Version 1 of Ogres by Lyall begins here.

[ Resolution of Ogre Encounter                                                 ]
[  0: starting value                                                           ]
[  1: player won, submitted for sex                                            ]
[  2: player won, refused sex                                                  ]
[  3: player lost, got fucked                                                  ]
[  4: player fled                                                              ]
[  5: player refused to submit willingly                                       ]
[  6: player became their willing plaything                                    ]
[  7: player had third encounter (no choices in that)                          ]
[  8: player met the ogres in their camp                                       ]
[ 50: player won, dominated ogre leader                                        ]
[ 99: avoiding future contact                                                  ]

a postimport rule: [bugfixing rules for players that import savegames]
	if Resolution of Ogre Encounter is 3 and Player is not male: [no female content for second encounter]
		now Resolution of Ogre Encounter is 5; [skip ahead to third encounter]

Table of GameEventIDs (continued)
Object	Name
Ogre Encounter	"Ogre Encounter"

Ogre Encounter is a situation.
ResolveFunction of Ogre Encounter is "[ResolveEvent Ogre Encounter]".
The level of Ogre Encounter is 10. [minimum level to find the event]
Sarea of Ogre Encounter is "Junkyard".

when play begins: [flags for blocking this event]
	add Ogre Encounter to BadSpots of MaleList;
	add Ogre Encounter to BadSpots of FurryList;

to say ResolveEvent Ogre Encounter:
	setmonster "Ogre Male";
	if Resolution of Ogre Encounter is 0: [FIRST ENCOUNTER]
		say "     While exploring the city, you turn a corner and bump into a large creature. Startled, you quickly jump back to create some distance between the two of you and [if weapon object of Player is journal]ready your fists[else]reach for your weapon[end if]. Your resolve to fight wavers when you realize that it's not just one, but three of these beasts that stand in front of you, all easily seven feet tall and imposingly built. The gray-skinned creatures resemble orcs, but with pudgy faces and large, round bellies. Their faces are covered with wrinkles and sport pointed teeth with what look to be a small set of tusks jutting out unevenly from the bottom row. They have large, round ears and dark, dim eyes. You can see a bush of black hair covering their armpits, a light coating across their arms, and a big patch between each pec. They look to be either oiled up from head to toe or just covered in sweat - you assume the latter.";
		say "     The middle one stands a little taller than the other two. Unlike them, he wears a long, open fur coat that almost reaches to his knees. A long scar runs down his torso, although it's hard to gauge the source of the injury. All of them are wearing what look to be tight, black swimming briefs, though these don't hide much, the bulk of their large orbs and thick lengths leaving a clear impression in the material. 'Look what we ran into, boys,' the middle one shouts. 'A weakling for us to beat the snot out of.' A small sense of fear creeps over you as they step forward, a mismatched collection of baseball bats at their disposal. 'You know, us bounty hunters usually have to fight much tougher enemies than you, weakling. You should be honored that we would waste our time with you.' They inch closer to you, looking for a fight.";
		let GroupFightCounter be 0;
		now fightoutcome is 0; [reset]
		while fightoutcome < 20 and GroupFightCounter < 3: [runs for 3 times or until the player loses or flees]
			if GroupFightCounter is 0:
				say "     The three ogres ready their bats and growl, pushing themselves up to their full height. Chest puffed out and bat over his shoulder their leader shouts out, 'Hopefully you prove to be more challenging than you look!' And with that, he charges you!";
			else if GroupFightCounter is 1:
				say "     'You might've gotten lucky beating the boss,' the second ogre grumbles, 'But you won't get lucky twice.'";
			else if GroupFightCounter is 2:
				say "     The last ogre looks at his fallen brethren and shakily lifts his bat to give it a swing in your direction. He lets out a nervous scream before attacking.";
			now inasituation is true;
			challenge "Ogre Male";
			now inasituation is false; [reset]
			increase GroupFightCounter by 1;
		if fightoutcome < 20: [player won]
			if Player is male:
				say "     The last of the three creatures has been bested in combat and falls down flat on his face with a loud thud. You stand there with your hands on your hips and chest puffed out, happy with your work. One of the creatures whimpers on the ground and crawls towards who you assume is the leader of their group, then whispers something into his ear. You start to wonder what you should do with the helpless creatures. Looking down at the smallest one you see his little, curly tail begin to twitch. At the same time, the other two both roll over and sit up, giving you a concerned glance before quickly looking at each other and whispering amongst themselves. Their leader in the fur coat finally speaks up, 'I am shocked. You have bested my brothers and myself in combat. You do as you please with any one of us. All I ask of you is to leave the most undesirable punishments to me as I have failed to live up to my duties as a leader.' You nod and look over the three creatures and carefully examine both their bulges and their rears.";
				LineBreak;
				say "     [bold type]What do you want to do with them now?[roman type][line break]";
				say "     [link](1)[as]1[end link] - Fuck the ogre leader.";
				say "     [link](2)[as]2[end link] - Ride a thick ogre cock.";
				say "     [link](3)[as]3[end link] - Just leave.";
				now calcnumber is 0;
				while calcnumber < 1 or calcnumber > 3:
					say "Choice? (1-3)> [run paragraph on]";
					get a number;
					if calcnumber is 1 or calcnumber is 2 or calcnumber is 3:
						break;
					else:
						say "Invalid choice. Type [link]1[end link] to fuck an ogre, [link]2[end link] to ride an ogre's cock or [link]3[end link] to leave.";
				LineBreak;
				if calcnumber is 1:
					say "     Your eyes fixate on the ogre leader's rear and give you an idea as to how he might be able to serve you. Stepping closer, you demand that he get on all fours. Hesitantly, the large being obeys, shifting his body and rolling over, presenting himself to you. Removing your gear, you walk up to the waiting male, licking your lips in anticipation. You get down on one knee behind him and possessively place your hand onto his rear end, rubbing it up and down over his still covered buttocks. He grumbles something about being humiliated and his two friends turn away and walk off, at least wanting to spare him witnesses to being put in such a position. Meanwhile, you reach up and pull down his spandex briefs, revealing a gray-skinned and hairless ass. A smile spreads over your face as you give his exposed cheeks a few good smacks, enjoying your dominance over this big brute. A couple of slaps on each side make a nice even number.";
					say "     The ogre leader grunts in response to your rough treatment, not at all enjoying to be on the receiving end for once. Bringing a finger to your mouth you suck on it for a few seconds before pulling it out and moving towards his pucker. You brush over his wrinkled opening once or twice, then push the wet digit against his hole, not letting up the pressure until it sinks into his body. The large creature doesn't make a sound, instead gritting his teeth and stoically bearing your invasion. You swirl the finger around, noticing that his ass is so tight that it might actually be a virgin. Then you add a second finger, closely followed by a third, all in an effort to help loosen him up before you proceed to fucking the ogre. 'You gonna be done soon? I think you've ridiculed me enough, so why don't you call it quits, eh?' the ogre asks with a grunt. A quick smack on the ass gives him an answer - just not the one he was looking for.";
					WaitLineBreak;
					say "     Spitting on his hole and fingering him some more till you think that the defeated ogre is ready, you soon line your dick up to his exposed rear and push yourself in. A slight moan escapes between the creature's clenched teeth as your shaft stretches his inner walls, penetrating deep into the previously unclaimed passage. His inner walls squeeze nicely around your cock, and you are eager to push yourself in all the way, to enjoy the tight confines of his virgin ass. One more hard thrust and you find yourself balls-deep inside the beast. You give him a few seconds to get used to your member, then waste no more time and begin to fuck the ogre leader in earnest, using long and hard thrusts. He grunts and mutters quiet curses in response to your rough treatment. Paying no mind to your defeated enemy's opinion, you just continue the fast-paced fucking, greatly enjoying yourself.";
					say "     The air is filled with the rhythmic sound of your hips hitting his rear, complete with the wet slurps of your [Cock of Player] prick sliding in and out of his spit-slickened asshole. Unable to deny that he is getting used to - and into - the feeling of being fucked, your gray-skinned partner soon breaks his quietness by letting out louder and louder moans, then even asks you to go faster. Grinning at pushing him to accept his new role, you grab onto his hips firmly and thrust even harder into him. Due to his tight inner walls clenching and relaxing around your cock, your arousal soars quickly to new heights, and you find yourself approaching an orgasm quickly. With a satisfied grunt, you bury yourself all the way in his gripping ass and unleash a torrent of your seed. As an afterthought, you reach around your sub while still sending more spurts into his ass, taking hold of his thick member and starting to jerk him off.";
					WaitLineBreak;
					say "     The newly inducted bottom is quite hard from the novel sensations you've been giving him during your fuck, so it doesn't take all that long to rub out his own climax. He lets out a loud grunt as his thick shaft starts to throb, spraying his load onto the ground below. After riding out your own orgasm, you pull out your spent cock and give the ogre's ass a hard smack. No longer held up by your hands on his hips, he sinks down on the ground, panting and trying to reconcile with being made to receive a hard dick, including breeding his ass. You smile as you put your clothes back on, then get going and leave the ogre behind. Time will tell what kind of aftermath comes from this. Maybe they'll be out for revenge?";
					CreatureSexAftermath "Ogre Male" receives "AssFuck" from "Player";
					now Resolution of Ogre Encounter is 50; [won, fucked the ogre]
					now Ogre Encounter is resolved; [the angry ogre path ends here for now]
				else if calcnumber is 2:
					say "     You give them a final look over and tell the fur-coated ogre to strip. He gives you a puzzled look, followed by a grunt, before he removes his coat and briefs. The others look back and forth between the two of you while you quickly begin to strip yourself, laying down gear and clothes in a tidy pile. The little show actually causes the outline of the two watching ogres['] cocks in their pants to grow. You turn your attention back to the leader, who is standing there unimpressed, glancing at your crotch. 'If you think that little thing's going to please me, you're sadly mistaken,' he scoffs, pointing at your cock. Chuckling, you explain to him that it isn't his ass that you're after. 'Then what the hell could you possibly want from me? My coat?' he shouts. After a quick step closer, you reach out and take hold of his still soft cock. He tenses up at first but relaxes when you start some gentle rubbing.";
					say "     'Even after defeating us, you want me to breed you?' he asks incredulously, then laughs out loud and calls to his friends, 'Seems like this one is a needy slut after all!' You ignore the ogre leader's words and continue rubbing his hardening cock, your other hand also moving to his plump balls. When his cock starts to drip precum, you place your palm over his tip, rubbing and spreading the slick liquid over his member. Once he is sufficiently lubed up, you tell him to lay down on his back, which he does without hesitation, and line your hole with the thick, gray-skinned piece of man meat. You try to sink down onto the creature's cock but are met with resistance from your own pucker as it struggles to take the girthy shaft. It takes a few tries before you are able to pop the tip of his thick cock into you, letting out a satisfied moan at the nice and full feeling he gives you.";
					WaitLineBreak;
					say "     After allowing yourself a few seconds to get used to his thick dick, you start to gently lower yourself further onto his pole. You let out a few long moans as you slowly sink down onto his cock. Inch by inch, his meat slides into you until you feel your rear touch his plump sack. 'I didn't think you would be able to handle all of this,' the ogre leader says with a small wiggle of his hips that forces a lewd groan from your lips. 'It would be awful rude of me to make you do all the work, wouldn't it?' He starts rubbing your sides. 'Why don't you just relax a little and let me show you how a real warrior fucks?' Just the thought of letting this creature have his way with you, even after beating him, fills you with joy. Unable to say anything, you just blush in response. 'I know that you will like it,' he says while very gently thrusting into you. 'Don't overthink it. Just let it happen. It will feel great, I promise.'";
					say "     The powerful ogre grips your sides a little bit harder, and his thrusts become just a little faster. You are too confused to think rationally, and you just sit there moaning on top of him, wishing that he will keep pleasuring you. 'All you have to do is say the words,' he offers, stopping his thrusts.. 'And I'll breed you properly. Just imagine having such a strong male laying on top of you, having his way with you. We both know that you beating us was a fluke, and all that you want is to be bred by me. Just imagine how great it will feel to be pumped full of my cum, to have my seed buried deep inside of you.' You moan for him to breed you once your lust-filled mind takes control. He pulls you into his chest, and you are greeted with the musky smell of his armpits. You take a deep breath trying to inhale as much of the male's scent as you can.";
					WaitLineBreak;
					say "     'Good choice,' he says, beginning to thrust into you again. 'Just take it like the good little slut you are.' He wastes no time to really start pounding into you. His slick cock slides in and out of your hole rapidly now that it's been stretched out. You feel yourself being pushed up against his chin and start to kiss at his broad chest as a way of thanking him for the rough fucking. His two brothers are now standing a few feet away, stroking their cocks while they watch their leader fuck you. His thrusts start becoming more sporadic, and his breathing becomes heavy and shallow. Soon enough, he wraps his arms around you and gives you a tight squeeze, holding you in place while he slams into you one last time and starts releasing a torrent of cum deep into you. You find yourself orgasming as well, spilling your sticky seed between your bellies.";
					say "     Even his underlings join in as they grunt, and you feel a spurt of their seed fall onto your back as you hear the rest fall onto the ground. The creature continues to fill you long after your orgasm subsides. Soon, you feel his cock slide out of you with a wet plop, and his grip loosens up. Once he fully removes his arms, you slide off of him and onto the cold cement. 'I told you that it would feel great,' he remarks, putting his clothes back on. 'The name's Gurke, and the other two are Kogs and Mogs.' Finished putting his gear on, he extends his hand down to you. You grab ahold of his meaty hand and are pulled up to your feet. 'You're welcome to see us again any time you wish.' He gives you a smile before walking off. You quickly put your gear back on and head out before any beasts decide they want to try and get sloppy seconds.";
					CreatureSexAftermath "Player" receives "AssFuck" from "Ogre Male";
					now Resolution of Ogre Encounter is 1; [won, submitted for sex]
				else:
					say "     Deciding that you would like nothing to do with any of the creatures, you just simply turn and walk away, leaving them to lay there and sulk in their defeat. You can hear them talking amongst themselves as you are walking away, but something tells you that this won't be the last time you see these three.";
					now Resolution of Ogre Encounter is 2; [won, refused sex]
					now Ogre Encounter is resolved; [no further content for this path exists for now]
			else:
				say "     [bold type]What do you want to do with them now?[roman type][line break]";
				say "     [link](1)[as]1[end link] - Ride a thick ogre cock.";
				say "     [link](2)[as]2[end link] - Just leave.";
				now calcnumber is 0;
				while calcnumber < 1 or calcnumber > 2:
					say "Choice? (1-2)> [run paragraph on]";
					get a number;
					if calcnumber is 1 or calcnumber is 2:
						break;
					else:
						say "Invalid choice. Type [link]1[end link] to ride an ogre's cock or [link]2[end link] to leave.";
				LineBreak;
				if calcnumber is 1:
					say "     The ogres lie there defeated. It doesn't take long for you to decide what you want. You walk up to the biggest one and stand over top of him, looking down. You examine his big, muscular frame, slowly making your way down to the very large bulge he's displaying through his underwear. You find yourself quickly removing your gear and tossing it aside. Once your pesky clothes are removed, you move onto freeing his still soft cock from the tight black underwear. He gives you a lust-filled gaze while you do so, knowing that your intentions are to do something with his cock. Once his cock is free, it very quickly starts to grow longer and thicker. Eventually, what was already a thick member is now even thicker and much longer. You wrap your hand around the piping hot member and stroke it a few times sizing him up; deciding that you can in fact take him you position yourself over his member and line it up with your awaiting pussy.";
					say "     Not wanting to waste time, you pop the tip in, and after a few seconds, you begin to slowly lower yourself down his long and very thick pole. After a long minute or so you feel your butt touch against his balls, signaling that you've reached the end of his cock. You once again give yourself a minute to grow accustomed to his member and gyrate your hips just a little. You have to admit the ogre does fill you up just right. He's not so big that it's painful, and it's at the perfect width to give you a nice stretch. It's a full feeling you'll be enjoying until you've exhausted yourself. The other two ogres are still near him motionless. You assume they are just unconscious and get back to the feeling this ogre's cock is giving you. The ogre does look up at you almost begging for you to start, but since you're the one in charge, you decide to wait just a little while longer.";
					WaitLineBreak;
					say "     Now that you've teased him long enough, and you're growing impatient yourself, you begin to slowly work yourself up and down his member. You gently slide up and down his member, slowly going further and further up his pole until you reach a little bit past halfway. You soon start bouncing up and down on his member slowly and getting faster. His hot member starts leaking more and more pre inside you, helping you ride him with ease. The warmth it fills you with is intoxicating, and you can't help but to want more. Your riding becomes more and more chaotic with time. You begin to care less about tempo and more about getting off with this fat member in you. The ogre starts to match you with thrusts of his own. These thrusts fill you with even more pleasure.";
					say "     Before too long you two are in sync, he's matching you thrust for thrust and you can feel yourself reaching an orgasm. Not much before you, the ogre gives out a small roar and buries himself deep inside your pussy. That thrust sets you over the edge, and your pussy starts to quiver, and you let out a lust-filled scream while you orgasm on top of him. Meanwhile the ogre beneath you has started unleashing a torrent of cum deep into your womb, painting your insides completely white. Long after your orgasm subsides, he finally stops cumming, and after a few seconds you start to pull his still hard cock free. Slowly pulling his cock free, it comes out with a nice wet pop accompanied by a few drops of his load.";
					WaitLineBreak;
					say "     Once you're back on your feet, you move to gather your gear. 'So,' the ogre says while you gather your gear. 'I'm Gurke and the two unconscious fellows over there are Kogs and Mogs.' You nod almost dismissively now that you've gathered your equipment and begun to put it on. He gives you a questioning look and moves towards the other two. Once you've put the last of your gear on you leave Gurke and the other two ogres behind and make your way back into the city.";
					now Resolution of Ogre Encounter is 5; [won, submitted for sex, skip second encounter for female]
				else:
					say "     Deciding that you would like nothing to do with any of the creatures, you just simply turn and walk away, leaving them to lay there and sulk in their defeat. You can hear them talking amongst themselves as you are walking away, but something tells you that this won't be the last time you see these three.";
					now Resolution of Ogre Encounter is 2; [won, refused sex]
					now Ogre Encounter is resolved; [no further content for this path exists for now]
		else if fightoutcome > 19 and fightoutcome < 30: [lost]
			if Player is male:
				say "     You fall to your knees, exhausted from the fight. The large creatures walk up to you, towering over you with smiles plastered across their faces. 'What should we do with them?' one asks. 'We should kill it,' another one says. 'Shut up, both of you!' the leader barks. 'He doesn't have a bounty, so there's no use killing him, and he didn't put up a fight as another bounty hunter would. I say that we have a little fun with him.' The leader licks his lips and stares down at you. The other two laugh and agree with him. Done arguing over what they want to do with you, the leader removes his jacket and sets it on the ground. You can't help but look over in awe at his powerful, gray legs and his cute, little tail. The other two stand there, waiting for their leader. Once his jacket is neatly placed on the ground, he removes his briefs and turns towards you.";
				say "     His thick, though not long, cock begins to harden, becoming even thicker. He walks up to you, and the closer he gets, the stronger his musk becomes. He stands only inches from you, and you look up to see his now hard eight-inch cock above. The other two walk behind you, having already removed their gear, and rest their cocks upon each of your shoulders. 'I'm Gurke, and these are my partners, Mogs and Kogs,' the leader informs. 'And you are now our pet, you understand?' You nod in agreement with Gurke's statement. 'Good. Now get on all fours,' Gurke commands. Given the situation, you have no choice but to do as they say. You fall forward, bracing yourself with your hands, and raise your ass for your new masters. Gurke steps towards your ass, moving his partners away.";
				WaitLineBreak;
				say "     He looks down at your raised ass and chuckles 'I think we are too thick for the weakling,' Gurke taunts, getting a chuckle in response from Grog and Kogs. He gives his thick member a couple of stokes to gather some precum and lines himself into your awaiting hole. 'I'll try not to ruin him for you two.' He pushes his thick cock against your hole. Your hole fights his member, refusing to let him in, though the fight doesn't last too long before Gurke's thick cock head pops into you. The initial penetration hurts, but part of you relishes in the idea of being stuffed by such a thick cock, and the pain soon turns into pleasure. Luckily for you, Gurke does stay still for a few seconds to help you get accustomed to his thick member. Once he believes that you are adjusted enough, he gently pushes his cock deeper into you.";
				say "     He inches in slowly while you moan beneath him. The more Gurke pushes into you, the more eager you get to have his cock buried balls-deep inside of you. Your wish is finally granted when you feel his huge balls gently rest upon your ass. Gurke, once again, pauses for a few moments before he starts fucking you with short, slow thrusts, only taking an inch or two out at a time. You let out a few deep moans while he gently has his way with you. 'Good boy,' he says, still fucking you gently. 'I want to take my time with you.' His thrust stays the same for quite some time. Eventually, your new lover starts to take some more of his cock out with each thrust, eventually taking it all the way out to the tip. Though the length may have changed, his slow, tantalizing pace remains the same.";
				WaitLineBreak;
				say "     His two partners, who have been watching this whole time, make their way to either side of you and begin slowly stroking their cocks over you. Gurke notices his partners and finally begins to pick up the pace of his humping. You are caught off guard by his sudden change of pace and almost fall onto your face. You moan beneath him as he starts to pound faster and faster into you, and it seems to get him even more riled up because he suddenly begins to brutally fuck your hole. His voluminous, gray balls make a loud smack with each of his hard thrusts. His partners, who seem to be enjoying the show, start stroking themselves faster. Gurke grabs hold of your hips and gives them a couple of good smacks while fucking you. Before long, the air is filled with the sounds of your moans, fapping, and loud grunts. This goes on for a little while longer before you hear his partners['] grunts change, and they both orgasm.";
				say "     You feel spurt after spurt of their hot seed fall onto your back while they cover you with their cum. Their orgasms seem to last forever before you finally feel the last drop of cum fall onto your soaked back. The pleasure of being fucked by Gurke and getting covered in his partners['] cum sets you over the edge as you shoot your load onto the ground beneath you. As you orgasm, your hole tightens around Gurke's cock, and you feel his thrust become shorter and more desperate before, with one more hard slam, he buries his cock inside of you and begins filling you. His seed quickly floods your bowels as he just keeps pumping you full of his cum. Once his orgasm finally subsides, he pulls his spent cock from your hole and gives your ass a hard smack. 'Man, I don't think you will recover from this.' Gurke laughs. 'I haven't seen a hole beat up like this in years.' His two partners chuckle while you slowly drift away. The last thing you remember is hearing Gurke tell you to look for them sometime if you ever want to become their newest plaything before passing out from exhaustion. You wake up and clean off their dried-up cum as best as you can before making your way back to safety.";
				CreatureSexAftermath "Player" receives "AssFuck" from "Ogre Male";
				now Resolution of Ogre Encounter is 3; [lost, got fucked]
			else:
				say "     The three ogres quickly circle you removing their underwear, showing off their proud, rapidly growing members. The leader moves closer initially and gently puts a finger under your chin, lifting your head up. 'We're going to have fun with you, little thing,' he says with a proud grin plastered across his face. He wastes little time deciding what he wants. You are suddenly met with a hard smack of his dick across your cheek. The ogre chuckles and slaps you with his meaty member a few more times. The other ogres begin to laugh while stroking each other off. Finally finished slapping you, you feel the warm head of his thick cock rest upon your lips. 'It isn't going to suck itself, you know,' he says. 'If you do a good job, I'll give you a nice pounding to go with it.'";
				say "     Wasting little time you open up, letting the large intruder slowly push into your mouth. The taste of his salty precum slides across your tongue, filling you with a need to satisfy your better. You reach a hand up and grab hold of his hot cock, and slide it further into your mouth. The ogre lets out a small grunt of approval over your actions, and you continue. You begin to steadily bob your head up and down his cock sliding more and more of it into your maw each time. You soon remove your hand and start eagerly sucking down his behemoth of a cock. You work your tongue around the base and tip when you can, searching for any way to please the ogre. He doesn't try to coach you or anything. He just lets you keep sucking away. His cock begins to start drooling more pre into your mouth, and with each drop, you want more.";
				WaitLineBreak;
				say "     Before too long the ogre starts to pant heavily. You do your best to finish him off, but before you have the chance, you feel his hand wrap around the back of your head and pull you off. 'Slow down, we haven't gotten to the fun part yet,' he says, giving a gesture for you to turn around. You do so immediately and are met with a harsh shove. Barreling face-first into the ground, you break your fall quickly. Understanding what the ogre wants, you reposition yourself with your tail end upwards so he may take you how he pleases. With a satisfied grunt, the ogre gives your ass a hard smack. 'It looks like you might be ready for the real fun,' he says, gliding a finger up and down your pussy. 'I just wonder if this can take all of me. I guess we'll find out soon enough.'";
				say "     And just like that, he forces himself balls deep into your pussy. You let out a scream of both pain and pleasure. You feel a hot warmth engulf your entire body. His cock is filling you with a warmth, or maybe even a need, that you've never experienced before. He was generous enough to give you a few seconds to get properly adjusted to his member, but that's about it. All of a sudden, he starts to slide his cock out of you and quickly shoves it back in. He does this a few times before he grabs onto your hips and starts rapidly thrusting in and out of you. It feels like each stroke gets longer and faster until everything but the tip of his cock is withdrawn and pounded back in. He's fucking you like a wild animal in rut, and you can't help but moan beneath the powerful man.";
				WaitLineBreak;
				say "     After a few minutes of rough fucking, you realize that you completely forgot about the other two ogres. You glance over to the side and see that they are perfectly content in jerking each other off with their cocks facing you. The ogre behind you starts to thrust even harder than before, and his balls are loudly slapping your thighs. It isn't much longer before the ogre pushes into you and starts to pump you full of his cum. After the first shot of his seed, your pussy clenches down around his cock, and you begin to orgasm as well. Your pussy quivering around his member, you let out a moan that much resembles screaming. The other two let out a loud grunt and begin to cover you with their own loads. With bad aim, a few of their shots land on your back and in your hair in an attempt to cover you with their loads. Well after your orgasm subsides, the ogre still lodged inside you continues to pump you full of his cum before it eventually stops.";
				say "     Once the leader is finished, he pulls himself out of you with a wet plop. He takes a second to admire his work before getting up and high fiving the other two ogres. 'If I'm lucky enough, you'll have a couple little ogres in there for me. The more, the merrier.' He chuckles, getting laughs from the other two. 'The name is Gurke by the way. The other two here are Kogs and Mogs,' he says, pointing at the other two. 'Feel free to pay us another visit if you want some more of this,' he says while swinging his cock back and forth. 'But for now we have to get going.' And just like that, the three left you there naked and leaking cum on the ground. You take a little while to recover, then amply put your gear back on and go.";
				CreatureSexAftermath "Player" receives "PussyFuck" from "Ogre Male";
				now Resolution of Ogre Encounter is 5; [lost, got fucked, skip second encounter for female]
		else if fightoutcome is 30: [fled]
			say "     Taking your arms under your legs, you quickly run off, leaving the aggressive ogres behind.";
			now Resolution of Ogre Encounter is 4; [player fled]
			now Ogre Encounter is resolved; [no further content for this path exists for now]
	[SECOND ENOUNTER BELOW]
	else if Resolution of Ogre Encounter is 2: [player won but refused sex the last time]
		say "     ...";
	else if Resolution of Ogre Encounter is 3 or Resolution of Ogre Encounter is 1: [player lost or submitted previously]
		say "     For some odd reason, you find yourself looking for Gurke and his partners. You search for quite some time before you stumble across what looks like a little camp with a large tent and a fire pit that must have been found while scavenging. The tent is black and looks like it could house eight average size people, and the large fire pit is filled with ashes from previous fires. It looks like there may even be embers still hot in the pit. You look around to see scattered wrappers and miscellaneous objects scattered all around the makeshift camp. You look around for signs of life to no avail. You are about to give up your search and leave, but before you finally do, you hear a loud voice coming from behind you. 'Look who came back,' the familiar voice says, and you turn around to see the three hulking figures of Gurke, Mogs, and Kogs. 'I honestly didn't know if you were going to be able to walk after what I did to you last time,' Gurke teases with a powerful thrust of his hips. You chuckle and tell him you got up shortly after and went on your way. 'So, what brings you back to us,' Mogs asks. 'Why else would they come back, you idiot,' Gurke responds. 'He wants to be our new little plaything, isn't that right?'";
		if Player is male:
			say "     Do you agree with Gurke?";
			LineBreak;
			say "     ([link]Y[as]y[end link]) - Become their plaything.";
			say "     ([link]N[as]n[end link]) - Disagree with him.";
			if Player consents:
				LineBreak;
				say "     You tell them that, yes, you would like to be their new plaything, against your better judgment. They look at you almost shocked with your response and give each other confused looks back and forth. 'Well... Um... That's great,' Gurke says, finally breaking the silence. 'So you want to be our pet?' You tell Gurke that you do wish to be their pet and will do whatever they ask of you. 'Okay,' Gurke replies, still surprised. 'Well, then take that shit off and bend over for me.' Without hesitation, you remove your gear and present yourself to the three, who are removing their clothes as well. Gurke is the first to walk up to you and leads you into a tent with three makeshift beds. He guides you down onto all fours on the bed and sucks on his finger. Getting his finger wet enough, he gently pushes it into your awaiting hole. Your hole, still loosened up from your last coupling, easily yields, letting his finger slide in with ease. He thrusts his finger a few times, just to be safe, before pulling it out and positioning his now hard cock up to your hole. He gently pushes his head against your rear, and with a little effort, manages to pop the tip of his cock in.";
				say "     This time, you moan during the initial penetration. It no longer hurts, and it just feels great to be stretched out by your new master once again. He doesn't waste time before he starts pushing the rest of his member inside of you. You quickly feel his balls press up against your own, signaling to you that he's balls deep. He slowly starts to slide his cock halfway out before gently pushing it back in. You moan in response to his thrust, urging him to fuck you harder. Acknowledging your demands, he reluctantly starts to thrust faster. He grunts and groans on top of you as he continues to fuck you harder and harder. His thick cock fills you with the feeling of fullness that you long for. He rubs across your prostate, sending shivers up your spine with each pass. You moan louder as he continues to fuck you. Not long after his breaths start to become shallow, he thrusts hard into your ass, unleashing a torrent of his cum that completely paints your insides white. Once his orgasm subsides, he pulls his cock free from your loose hole with a wet slurp, and some of his seed falls onto the bed.";
				WaitLineBreak;
				say "     Kogs and Mogs look in awe at your gaping, cum-filled hole and both rush towards you to fill it next. Kogs manages to push Mogs off course and is the first to grab ahold of your hips. Wasting no time, he positions his cock and slams it into your hole. You moan in delight as you are suddenly filled by Kogs['] thick member. 'I hope you like your fucks extra sloppy, Mogs,' Kog taunts mockingly. He starts fucking you in earnest. His thrusts are long and fast as he ravages away at your hole. You moan lewdly beneath him, and you find yourself creeping closer to an orgasm. You feel Gurke's seed get pushed deeper into you and make its way into your belly. As fast as it began, you feel Kogs['] balls tense up as he slams hard into your ass. He starts pumping his seed into your already cum-filled bowels, and after only a couple of spurts, you feel his cum start to drip out of your hole and onto the bed. Finally finished with his orgasm, he pulls free from your hole. Mogs instantly pushes Kogs out of the way and plunges his thick member into your hole, causing you to moan once again from the sudden fullness. Much like Kogs, he fucks you in earnest.";
				say "     He pushes your head down onto the bed and positions himself a little higher so that he can fuck you harder. Gurke's and Kogs['] seed are starting to slip out around Mogs['] cock, allowing for him to fuck you faster. Mogs gives your ass a hard smack, and you find yourself shooting a load of your seed onto the bed below. Mogs gives a satisfied grunt as he plows your wrecked hole. Before too long, Mogs finally has had enough and thrusts into you, releasing his ample load into you as well. When he pulls out, a flood of their mixed seed spills onto the bed. You fall flat onto the bed with a swelled-out stomach. 'Welcome to the team, partner,' Gurke says with a smile. 'We might have to take you out for a couple of fights here and there. Maybe we'll even let them fuck you after you beat them up.' You don't respond. Instead, you just lay on the bed, silently savoring the sensation of being filled with so much cum. 'Get some rest, pet,' Gurke says. 'And come back to the camp when you're ready to fight or ready for another fucking. Maybe even both, if you're lucky.' With that, he leaves you to rest. After a while, you gather your things and head out, still leaking their cum. You make sure to note where their camp is so that you won't have any troubles coming back.";
				CreatureSexAftermath "Player" receives "AssFuck" from "Ogre Male";
				now Resolution of Ogre Encounter is 6; [player became willing ogre plaything]
			else:
				LineBreak;
				say "     You tell him that unfortunately, you do not want to be their personal plaything. All three give a dissatisfied sigh in response. 'If you ever wish to have fun with us again, you know where to find us. We would all enjoy another round of playtime with you, but I won't press the matter. Just know that you are welcome back anytime.' Gurke looks sad while he talks, but you don't want to bring it up. Instead, you thank him for his offer. Part of you is a little disappointed that you said no to him, but you remind yourself that you will probably see him again and be asked again.";
				now Resolution of Ogre Encounter is 5; [refused ogres]
		else:
			say "     You tell him that unfortunately, you do not want to be their personal plaything. All three give a dissatisfied sigh in response. 'If you ever wish to have fun with us again, you know where to find us. We would all enjoy another round of playtime with you, but I won't press the matter. Just know that you are welcome back anytime.' Gurke looks sad while he talks, but you don't want to bring it up. Instead, you thank him for his offer. Part of you is a little disappointed that you said no to him, but you remind yourself that you will probably see him again and be asked again.";
			now Resolution of Ogre Encounter is 5; [refused ogres]
	else if Resolution of Ogre Encounter is 4: [player fled the last time]
		say "     ...";
	[THIRD ENCOUNTER BELOW]
	else if Resolution of Ogre Encounter is 5 or Resolution of Ogre Encounter is 6: [player was asked to submit before and did or did not do it]
		say "     You find yourself walking around the city and see three large silhouettes in the distance. They appear to be fighting off something, though you can't tell what it is from this far away. Against better judgment, you move closer to the three creatures, with an odd feeling that you've met them before. You inch closer ever so cautiously not to draw any attention. Each step is almost silent, and the creatures come closer in view. You finally get behind a couch that has been discarded. You use the red, and very aged leather couch as cover for a moment before peering over the back just enough so that you can be seen. The three creatures appear to be having absolutely no problems with the monster they are attacking. They swing away at the beast with their large wooden bats, laughing and joking about how easy the fight was.";
		say "     At this point, you wonder if they are just beating the poor creature senseless for their own amusement. After a few more minutes, they grow bored of the monster and turn away from it. Still laughing and having what looks like a good time, they turn around, and you immediately recognize them. It's Gurke, Kogs, and Mogs. Your face lights up a little bit, mostly with relief, but it's been a while since you've seen them, so you stand up from behind the couch and wave. The three ogres jump back and start to prepare for a fight. The second they were preparing for a fight was surprisingly intimidating; you could see the bloodlust in their eyes and sly smiles creep across their lips thinking about how much fun it's going to be beating down some pathetic creature. In a delayed reaction, they lower their weapons, and they go from bloodthirsty to overjoyed at the sight of you. 'Hey you,' Gurke says with a wide smile, 'It has been too long, where have you been hiding out?'";
		WaitLineBreak;
		say "     You give out a sigh of relief now that they recognize you and won't be beating you to a pulp like their last victim. You tell them about your most recent adventures in detail. 'You sure have been up to a lot, huh lil fella?' Kogs says, 'I'm surprised you still know how to fight, to be honest. I figured you'd be someone's plaything now.' The ogres all laugh in agreement, and Gurke gives Kogs a high five. 'Well, it's good to see you again.' Gurke says, 'Unfortunately we are a little short on time at the moment, so you should stop by and visit it really soon ok? We'd love to catch up with you, go out and bust some skulls together, and have some fun.' He gives you a sly wink before continuing, 'You know where you can find us, so just come visit. We should be free for a while. We just have to take care of some important business.' You bid them farewell and reassure them that you'll come to visit whenever you have the time. They smile and wave back to you while saying in unison, 'Catch you around!' They turn the other direction and start walking away. You watch them walk out of sight and continue on your way, wondering what they could be up to and if you should actually go visit them again.";
		now Resolution of Ogre Encounter is 7; [3rd encounter done]
	[FOURTH ENCOUNTER BELOW]
	else if Resolution of Ogre Encounter is 7:
		say "     Once again, you find yourself wandering aimlessly looking for something to do or just something to fight. In the distance, you hear hardy laughter and a few people practically shouting. [bold type]The tone of voice reminds you of the ogres you encountered before hereabouts. Do you want to investigate?[roman type][line break]";
		LineBreak;
		say "     ([link]Y[as]y[end link]) - Sure thing!";
		say "     ([link]N[as]n[end link]) - Nah, you don't want to meet those guys again!";
		if Player consents:
			LineBreak;
			say "     Deciding that you should investigate the sounds, you listen closely and begin moving in the direction of the noise. As you come closer, you realize that the voices are coming from none other than the three ogres you've somewhat befriended. They become louder and louder and eventually come into sight. They are huddled around a rather large fire with a set of tents behind them. Not a care in the world, they continue talking, knowing that not many people are brave enough to just sneak up on three ogres. You clear your throat before saying hello. The three ogres quickly look your way and begin to stand up. Before they could fully get to their feet, they realize that it's only you and sit down as quickly as they almost got up. Everyone stays quiet for a few moments before Gurke lets out a hardy laugh, that may have caused the ground to shake; his unnecessarily loud laugh is followed up by two more obnoxiously loud laughs. You can barely hear yourself think they are so loud.";
			say "     You scan the area a little noticing the cans of food lying around, a stack of firewood and old newspapers. You also notice a large amount of alcohol scattered across the ground; it looks like a few bottles of whiskey, vodka, tequila, and a mountain of empty beer cans. There are enough empty beer cans to kill a small horse. Their behavior makes much more sense now. Once there, what seemed to be endless laugher subsides as Gurke looks at you and smiles. 'Hey there,' he says 'I see you finally decided to join us. You picked the best time too. We just got finished with a great hunt.' The other two nod in agreement while Gurke puffs his chest out. Seeing that he is looking for any form of recognition, you congratulate them all on a successful hunt even though you have no idea what they were hunting. 'Let me tell you about our great hunt.' Gurke says cheerfully.";
			WaitLineBreak;
			say "     'It's a story for the ages let me assure you.' You roll your eyes slightly and tell him that you'd love to hear his story. 'Great. Pull up a chair or sit on the ground' He shouts. You look around halfheartedly for a chair just to learn that there aren't any, so you sit on the cold hard ground. 'Now let's begin,' Gurke says, beaming with pride. The other two ogres lean forward, giving their full attention to Gurke's story.";
			say "     'We were tasked by the leader of the ogres to collect some information on the orcs since we have reason to believe that they plan on starting a war with us because they believe that ogres are inferior to orcs. He told us where we could look for some orcs, something about an old police station being their little orc hideout. We were, of course, excited about the idea of bashing a few of those cocky orcs['] heads in, so we hurried off in search of this hideout. Along the way, we spotted a few hyenas and beat them up for any information about the orcs['] hideout. One of those weak things actually knew where it was and told us this sob story about how the orcs took their friend against their will back to the hideout to be their slave or whatnot. Honestly, I didn't care much.'";
			WaitLineBreak;
			say "     The other two ogres laugh at the memory of the hyena's story before letting Gurke continue. 'Along the way we encountered four, and I kid you not, four Hydras.' You roll your eyes, doubting that they actually ran into four Hydras. 'Hey, are you paying attention?' Gurke asks. You tell him that you are listening to his thrilling tale. 'Good,' he says, 'Now where were we? Right! The Hydras. As you could expect, we had absolutely no problems with the Hydras. They may be big, but they are truly pathetic creatures. Kogs and Mogs over there each took one on apiece while I battled two of them at once. The first one was pretty easy. I just jumped up and popped him on one of his heads, and he fell straight to the ground. The second one, though, he was a stubborn one. I kept hitting him with this here bat.'";
			say "     He pulls out a blood-covered bat from behind the log he's perched on. 'I smacked that monster twenty times with this thing, and he didn't go down. I was actually starting to be impressed. Luckily these two over here,' he says while pointing at both Kogs and Mogs, who are sitting at either side of him. 'They had just finished up knocking out their Hydras and helped me out. We hit him in three of his heads at the same time, and he went down like a sack of potatoes. Even though I was more than capable of taking him out myself, I appreciate their help. Besides, I was getting all riled up. Nothing turns a man on more than overpowering such a large creature. You know what we did after we defeated them all?' He looks at you, grabbing his large bulge through his spandex underwear. You tell him you have no idea, and he laughs.";
			WaitLineBreak;
			say "     'Let me tell you then. We fucked each and every one of them, and I mean we fucked their brains out. They were a heaping pile of cum and drool by the time we were done. We each fucked our own, of course, and then ganged up on the one we took out together. I swear we fucked him so good that that creature followed us for hours, begging for more. So we gave it to him until he was unconscious. Then we moved on to the orc lair after getting some rest. I know we look like we could fuck all day and night and not need any rest, but after a while it sure does get tiring.' Gurke says with a wink, pausing for a second to drink an entire beer can in one very large gulp. You hadn't realized that they're still drinking. As quickly as he picked up the beer, he swallowed and continued his story, which to you sounds more like recon than a hunt.";
			say "     'After our well-deserved rest, we woke up before the Hydras and snuck off towards the hideout. There's nothing worse than a needy slut you don't want, following you around. It didn't take us long to locate the base. It's not very well hidden, but what do you expect from stupid orcs? We waited outside for one of those orcs to come out because even though we can beat up almost everyone and everything, we're smart enough to know that we probably can't take on an entire army of orcs by ourselves. We waited for a really long time for one of those idiots to come outside. Luckily, one did, and we jumped him, and we beat him up bad, he was a mess when we were done with him. We beat his ass, tied him up, and started interrogating him.'";
			WaitLineBreak;
			say "     'Unfortunately for him, he was stubborn about telling us anything right away, something about stupid orcs['] honor or some bullshit like that. We tried everything we could think of to get him to talk. Eventually, we were left with only one option. We fucked him. Kogs and Mogs started first, and they bred him until they couldn't anymore. He was half-sleeping, half in a lust-filled daze. He couldn't get enough of it, and finally, I stepped in and told him that he couldn't get my dick until he told me what they were planning and guess what it worked. He told us everything from how many orcs there are going to be, to when they planned to attack, and since I'm a man of my word, I gave him the best dicking of his life, he was moaning so loud it caused all the birds to fly away. I'm sure they heard it inside but those stupid orcs probably thought he was just really giving it to some random creature. Well, after we left the orc a cum-soaked slut, we left and found as much to drink as we could find and came back here.'";
			say "     You nod, not sure if his story is done, and wait for a few seconds to say anything. Nobody spoke up, so you told him it was a great story and that you were glad you stayed to listen to it. Once again, Gurke puffs his chest out with pride and tells you that he has plenty of amazing stories for you. You chuckle and tell him that you'd love to hear them some time, mostly out of courtesy. He flashes a genuinely happy smile and goes on about how stupid orcs are and how they are pathetic creatures.";
			WaitLineBreak;
			say "     You just nod in agreement as he rambles on. You ask him about the ogre leader, and he gives a brief and vague explanation that really doesn't explain anything, and leaves you with more questions and no answers. In unison, the ogres yawn and hiccup. Clearly tired, probably from drinking so much, you ask them if they'd like you to leave. 'You're more than welcome to stay here,' Gurke says cheerfully, 'But we're just going straight to sleep, so if you stay, you can't have any fun with us.' He runs a finger across the outline of his meaty cock while talking, 'But feel free to stop on by some time. I'm sure we can make time for more stories and fun.' With that, he gives his bulge a nice squeeze and wiggles it the best he can through his underwear. You wave goodbye to them as you stand up and begin to walk away.";
			now Resolution of Ogre Encounter is 8; [encountered them in their camp]
			AddNavPoint Ogre's Camp;
		else:
			LineBreak;
			say "     Deciding that it's not worth your time, you choose to ignore whatever is going on over there and walk away. You'll make sure to avoid them in the future too.";
			now Resolution of Ogre Encounter is 99; [avoiding the ogres now]
		now Ogre Encounter is resolved; [any further content in the friendly/subby track is reached by navigating to their camp]
	[ALTERNATE TRACK - ANGRY OGRES]
	else if Resolution of Ogre Encounter is 50: [player dominated ogre leader last time]
		say "     ...";

Table of GameRoomIDs (continued)
Object	Name
Ogre's Camp	"Ogre's Camp"

Ogre's Camp is a room. It is a fasttravel. It is private.
Description of Ogre's Camp is "     You shouldn't be seeing this, as navigating to the Ogre Camp should bring up an encounter scene with them. Please report on the FS Discord how you saw this.".

instead of Navigating Ogre's Camp while (Resolution of Ogre Encounter is 8): [player is their willing playmate and is visiting]
	say "     Wandering the city you find yourself back at the ogres['] impromptu camp. You can see them sitting around talking amongst each other, not a care in the world. Though it appears that they cleaned up the mess of beer cans and empty bottles from last time. You are quickly welcomed by Mogs, who shouts 'Look who came back to visit!' Kogs and Gurke look your direction pleased that you came back. 'Sit down and relax with us for a little bit,' Gurke says, patting a spot on the wood log he's sitting on. You're not sure what kind of tree the log's from, oak or something; it's a dark, almost brown color. You walk over there and take a seat on the log next to Gurke. The moment you get situated he wraps his arm around you and asks, 'What did you come here for today, you want our life stories, some fun, or something else?' He elbows your ribs playfully while asking.";
	LineBreak;
	say "[OgreTalkMenu]";

to say OgreTalkMenu:
	say "     [bold type]What is your reply?[roman type][line break]";
	LineBreak;
	now sextablerun is 0;
	blank out the whole of table of fucking options;
	[]
	choose a blank row in table of fucking options;
	now title entry is "Ask for Gurke's life story";
	now sortorder entry is 1;
	now description entry is "Learn more about one of the ogres";
	[]
	choose a blank row in table of fucking options;
	now title entry is "Ask for Mogs's life story";
	now sortorder entry is 2;
	now description entry is "Learn more about one of the ogres";
	[]
	choose a blank row in table of fucking options;
	now title entry is "Ask for Kogs's life story";
	now sortorder entry is 3;
	now description entry is "Learn more about one of the ogres";
	[]
	choose a blank row in table of fucking options;
	now title entry is "Hear more ogre hunt stories";
	now sortorder entry is 4;
	now description entry is "Let them entertain you with one of their many stories of hunting in the city";
	[]
	choose a blank row in table of fucking options;
	now title entry is "Fuck around with the ogres";
	now sortorder entry is 5;
	now description entry is "Have sex with the three of them";
	[]
	choose a blank row in table of fucking options;
	now title entry is "Ask about their mission";
	now sortorder entry is 6;
	now description entry is "Learn more about what they set out to do";
	[]
	choose a blank row in table of fucking options;
	now title entry is "Ask about their leader";
	now sortorder entry is 7;
	now description entry is "Learn more about the ogre leader";
	[
	choose a blank row in table of fucking options;
	now title entry is "Ask to meet their leader";
	now sortorder entry is 8;
	now description entry is "Request a meeting with the ogre leader";
	]
	sort the table of fucking options in sortorder order;
	repeat with y running from 1 to number of filled rows in table of fucking options:
		choose row y from the table of fucking options;
		say "[link][y] - [title entry][as][y][end link][line break]";
	say "[link]0 - Say you're just passing through.[as]0[end link][line break]";
	while sextablerun is 0:
		say "Pick the corresponding number> [run paragraph on]";
		get a number;
		if calcnumber > 0 and calcnumber <= the number of filled rows in table of fucking options:
			now current menu selection is calcnumber;
			choose row calcnumber in table of fucking options;
			say "[title entry]: [description entry]?";
			if Player consents:
				let nam be title entry;
				now sextablerun is 1;
				if (nam is "Ask for Gurke's life story"):
					say "[GurkeStory]";
				else if (nam is "Ask for Mogs's life story"):
					say "[MogsStory]";
				else if (nam is "Ask for Kogs's life story"):
					say "[KogsStory]";
				else if (nam is "Hear more ogre hunt stories"):
					say "[OgreHuntStories]";
				else if (nam is "Fuck around with the ogres"):
					say "[OgreCampFuck]";
				else if (nam is "Ask about their mission"):
					say "[OgreMissionTalk]";
				else if (nam is "Ask about their leader"):
					say "[OgreLeaderTalk]";
				else if (nam is "Ask to meet their leader"):
					say "[OgreLeaderMeet]";
				wait for any key;
		else if calcnumber is 0:
			now sextablerun is 1;
			say "     Giving an apologetic shrug, you tell the ogres that you actually are on your way somewhere and just wanted to check in for a moment.";
			wait for any key;
		else:
			say "Invalid Option. Pick between 1 and [the number of filled rows in the table of fucking options] or 0 to exit.";
	clear the screen and hyperlink list;

to say GurkeStory:
	say "     The ogre laughs full-heartedly and says, 'So you want to know more about me, huh?' You nod and tell him it would be nice to learn about him before all this happened. 'Well, my life hasn't always been about bashing skulls, you know. For the most part that is.' He laughs for a moment before continuing. 'I guess we'll start off at the beginning. I was born in this town. At the city hospital to be precise, it was a lot less hectic there before the apocalypse and had far fewer orgies. I was born to a single mother, I never learned who my father was and I never cared to learn who he was, she raised me all alone. We lived in a small apartment my whole life. She worked two jobs and was never home. As you can imagine, I was sent to the public schools here. I don't remember much about my early days, especially not much about what school was like. It was nothing exciting or out of the ordinary. Nowhere near as exciting as life is now. But anyway, when I graduated high school, I wanted to be a police officer. I went to college and got a degree, I worked out a few times a week so I could get bigger. I breezed through college, partied a lot, and fucked a lot. The true college way in my mind. After graduating from college, I started looking for jobs around town.'";
	say "     Gurke looks at you and elbows your ribs again. 'You still there? Now that I sped through the boring part of my life now we're on to the fun stuff.' You nod and let him know that you were paying attention. Without hesitation, he continued, 'At first I had trouble finding a job as a police officer the city said that they were already staffed, the county sheriff was also staffed, hell even the surrounding cities were fully staffed. To this day, I still think that they were lying to me and were playing politics with who they wanted to hire. None the less I continued job-hunting picking up odd jobs here and there to pay the bills. Nothing fancy or anything just simple jobs in fast food and construction. I really enjoyed my time in construction. We were all tough guys, and we'd let you know it. If you looked at any of us wrong we would very easily start throwing punches at you.'";
	WaitLineBreak;
	say "     We didn't take to kindly to being looked down at or belittled in any way. You wouldn't have any of these buildings and roads if it wasn't for us. My buddies and I would go to a bar every Friday and Saturday and get absolutely hammered. I think the bar was called Freddie's or something like that. I honestly don't remember a lot of what we did there besides get drunk and try to take someone home with is. We used to keep count of how many people we fucked. I remember I brought home five people in one night.' You shake your head a little bit after hearing that partially because you don't think he took five people home in one night. Secondly you're pretty sure he's not lying about them keeping track. You ask if he remembers how many people he ended up taking home before he quit. 'I don't remember,'";
	say "     He chuckles, 'But I'm sure it was well over one hundred.' You let out a silent sigh while shaking your head in disbelief. 'You don't have to believe me,' he protests, 'but you could at least let me finish.' You apologize and let him continue his story. 'I was there for maybe a year and a half maybe two. But one day I saw that the local prison was hiring for jailers, and thought what the hell it'll be a good way to get into the police department. So I walked in got an application, and the next day I got a phone call for an interview. I, of course, nailed the interview and was offered the job on the spot. I was pretty excited about it at the time. I put my two weeks in at the construction company and moved on to the prison. The training was hell, and they made us practically fight each other and get pepper sprayed every day for a month.'";
	WaitLineBreak;
	say "     Finally, after that month of training, I was sent to guard the prison. I was sent to the maximum-security part of the prison. It was about 10,000 square feet, and they had about 20 guards in there at a time. This is where the worst of the worst prisoners were sent, excluding solitary confinement which is for those who can't be in the prison population, and they were rowdy. We had to let them out a few at a time for meals. So we'd escort five or six out to the door, and once they got out the door, we'd do it again and again until they were all out. Then, of course, we would have to wrangle them back in, and that in itself was a disaster. I swear almost every day a mini-riot would break out, and we'd have to wrestle down a ton of prisoners. Otherwise, they'd start punching and stabbing each other. I had a good time while I was there, I got close to some of the prisoners and really got to know them. One of my favorites was a serial killer name Robby; he was a special kind of crazy. He'd try to kill someone a few times a year, but the stories he told were amazing.'";
	say "     He pauses for a second like he's trying to remember something but shrugs and carries on 'I was at that prison for two or three years. I never moved up the ranks and rarely got a raise, but none the less it was fun, and I enjoyed it. Until one day, a riot ensued during lunch. All the officers in the building were to report to the lunch hall and try to stop it. It was chaos; prisoners were stabbing, punching, choking, and all around trying to kill one another. There were chairs flying everywhere people getting thrown across tables. It was a sight to see. It took us hours to apprehend everyone. I had to wrestle and handcuff at least forty prisoners, and I got roughed up quite a bit during that. I had four broken ribs and a concussion. Though I didn't have it the worst that day. We lost forty prisoners and two guards. It was rough on everyone, but we moved on and continued on as nothing had happened.'";
	WaitLineBreak;
	say "     You move a hand onto one of his broad shoulders. It is warm to the touch, and it feels like he's sweating a little, but he continues on with his story. 'It wasn't all bad after the riot though I still had fun on the job, and the inmates were much less rowdy for a while. I'd say it was about a month after the riot that the apocalypse happened and we were all changed. I never went back to work after that and I'm sure many people followed suit. I haven't gone anywhere near there since. I bet it's still standing and running even in this hell hole. Some people no matter what still show up to work until they can't anymore, and I'm sure they'd be in a lot of trouble if any inmates got out even though that should be the least of their worries.'";
	say "     You sit there in silence for a few seconds trying to process everything that he told you. You didn't know what to expect when you asked about him, but this certainly isn't it. You tell him that you enjoyed the story and thought it was cool. Mogs and Kogs still haven't said anything. They just sit there in awe of their leader. They must not have heard this story before. Gurke clears his throat and says 'You know I still have the handcuffs from when I was a jailer, why don't I use them on you?'";
	say "     [bold type]Do you take him up on the offer?[roman type][line break]";
	LineBreak;
	say "     ([link]Y[as]y[end link]) - Ogre bondage play? Yay!";
	say "     ([link]N[as]n[end link]) - No thanks, not right now!";
	if Player consents:
		LineBreak;
		say "     The thought of being ravaged by the ogre starts to get you a little hot and bothered. You look the ogre up and down and give him a sly grin. Picking up on your subtle hint, the ogre gets up and makes his way over to a tent. 'You two better not follow me,' Gurke shouts, 'This is my ass tonight.' Your face heats up a little at his act of possession. He can certainly be a very possessive guy when he wants to be. What is his, or that's at least what he thinks. You get up and follow him back to the tent. You see him rummaging around, clearly looking for his old handcuffs mumbling to himself, you decide to save him both time and effort by removing your clothes and setting them into a half-assed pile in the corner. Once you've removed all of your clothes, you stand there waiting for him to find the handcuffs. After what seems like forever, he finds his handcuffs and chuckles, 'I haven't used these things in what feels like ages. I'm sure they are strong enough to hold anyone.' He chuckles and turns to you. 'Well, look at that someone is really eager to get abused.' He says in a more seductive tone than usual.";
		say "     'Don't you worry, I might go easy on you. Unless you're enjoying yourself that is.' With that, you notice his already thick member growing larger in his, unnaturally, tight spandex. He wastes no time walking up to you and putting you into a chokehold. His grip isn't enough to cut off your oxygen, but it's enough to remind you who's in charge. You feel he soft skin pressing up against either side of your neck, and his arm is warm around your neck. Your member quickly starts to grow itself almost immediately hitting full mast. 'Well, well, well,' Gurke says, 'Someone just can't wait to be my little plaything.'";
		WaitLineBreak;
		say "     Your face gets hot again thanks to his teasing, and you just nod your head in response. With that, he forcibly grabs one of your wrists and forces it behind your back slightly above your rear. You feel the cold metal from the handcuffs slap your wrist and tighten with a quick zzztttt. The handcuffs were much colder than you expected. They send a rapid shiver up your spine once the cold metal fully wraps around your wrist. Before you have time to grow accustomed to the sudden chill, he grabs your other arm and places it right next to your other hand, and quickly locks that one in place. The small ice-cold chains in between are now touching your back, sending, even more, shivers up your spine. He finally wraps one of his hands around the back of your neck and walks you a few steps towards the middle and pushes you down onto a small pile of blankets. He carefully places you down onto the blankets. You help him out by bending your knees.";
		say "     Quickly he has you down face pressed into the blankets and ass high in the air. You can feel part of his, now, fully erect member pressing against one of your butt cheeks. The member is pulsing ever so slightly like it's begging to be freed and buries into your hole. Once Gurke has you in place his cock's wish is granted. He pulls down his underwear, and you feel his cock lightly smack your ass. It dribbles just enough precum so that you can feel the little wet dollop drip out of his cock head. 'You look pretty nice like this.' Gurk says, giving your ass a nice loud slap. The slap stings a little on impact but the stinging goes away in a matter of seconds. Admiring his work for a few seconds Gurke gives out a huff of approval before smacking his hefty cock against your ass cheeks.";
		WaitLineBreak;
		say "     You give out a quick moan in unison with his slaps. Amused at this Gurke slaps his cock against your exposed pucker. You give out a more drawn out moan this time which eggs him on even more. With each slap his cock dribbles out more and more pre eventually soaking your hole and a portion of his cock. 'Just because I like doesn't mean you aren't going to get the full prison experience,' Gurke chuckles, 'I hope you're ready.' And with that he lines his cock up with your exposed hole and slowly. Your hole gives little resistance as his cock head just pops right on in, causing you to give out a lust-filled moan. It feels so good you want, no, you need all of it in you.";
		say "     You push back, helping him slide in his monstrous cock inch by breathtaking inch. Finally your wish is granted, and you feel his plump balls resting on your thigh. Satisfied with his work, he gyrates his hips for a moment before he begins slowly fucking you. He starts out fairly slow, only inching himself in and out of you, with his strokes only becoming a little longer with each thrust. You can't help but moan beneath him while he takes advantage of your now stuffed hole, knowing damn well that you aren't going to stop him from doing what he wants. 'Mmmm.' Gurke says, 'You're just as nice as I remember. This won't take me too long. I hope you enjoy it.' Not a moment after his comments he starts jackhammering your hole. The smell of sex quickly engulfs the tent while you slowly become a moaning, lust-filled mess beneath him. His plump balls rapidly smack against your thigh with a nice smack. Other than your needy moans, you hear wet slurps with each and every thrust as your hungry hole tries to swallow Gurke girthy cock.";
		WaitLineBreak;
		say "     Your insides are stretched out to accommodate his size. His cock fills you with pure ecstasy. His cock easily glides against your inner walls while more pre paints your insides. You do the best you can to match his hectic rhythm pushing back every time he thrusts back in. He pushes your head down and grabs onto the cuffs to give him more leverage to pound you even harder than before. 'That's it,' Gurke groans, 'You take it like a good pet. I want to hear you moan.' Just as he commands you begin to moan even loader and begging him to keep fucking you. 'That's what I like to hear.' He says, 'Now I hope you're ready to get filled up with Ogre cream.' You don't quite get it at first but are soon hit by what he meant. Right on cue, the Ogre grunts and thrusts into with all his strength causing you to slip forward belly first into the blankets.";
		say "     His hot Ogre cum blasts squirt by squirt into you. Filling you with warmth while he continues to cum. Almost simultaneously, you find yourself orgasming, [if Player is male]your cock spurting your sticky seed between your stomach and the blankets[else if Player is female]your pussy leaking copious amounts of femcum[else]trembling and twitching in pleasure[end if]. Long after your own orgasm, Gurke's cock finally stops pumping you with his load. With a few heavy breaths, he pulls out of you, leaving you with a warm yet empty feeling, which is quickly followed by his warm cum trickling out of your abused pucker and down your balls. 'It looks like you had as much fun as I did,' Gurke said slightly out of breath, 'You're going to have my load up there for a while.' You nod waiting for him to shove his cock back inside of you, Unfortunately for you, he does not and you feel him unlocking the cuffs, and setting your hands free.";
		WaitLineBreak;
		say "     You have to admit that it was quite fun letting him have his way with you even though your shoulders are now stiff thanks to his handcuffs. You tell him you want to do it again but he gives you a soft pat on the ass. 'Maybe next time,' He says softly, 'but right now, I need to hit the hay.' You whimper slightly while he helps you up. You look him over once again, mainly focusing on his cum soaked cock, before putting your gear back on. He follows you out the tent giving your ass a hard slap, which lets loose a small amount of his cum. 'Well, I'm sure I'll be seeing you around again, especially after the pounding I just gave you.' Gurke laughs. You tell him that you'll stop by again sometime soon/ With that you say your goodbyes to everyone and head back to the city streets.";
		CreatureSexAftermath "Player" receives "AssFuck" from "Ogre Male";
	else:
		LineBreak;
		say "     You decline his offer and tell him that you're not interested in that right now. He lowers his head in disappointment for a moment before looking back up and saying, 'Oh, I get it you want something more hardcore than that. Well, don't you worry, I'll think of something so wild you won't possibly be able to say no.' You chuckle in amusement at his statement, then say goodbye to everyone as you make your way back to the city streets.";

to say MogsStory:
	say "     Deciding that you'd like to hear more about Mogs, you look over at him and ask what his life was like before all of this. He looks at you with a look of both excitement and confusion. 'You want to hear my story?' he stutters. You nod and urge him to tell you. 'Well, ok, I guess,' he says shakily, 'but I didn't do anything that special.' You remind him that it won't harm anything if he just talks about his previous life. 'Well, here goes nothing, I guess.' He starts.";
	say "     'I was born and raised in this city some years ago. I think I was born in the hospital, but I don't remember. Regardless I had a pretty shitty childhood, my mom was a drug addict, and my dad was abusive. Every day for years, I would come home and get beat or my mom was getting beat. This went on for around six years before the counselor in my high school noticed a black eye. Next thing you knew, I came home and my dad was getting put into the back of a police car and being taken away. That didn't stop there since there was a whole investigation; I was interviewed by police officers, prosecutors, you name it I had to talk to them. It took almost a year before they actually had a trail. Of course, he was found guilty and was sentenced to four years without parole. During that year my grades gradually slipped, and I began missing too much class and eventually just not going to class.'";
	WaitLineBreak;
	say "     'I dropped out shortly after the trial and started working at a local fast-food joint just down the road from my house. I absolutely hated it there but it helped my mom and me to pay the bills and keep a roof over my head. It was long after I started working that I went back and got a GED. I just couldn't stand the thought of working in a fast-food restaurant my entire life and wanted something better for myself.' You nod towards him as reassurance while he continues his story.";
	say "     'I'd guess it was about a year after I got my GED that I went to a community college in the area and got an automotive technology degree. It wasn't anything fancy like an engineering or medical degree, but always having to learn how to fix my family's car growing up, I figured it would help me get a job with something I know and sort of enjoyed doing. Not even three months later I got a job in a local mechanics shop. I worked on cars and cleaned up the shop five days a week and made far more money than I ever would've at my old job. I didn't mind the work, though it was hard and tedious, and I never stopped learning. There was always a new problem that I had to diagnose and fix, and a lot of things that I already spent my life fixing. I had a blast. I got to see all sorts of cars and trucks from junkers to exotic foreign cars that cost a fortune and a half.'";
	WaitLineBreak;
	say "     He pauses for a second before looking at the ground then back up. 'It was fun until the accident.' You look at him inquisitively and ask what the accident was. 'Well, it's simple, really,' he says. 'It was a cold day, and we had our large heater on. We closed up shop early since it was starting to get too cold to work without proper heating, which we didn't have. What we had was essentially a giant gas oven the size of a bar top. And as you can imagine, there are more flammable objects than one person would want to count in a mechanic shop. That night we had to leave the heater on so that our hydraulic lifts wouldn't freeze up amongst various other things.'";
	say "     'Unfortunately, something fell over while everyone was home and caught on fire. I'm guessing it was a flammable gas like aerosols or something like that because it blew up like a pipe bomb. The whole shop ignited, and everything in there went up with it, it was explosion after explosion; it took hours for the firefighters to put out the fire, and by then the entire shop was destroyed, not a single thing was left uncharred. The owner at the time decided that he was better off just taking the insurance money and leaving town. I never saw him again after that. He was old and getting ready to retire anyway so that was probably just an easy way out for him. After that I could never find a steady job. I bounced around from place to place never getting any footing. Eventually, I just gave up looking for work. Then one night I went to bed and woke up like this.'";
	WaitLineBreak;
	say "     You sit there jaw dropped a tiny bit. You never really expected this from Mogs. He's the quiet one sure, but you didn't expect some depressing back story. Still unsure as to what to say you just stare blankly until someone says something. 'Shit,' Mogs says, finally breaking the ice, 'I like my life much more now than I did back then. Honestly, this whole weird apocalypse, loss of humanity thing, has been the best thing to ever happen to me. I don't have to worry about money anymore. I can just beat someone, or steal, to get whatever I want. I met those two guys over there, and they have been the best friends I could have ever wanted. So I'm not going to go around moping about what happened in the past. I'm going to look forward to kicking more ass, and sticking my dick in anything I can.' The other two ogres cheer and begin chanting 'Mogs! Mogs! Mogs!' Though entirely bewildered by what he just said you join the other two in chanting before the four of you start bullshitting about this and that. Before too long you realize that you have to leave and bid everyone farewell before wandering back onto the streets, feeling a little bit more motivated than before.";

to say KogsStory:
	say "     Deciding that you're interested in what Kogs['] life was growing up, you look at him and ask him if he'd like to share anything about his life. He looks at you nervously and looks around at the other two ogres who look interested in learning more about his life before the apocalypse. 'Well, I guess I can. I want to warn you my life wasn't all that interesting before,' he says shakily while looking down at his feet. You reassure him that it doesn't matter if his life was all that exciting before, it's just an easy way to get to learn about people. Mogs and Gurke agree and continue to urge him. 'Well, I guess,' he says.";
	say "     Everyone gives Kogs their full attention before he starts. 'Surprisingly enough, I wasn't actually born here. I was born ten hours away from here in a small town of only seven hundred people, and I lived there up until high school. Life was pretty lackluster, to say the least, there. All that was there was one church, two bars, a restaurant, a grocery store, and a gas station. There wasn't much for work in town, so both of my parents worked in a city an hour away. I never got to see much of them between school and them getting home late. So life moved on, and I learned to take care of myself at a pretty young age. Then right before I was supposed to start my freshman year of high school, we moved here. My dad found a job making over twice what he made before, and it was an opportunity we couldn't miss. So two weeks after hearing the news, they found an apartment and off we went. Adjusting to city life was pretty tough for me. The nearest big city would seem like a small town compared to this place. It was hard to find where you're going, all the streets looked the same, and there were always way too many people.'";
	WaitLineBreak;
	say "     Everyone nods in agreement with Kogs, and he looks a little flustered but continues regardless. 'And uh, well the high school was huge and scary to be honest. There were more people crammed in that one school than in my home town. It took me months to adjust to it, and I managed to make a couple of friends along the way, but as time passed, everything was still too much for me here, and I hunkered down in my room most days, not wanting to go outside. I mainly played video games after homework and stuff, so I had a few hours every night to play. On weekends I didn't do much either, maybe every other week or so I'd hang out with friends, but for the most part, I'd just be by myself. I preferred it that way, being around too many people was just a headache. Anyway, the years passed and nothing changed.'";
	say "     'I went to school and kept to myself. Finally, my senior year came, and I got to graduate. My grades weren't anything great, but they weren't bad either, so I could've easily gone to college, but instead, I figured I would take a year off from schooling so I could figure out what I wanted to do before spending the money on secondary school. So like many other people my age, I picked up a job at the mall and worked there full time to help save up money for when I did go back to school. Unfortunately that never happened. One night I just went to bed and woke up like this, and the whole city was in chaos. I didn't leave the apartment for what felt like an eternity. I would just look out the window and watch everyone. I was always too scared to go outside. That was until I saw these two outside my window. They looked just like me, so I ran out the door and through the front exit to see them. And as you can see now, they took me in and we've been inseparable ever since.'";
	WaitLineBreak;
	say "     He finishes his story with a light smile. 'You should've seen how much you were shaking when we first met!' Gurke shouts bent over in laughter. 'You looked like a puppy walking downstairs for the first time. It was adorable.' Kogs blushes and shouts, 'It wasn't that bad. I just didn't know if you two were actually going to be nice. I was afraid you two were just going to beat me up and rape me. I saw a lot of that going on through the window.' Gurke still bent over laughing proclaims, 'Yet you came outside anyway knowing the risks. And if I don't recall that night you wanted some dick.' Kogs sweats a little, clearly embarrassed by Gurke's outburst. 'That's... that's not true. Isn't that right, Mogs?'";
	say "     He looks at Mogs for backup, and Mogs just shakes his head. 'I'm pretty sure you practically begged for it that night, but I don't remember so well, I was too drunk to stand up.' 'You two are the worst,' Kogs laughs. 'To think you'd ruin my story like that. I was starting to sound pretty cool.' Gurke, who somehow hasn't managed to pee himself yet, starts laughing even harder than before, trying desperately to stop and catch his breath to say something. Holding up a finger for some time he finally calms down before saying, 'Kogs, you definitely weren't starting to sound cool. You sounded like a lonely high schooler who had never talked to anyone in their entire life.' And just like that, Gurke was having another laughing fit, but this time he was joined by Kogs. For the next little while, the four of you sit around laughing, mostly at the expense of Kogs, without a care in the world, before you eventually have to bid them farewell and go on your way. 'Don't be a stranger now!' Kogs shouts. 'You're always welcome to hang with us.' You wave and begin walking back. Those three are a wild bunch, and maybe Kogs really was a lonely kid growing up.";

to say OgreHuntStories:
	let randomnumber be a random number from 1 to 3;
	if randomnumber is:
		-- 1:
			say "     Knowing the ogres hunt stories can be entertaining, you ask Gurke and the other two ogres to tell another story about their hunts. 'Well certainly,' Gurke says with a beaming smile. He appears to be genuinely happy that you want to hear more stories about their great hunts. 'Come sit next to us,' he says, patting the log he normally sits on. You make your way to the log and sit down. At first, it was a little uncomfortable, but you're starting to get used to it, and it's not so bad this time around. It's still a little cold and doesn't feel the best, but it's not all bad. Now sitting next to Gurke, he pats you on the back and says, 'Man, do we have a ton of stories we could share? I'm not sure where to start honestly.' He pauses for a few seconds, thinking about what would be a fun story to tell. He stays quiet for a few more seconds, and it starts to become an uncomfortable silence.";
			say "     A few more seconds pass by and he lifts up his hand and points a finger to the sky saying, 'I have the perfect one.' You look at him and see his beaming smile is back. 'This is a good one I'm sure you won't forget any time soon,' he says, still smiling; it looks almost unnatural with how wide his smile is. He gives you a hardy slap on the back and begins his story. 'This happened just a few nights ago,' he says. 'We were out just walking around minding our own business when this pack of huskies walked right up to us...' He pauses and looks around for a second while the other two ogres nod.";
			WaitLineBreak;
			say "     'I'd say there were roughly ten of their little husky playthings and then one leader. He wasn't all that big though, he was much smaller than any of us. To be frank, if he didn't have all that hair, he wouldn't be more than average, nothing impressive about him,' he says. 'Him and his little harem walked right up to the three of us looking for trouble. He had the balls to ask me what I was doing on his turf. That little shit had a smug look on his face and everything. He was just asking to get punched if you ask me. I told him to mind his own damn business and walk away before we beat the shit out of each and every one of them. Now I don't go around trying to pick fights as often as you'd think, just when necessary, and trust me this little pecker head deserved it.'";
			say "     'He laughed at me. He laughed right in my face and told me that he'd only ask me one more time to leave before he taught the three of us a lesson. So you know what I did?' he says, looking at you. You reply [']no['] and he continues. 'I walked towards one of his little bitches and grabbed her ass and said, [']Maybe I will stay and teach these girls how a real man fucks. They'd never come back to you after a night with the three of us.['] He didn't think that was very funny and ran up to me and sucker punched me while I was laughing. That wasn't cool of him. A man just doesn't sucker punch someone out of nowhere for an advantage.'";
			WaitLineBreak;
			say "     He chuckles a little bit before continuing. 'He backed away as soon as he punched me and told the girls to whoop up on the three of us. My jaw was still stiff at the time, but we easily took them out. They weren't a challenge at all. Honestly, I kind of feel bad for them. They never stood a chance, but they attacked us with everything they had, so, of course, we had to defend ourselves so we could teach that little punk a lesson. He looked pretty shocked at how fast we went through his girls.' He pauses for a second, either trying to think of the next part of the story or just reminiscing but before you have time to figure that out, he starts talking again.";
			say "     'Being true fighters and not some street thugs, the three of us talked over who should be the one to fight him. I, of course, believed I should because he sucker-punched me. The other two argued that they should continue so that they can practice fighting more. I reminded them that beating him up wouldn't be much practice and that I had a bone to pick with him. It honestly didn't take much convincing before they agreed with me.' He stops to look at the two of them who nod in agreement. 'It's only fair that Gurke got to beat him up,' Kogs says, snickering. 'Yeah, he is the one who got punched after all,' Mogs adds.";
			WaitLineBreak;
			say "     You nod and agree that it is only fair that he got to fight him. 'I'm glad we all agree with that, but can I get back to my story now?' Gurke demands more than asks. The three of you just give him a quick look, and he continues. 'Now after we all decided that I got to beat him up, I walked right on up to the smug little bastard. You should've seen his face. He was so scared I thought he was about to start running. But of course, having to be Mr. Tough Guy he laughed and told me it was going to take more than just one of us to beat him. I pushed him, and he fell straight to the ground. Too bad he got up so fast. It could've saved him a lot of pain had he just stayed down on the ground. Nonetheless, he got right back up and punched me in the jaw again. Things were starting to get serious. Nobody punches me in the jaw and lives to talk about it. I waited for him to punch me again and caught his fist with my hand. I grabbed onto his hand so tight I'm surprised I didn't crush it. His face was priceless; he looked like he was about to cry.'";
			say "     Gurke pauses to laugh wholeheartedly before resuming his story. 'I pulled him in really close and punched him right in the gut. He fell straight to the ground like a sack of potatoes. I was still holding his hand, so I picked him back up and did it again, and again, and again. I'd say I punched him in the gut at least seven or eight times before I let go of his hand. I'm not cold-hearted so I didn't keep kicking him while he was down. I told him a couple tricks to be a better fighter. But then as is tradition, I bent him over a nearby car and fucked him silly. I made that puppy scream in ecstasy it was so good. By the time I was done with him, he was almost unconscious. I'm pretty sure the girls he was with enjoyed the show, but I didn't have much time for them, so they only got to watch. Which is too bad for them because they looked like they really needed some good dick.' He laughed while rubbing the outline of his bulge. 'After I was satisfied we all just came back here and celebrated by getting drunk.' After his story, the four of you make small talk here and there before you tell them you have to go and wander back into the city.";
		-- 2:
			say "     Wanting to hear more of the ogres['] tales of their adventures, you chat up Gurke a little bit. Once the time is right, you ask him to hear another story of his triumphs against some of the monsters in the city. He chuckles a little bit and says, 'Of course. I have tons of stories for you. Come with me, and we'll sit down so you can hear about how great we are.' That seemed a little over the top, but you can smell the alcohol on his breath and understand that he's had his fair share to drink already, so he's probably going to be just a little full of himself. You follow him to the usual log next to the impromptu campfire they have stirring and take a seat next to him. Gurke wraps his large arm around your shoulder and leans in, saying, 'You'll really like this one.'";
			say "     The other two quickly make their way near you two and sit down across from you. It looks like they never get tired of hearing their leader's stories either. They are pretty over the top at times, but they make for a good time between the four of you. You also wonder what they do when it's just the three of them, other than fighting, but that's a question for a different time. Gurke clears his throat and begins, 'How about I tell you about the time that I took out the entire football team?' You give him a questioning look and ask him to clarify which one since there are two in the city. He pauses and looks a little dumbfounded for a second or two. 'The one with the gorillas, I didn't know there was a second one. I'll have to beat them up to.' You chuckle and let him continue.";
			WaitLineBreak;
			say "     'It was a rainy day, and I was walking around campus by myself. I like to go there every once in a while when I'm bored. I like to say it's so I can go to the library and read books, but you know me too well to believe that so I'll tell you the real reason.' You very subtly roll your eyes, knowing what he's about to say isn't going to be much of a surprise. 'I go there to get me some fine piece of ass. Nothing better than some college student ass. Let me tell you they are all of legal age and have so much energy. It's ripe for the picking.' He chuckles for a few seconds.";
			say "     'On this particular day, it was pretty quiet around campus. I didn't see much ass at all, and on top of that, all of what I saw turned me down. It was a pretty slow day for me. Oh well, they don't know what they missed out on. Anyway, I eventually made my way up to what they call Athletic Street or whatever. I don't really care what the name is I just wanna see some ass. So I got there, and things were looking pretty grim for poor old Gurke. Then I saw that there were a bunch of people leaving some big stadium looking thing. Of course, it did end up being a stadium, but I didn't know that at the time.' He looks around, making sure that everyone is still listening.";
			WaitLineBreak;
			say "     'Wow, was there a flood of nice ass pouring out of there. I thought I died and went to heaven. I didn't want to settle for just any ass anymore; I needed to know what brought so much ass to one place. So I walked inside. It was absolutely filthy in there. There were cups, wrappers, towels you name it everywhere. I was disgusted, and there was nobody inside besides the people picking up the trash. So I decided to wander around the stadium for a little while. Eventually, I made my way to the hallway, and all it said was a lockerroom. I heard some shouting and running water, so I found the door and walked right on in.' He takes a long breath and looks around again.";
			say "     'There were forty of fifty gorillas in there. It was packed to the brim in there. Well one of them saw me and shouted asking what I was doing there. Being the gentleman that I am, I told them I was looking for some fine piece of ass. I wasn't going to lie to them after all. I was there for ass and damn it I was getting me some ass. Well, they didn't take too kindly to it saying that it's their ass and whatnot. I didn't really care all too much about their rules or whatever. Before you know it, one of them jumped at me. He didn't make it too far, one punch and he was out cold. Then more and more of them started making a break either towards me or out the door. Most of them who ran out were still naked. I'm not going to lie, it was kind of funny. I'd say I knocked out nine or ten of them in a few punches before the ones who were in the showers came out to see what was going on. Everyone beside me and the unconscious gorillas had left.'";
			WaitLineBreak;
			say "     'There were six of them, and they didn't seem to be all too upset with me. They just asked what was going on. I told them that I was viciously attacked by them for no reason. They believed me since I'm a master wordsmith and just went about like nothing unusual happened. There was one who didn't take his eyes off me. He was the biggest of the bunch by far. He looked like he could easily lift any of the other ones up with just one hand. He, now he wanted to fight. He walked right up to me, still naked, and tried to put me in a chokehold. Well, I flipped him over my shoulder right onto the ground. He got up after a few seconds and tried again. This went on a few more times before he finally laid sprawled out on the floor.' Gurke wraps his arms around you, leans in and asks, 'You wanna know what I did next.'";
			say "     You nod slightly and say, sure. 'Good,' he says. 'Since I came there for a nice piece of ass I was getting it. And he was a real prize, not many people just run up and start a fight with me without backup. So I picked him up. Pinned him to a wall and started fucking him. To this day, he's still the best piece of ass I stuck my dick in on campus.' He outlines the bulge with a finger while talking. 'He moaned and moaned for me. He was such a needy little slut I couldn't get enough. I probably blasted five loads into his butt before we were done. Of course, I left him on the floor when I left, but still it was a great time. One of my favorite moments on campus that's for sure.' He finally stops tracing his dick, which now is clearly growing in size. He stands up and stretches a little bit before sitting back down. The four of you chit chat for a little while before you decide it's time to leave.";
		-- 3:
			say "     Again, you find yourself longing for more of Gurke's exciting tales. He may over exaggerate a bit, but he does tell some nice stories which still seem rather odd. You walk up to Gurke, who's busy throwing wood into the roaring fire. He clears his throat ever so slightly and gets ready to speak. But clearing your throat startles the ogre, who jumps back into you, knocking you flat on your butt. The two of you are taken back slightly; you for getting knocked to the ground by a startled ogre, and the ogre for you sneaking up on him. The ogre looked ready for a fight for just a split second before realizing that it was only you, and there was nothing to fight. 'Are you trying to give me a heart attack?' Gurke laughs. 'I know there is a hospital in the city and all, but do you really think most of the doctors and nurses there are qualified to be taking patients now?' You shake your head, partly questioning some of their sanity and the overall cleanliness of the hospital.";
			say "     'I'm just joking around, kiddo,' he says. Though getting called kiddo is kind of demeaning at this point, you brush it off like it never happened. 'I am serious about the hospital though, there is so much sex going on in there it's crazy. That reminds me of this one time I was sent in there for some medical supplies. Come have a seat, and I'll tell you about it.' You sit down, and as always, the other two hurry to sit down as well. Luckily you don't have to wait for him to come up with any stories this time around, and accidentally scaring him could lead to something interesting. Sitting down and trying your best to get comfortable, you give the ogre your full attention. 'Boy does this feel like it was a while back, but I remember it like it was yesterday. Hell, maybe it was yesterday,' he says. You doubt that it actually happened yesterday, but you leave it be, and he continues.";
			WaitLineBreak;
			say "     'I was out trying to gather some supplies for a few ogres who were sick. It wasn't anything serious, but a few of them were guards, and we didn't have enough people to replace them. So I was enlisted to help find some medicine. Our leader sent me out, and I hurried on over to the hospital. I did check a few houses along the way for what he wanted, but I didn't have any luck. It's like nobody ever got sick in this town or the houses were already looted.' He pauses for a few seconds as if trying to figure out why he couldn't find any medicine in nearby houses.";
			say "     'A little disappointed that I couldn't find any nearby I made my way to the hospital. It was weird though, I don't remember seeing a single creature out walking the streets that night. I swear I didn't see a single creature until I finally got to the hospital. When I got there, the place was almost surrounded by people. They were yelling, crying, and many of them were even fighting each other. It was almost like a fight club, shit was crazy. As much as I wanted to join in, I couldn't and just made my way into the hospital. I ducked and weaved through the mob and made my way inside. It seemed way too quiet in there for how many people were outside. To be honest, I was a little worried that something was wrong, and someone or something took out everyone that was inside. I walked down the empty, and poorly lit I might add, hallways. Eventually, there was this goat-looking thing standing there cleaning the floor with a mop. At this point, I was lost and decided to ask him where I could find any medical supplies.'";
			WaitLineBreak;
			say "     He pauses for a second to look around before continuing. 'Well let me tell you that was a mistake. That goat got so mad he swung at me with a mop. I kid you not a wet mop. It got dirty mop water all over me, and I was mad. This guy had the nerve to swing at me, oh boy, was he going to pay, and he did. I punched him a few times, grabbed his mop, and hit him with that just for the hell of it. He was knocked out cold before I hit him with the mop, but you can never be too careful. He might've been faking it. He wasn't because he didn't move an inch, and it broke over him. There's no way that didn't hurt.' He gives a snapping gesture with his hands.";
			say "     'At this point, I was so mad I couldn't think straight. So I stomped all over the hallways looking for a nurse or doctor. I eventually found a doctor, and guess what this bastard had a boner. He was just walking around with his rock hard dick hanging out. Well I socked him a new one. I knocked him out in one punch. There's a reason they are doctors and not fighters. Well, that's because they don't know how to fight. Some of them spent more time studying than working out. Which is ok in the normal world, but in the world we live in now it's a bad thing. It's rough out there. You can't just rely on brains anymore; you need some muscle to back you up from time to time.'";
			WaitLineBreak;
			say "     You nod in agreement, and he flashes a small smile. 'Well, after I knocked him out, three more of them joined in. Each one of them with a boner too. I started to think there was some kind of orgy going on in there. I tried to be civil and asked where I could get some supplies. They tried charging me for them. 500 credits per bottle. That's highway robbery if you ask me. How can you just price gouge necessary supplies like that? I was disgusted, so I knocked two of them out and demanded that the last one tell me where the supplies were. He refused at first, but after a few gut punches, he spilled the beans. Unlike them, I wasn't in the mood to fuck, I was sent there for one reason and one reason only. So I went where he told me and the supplies were there. He's lucky they were. Otherwise I was going to teach him a lesson for lying to me.' He cracks his knuckles.";
			say "     'I gathered all of the medicine I could, and made my way out of there. Unfortunately there was a small problem. There were still people outside. I couldn't just walk outside like nothing happened and just push my way through the crowd again. So I came up with a plan. I decided that if I can't just push my way through again I'd just fight my way through.' You nod slightly to signal that you are still paying attention.";
			WaitLineBreak;
			say "     'I had a brilliant plan too. I took some medicine and launched it out towards one side. A lot of people ran over in that direction, but there were still a lot of creatures around. For them, I just grabbed another mop and started swinging my way through the crowd. Most of them hurried out of the way but a few were unlucky enough to be on the receiving end of the mop. It felt like it took hours to get out of the crowd and I was exhausted, but I didn't take a break and made my way back to the leader with all the medicine he asked for and more. He was excited to see how much medicine I brought and rewarded me with the jacket I still wear to this day. I felt so honored to receive a gift from him. It was one of the best days I've had since all this happened.' You tell him that it's awesome that he got such a nice reward for his hard work. 'I know right,' he says with a bright smile. 'I'm pretty awesome like that if I do say so myself.' You reassure him that he is awesome, mostly out of courtesy. The four of you sit around the campfire a little while longer before you head on back to the streets.";
		-- 4:
			say "     You walk up to the three ogres to say hi. But Gurke interrupts you. 'The craziest thing just happened,' he shouts. 'You just have to hear this.' The ogre walks to his usual spot around the fire and grabs a beer he had sitting next to it and cracks it open. 'Well come and sit down,' he says, waving you over. 'Don't be shy. It's not like I'll hurt you. That bad.' He chuckles, obviously amused with himself. You decide to sit down next to him, and the other two ogres follow suit. You all sit down, and you take the seat closest to Gurke. He waits for the other two to sit down, tapping his fingers on his thigh. The other two finally sit down and he gives them a sharp glare for taking too long. Whatever this story is, he's really excited to tell you about it. He stretches a little bit, and then begins talking.";
			say "     'So as I was telling you the craziest thing just happened. You should've been here, it was great.' The other two nod and agree that it was pretty great. You ask him what happened, and he puts a finger to your lips. 'Shush,' he says. 'It's not polite to interrupt someone's story like that. You need to know what happened before that for the full effect.' The other two just nod and agree as always. 'So this morning we decided to go out towards the museum. We are men of class here as you already know and went there to learn a thing or two.' You roll your eyes, knowing that's what someone who went there to look would say. 'The first thing we saw was some lady throwing a dance party by herself. She didn't even care that nobody showed up to dance with her. She was just over there, dancing her little heart away. It was kind of nice and kind of creepy to witness. We left her to herself because we're not heartless and wandered around the museum a little bit.'";
			WaitLineBreak;
			say "     He looks around for a second before continuing. 'It didn't take too long for someone to try and jump us. There was this really ugly looking dude that popped out in front of us with this big club. It might've been closer to a log, I'm not quite sure now. Anyway, he just started swinging this big ass club around like it weighed nothing. It almost smacked me in the head a few times. Lucky for me, he didn't seem very bright, and I took the club right out of his hands and smacked him with it a few times. He went down like a log.' Gurke abruptly starts laughing, uncontrollably at his own joke for what feels like forever before finally composing himself and resuming his story. 'After I whooped up on this guy, we moved on again. We did take some of his jerky, though. I have to admit it wasn't half bad, but I'm pretty sure my breath still stinks because of it.' You give him a nervous chuckle hoping that he doesn't try to get you to smell his breath. Thankfully he doesn't and moves right along.";
			say "     'Next we saw these cats trying to steal stuff out of this glass container. We didn't know what to do, so we just let them be. Thinking about it now though it could have been worth a pretty penny, so I guess we should've just taken it from them after all, huh.' He looks at you, and you just nod, trying not to start an argument about morals. 'After we let them continue on with their stealing, we caught an eye of a giant mammoth. This thing was just a giant of a beast. I had to look up to get a full view of it. This damn thing tried to step on me. It just walked right on forward like I wasn't there. I've never felt so disrespected in my entire life. I wasn't about to just let it leave without facing the consequences.' You look around to see the other two sitting there listening intently.";
			WaitLineBreak;
			say "     'Taking this beast down was no easy task might I add. It was going to take more than just brute strength to take it down. So the three of us decided the best way to beat it up was to get its head down to ground level. So those two started attacking its knees. We figured it was the only way to get it to lower its head that low. It didn't seem like it was that dumb.' The other two stick their chests out, beaming with pride.";
			say "     'These two did a fine job. It may have taken them a few minutes, but they were able to make that thing collapse. I thought poor Kogs over there was going to get smashed. He was able to get out from underneath it at the last possible second before it would've crushed him. Now that the beast was down, I started taking shots at its head. I swear it took almost a hundred punches to beat that thing. I just kept wailing and wailing, sometimes changing where I punched and at what angle. Once I was all done, my arms felt like jelly they were so tired; I haven't had a workout like that in a long time. It felt like I was back in the good old days for a second there. Well after we defeated this giant, I came up with a brilliant idea. We should fuck it. It's not often you get to fuck something that big, and I wasn't about to miss out on that opportunity. Who knows I may have never gotten another chance.'";
			WaitLineBreak;
			say "     He gives a small chuckle before continuing. 'Man did we give this thing the dicking of its lifetime. It was so loud I couldn't hear myself think. It wasn't too tight, and it wasn't too loose; it was just right. We each took turns fucking it for a few rounds before eventually leaving it there. Happy with ourselves, we decided it was time to head on back here before we ran into another one or a group of them. That one was tiring enough. I don't think even I could've handled another one. The walk home was pretty uneventful. Though the lady was still dancing her heart out when we left the building.' You tell Gurke that was a pretty interesting story and Kogs and Mogs kept filling his head with how great he was. This goes on for some time before you decide it's best to leave before Gurke's ego gets inflated too much. You say goodbye to the three and head on back onto the monster-infested streets.";

to say OgreCampFuck:
	say "     You realize that having a good time with the ogres doesn't sound like a bad time so you give Gurke a seductive wink. Clearly not needing any more from you he picks you up and starts walking towards the campfire with you sprawled over his shoulders. 'Well, look at this boys,' Gurke shouts. 'Looks like we're going to be having fun tonight.' The other two ogres follow behind him with their cocks visibly growing in their underwear. The other two ogres move a log away from the fire, surely so that nobody gets burnt, and you are gently placed next to the log. 'Strip,' Gurke commands.";
	let randomnumber be a random number from 1 to 2; [adjust the latter number for the number of options]
	if randomnumber is:
		-- 1: [Assfucked]
			say "     You quickly remove your gear and toss it to the side. The ogres start to do the same, then turn around to show off their long thick members. All three of their cocks are rock hard and ready to go. Gurke leans you down on top of the log, placing your torso in the center of the log with your arms to either side. Kogs sits down on the log in front of your face setting his meaty shaft atop your head, and his plump balls fill your vision. You are hit with the strong scent of his musky balls; the smell overwhelms your nostrils and leaves your head spinning. They have a slight mix of a salty, sweaty, and dominant smell to them. You didn't even realize that dominance could be smelled, but it smells like you'd imagine it would. You take in a few long deep breaths trying to take all the scent in you can.";
			WaitLineBreak;
			say "     Going on behind you, your pelvis is draped off the side of the logs and your knees placed on the surprisingly warm ground. The warmth likely came from the fire cackling a safe distance away from the four of you. Gurke wastes little time stretching you out. You feel a thick wet something stroke against your pucker. You quickly realize it's Gurke's fingers and relax so he can just push it inside you. Gurke's finger is met with a little resistance, but he quickly overcomes and plunges his finger into your awaiting hole. You give out a lewd moan as his finger slides slowly into your ass until you feel his knuckles touch your rear. He pushes his finger in and out slowly, spinning it on occasion to check just how loose you are. After a few minutes of foreplay, he pulls his finger out and you feel something much larger take its place resting on your loosened up hole. His fingers are surprisingly thick, they could be mistaken for a thin cock. None the less you brace yourself for his actual cock.";
			say "     This go-around he is met with almost no resistance and his cock slides right into you. You give out a long drawn out moan while he slowly pushes his length into you. After a few moments you learn that he's bottomed out inside you. This incredibly full feeling spreads throughout your body, making you question why you don't just stay here and get stuffed with his cock twenty-four seven. But you quickly remember why you can't and decide to just live in the moment and enjoy this nice full feeling for as long as you can. After giving you some time to adjust to his large member, he begins rocking his hips with a quick but very short motion. This causes you to moan needily practically begging him to go faster. Your wish is his command, and he starts pulling out a little further and thrusting back in faster than before.";
			WaitLineBreak;
			say "     You feel your body get pushed across the log with each thrust back in. Wanting more fun, and not wanting any slivers, you start pushing back into the thrusts, matching his speed with pinpoint accuracy. You've been having such a good time with his cock you forgot about the other two until Kogs smacks your face with his thick cock leaving a small smear of precum in its wake. Not wanting to leave him out you open your mouth allowing him to push his cock into your maw. He steadily pushes his cock in, with little disregard to your comfort, until his plump balls bump against your chin. He slowly pulls his cock from your mouth then back in small pushes, giving you room to breathe if you need it. The taste of his thick member covers your tongue with a nice sweaty taste, with a hint of his salty precum.";
			say "     Still enjoying Kogs' nice little face fucking, you reach out and grab ahold of Mogs['] cock and begin jerking his hot member slowly. You do your best to multitask with all three of their cocks focusing on the pummeling that Gurke is giving you for a little bit, then trying to find ways to please Kogs['] cock that's made itself at home in your mouth, and stroking of Mogs['] thick member that is really dripping out pre. Gurke's hot member really starts to glide in and out of you with ease the more pre it drips into you. It's rubbing your walls in just the right way and really rubs against your prostate. Before too long, you find yourself clenching and [if Player is male]spraying a load onto the side of the log and ground below[else if Player is female]dripping femcum onto the side of the log and ground below[else]trembling in orgasm[end if]. 'Cumming already?' Gurke asks mockingly. 'We've only just started.' Without any hesitation, Gurke and Kogs begin feverishly fucking you from both sides.";
			WaitLineBreak;
			say "     You are pushed back and forth between the two ogres['] cocks in perfect harmony. Gurke pushes your face into Kogs['] thrusts and vice versa. This goes on for some time before Mogs starts to twitch and grunt. You start stroking him off even faster and soon enough, he lets out a loud moan and starts to shoot his load all over your neck and back. He paints you with his load spurt after spurt for some time before leaving your back almost covered with his warm cum. He quickly plops down on the ground to catch his breath. Kogs isn't far behind. Kogs grabs your head and buries his cock deep into your mouth and holds you in place while he pumps your stomach full of his load. Squirt after hot squirt of his cum is shot down your throat and into your stomach, and you greedily swallow it all for the duration of his quite lengthy orgasm. Finally spent he pulls his now soft cock from your mouth and rests it in front of you so that you can continue to lick his tip, which you do.";
			say "     After a few more minutes of Gurke's rough, ball slapping and slurp making fuck session he buries his bone deep inside of you and unleashes a torrent of his hot ogre cum into your deepest depths. He fills you up to the point you don't think you can hold his load anymore. Luckily you do and he frees his cock from your bred hole. 'Oh man,' Gurke sighs, 'did we do a number on you. You're covered head to toe in cum, and we bred you on both sides. You are a really nice slut, aren't you?' You blush at his compliment and thank him for the good time. 'Not to hit it and quit it,' Gurke says, 'but we do have to rest up now. We got plenty more fucking to do today, and as fun as it would be it can't only be with you.' You let out a quiet sigh and nod in agreement. 'Don't get too down. You're more than welcome to come back and be our little cum collector some other time.' Kogs says, smacking you in the face with his cock. The three of them chuckle then help you onto your feet. You stagger for a few seconds while your knees are still weak from the pounding you received. You hesitantly put your clothes back on and head back out onto the streets, waving to the three of them as you leave.";
			CreatureSexAftermath "Player" receives "OralCock" from "Ogre Male";
			CreatureSexAftermath "Player" receives "AssFuck" from "Ogre Male";
		-- 2: [ogre cock worship]
			say "     Following his command, you begin to remove your gear as the ogres around you do the same thing. A glance over your shoulder leaves you observing the other two massive, hulking brutes taking their underwear off, their still soft but very girthy and heavy cocks dangling between their enormous and muscular legs. The view clearly excites you, and you're urged to get your current task done as Gurke, already standing naked, assigns your next task. 'Me and the boys are in need of a good little pet to polish our spears,' he says, grabbing his thick member with one hand and suggestively stroking it. 'Think you can do a good job?' The others are also jerking their shafts to a full erection, and you can definitely smell their strong musk as they come closer to you, forcing you down on your knees as they surround you.";
			WaitLineBreak;
			say "     Your answer will come in the form of hard work and effort at pleasuring the ogres, as they begin to rub their meaty cocks around your head and face, smearing your skin with precum that is eagerly oozing out with each throb. Without any further ado, you grab two of them, Kogs['] and Mogs['], with each one of your hands, while providing Gurke the pleasure of being the first to receive the soft touch of your lips, kissing his shaft all over as your tongue slowly comes to join the action. 'That's a good start,' he says, grabbing his cock to have you lick more around the base, as he then puts his large hand on the back of your head to lead you to his heavy musky balls. The size of his sack is enough to cover your whole face as you get on licking his orbs all over.";
			say "     'Lick [']em good, pet. They've been needing a cleanup,' says Gurke as you do your best to oblige his command while keeping the other two entertained with both your hands, grabbing their cocks and stroking them as you continue to clean the balls in front of you with your tongue. The taste of sweaty musk is almost intoxicating, quite strong and masculine, which combined with the ogre's grunts and persistent erection, it only encourages you to continue. Though eventually, he is satisfied with your service on his nuts, and leads you over to his shaft and all the way to the tip of his pulsing hard meat. 'Good [boygirl]... now get the rest of it,' he orders, and you immediately wrap your lips around the head of his member, tasting the big ogre's slick, precum-coated glans.";
			WaitLineBreak;
			say "     Though you have to open wide in order to get his whole girth in your mouth, he gives you a pat on the head and compliments your effort. While you continue to give Kogs and Mogs your best attempts at handjobs, you give Gurke a persistent, enthusiastic blowjob with lots of tongue wiggling and sucking, which causes him to grunt in satisfaction. 'Hnng... You're doing a good job indeed...' he comments, appreciating your warm and wet mouth around his big cock, pleasuring him just the way he wants you to. His grasp around your skull tightens as he pulls you, forcing more of his length in your mouth, threatening the limits of your jaw... But you endure everything like you are told. He thrusts in a couple of times, almost making you choke on that monstrous dick before letting go of you, only to grab your chin and make you look to his face as you catch your breath.";
			say "     'Who's a good [boygirl]?' he teases you, slapping your cheeks with his heavy cock, nearly bruising your face with how heavy and big his member is. 'Such a good little slut... You like some thick ogre cock, eh? Why don't you give my brothers some attention, now?' he asks you, but instead of waiting for you to make a move, he grabs your head once more and leads you to one of the cocks on your side. Without any choice left, you let your lips part and gobble on the throbbing dick eager to enter your mouth, and you gladly welcome it with all you have got. Your hands are always occupied with the other two you don't have your mouth on, and in good will, you alternate between Mogs['] and Kogs['] dicks, one at a time, occasionally pulled and pushed by Gurke as he tells you which you should go for whenever he wants.";
			WaitLineBreak;
			say "     At some point, the three ogres are demanding your attention, and you give all three a good share of sucking, ten or so seconds of your soft lips wrapped around their veiny and sizable girths which keep on leaking. Slurping all the salty liquid along the way, you go from one cock to the other, then to the other, and back to the first, only getting the ogres more and more excited as they thrust into your face. Your head is then pushed downwards and gets absolutely smothered between their musky balls as they take some time to stroke their dicks, having you lick all over their six orbs in total. You not only put your tongue to work, but your lips are also there, kissing and smooching every angle of those salty sacks, overwhelming you with that masculine scent that leaves you blissfully lightheaded.";
			say "     'You like that, don't you, little pet?' Gurke keeps teasing you, and it does not stop there. While two of the ogres are stroking their cocks, one of them decides they want more of your mouth, so you get two pairs of balls rubbing against your face while you are sucking one of the dicks. Gurke is the first, as always, and then it is Kogs and Mogs, in their respective order, all the while they seem to be approaching the edge. 'Ready for your reward? It's your favorite!' The three ogres grab their dicks and point them towards your head, occasionally rubbing the tips across your face and smearing you with more precum, leaking like faucets... But that is about to change into a much, much messier situation.";
			WaitLineBreak;
			say "     As they pick up the pace, all the ogres start to cum after several seconds of stroking, shooting a great amount of thick ogre cum with each powerful spurt as they roar in lust. Their orgasms last for a long time, and eventually, you get covered from head to feet in an avalanche of creamy jizz coming from all three of them. Once their climaxes subside, they look down on you with grins on their faces, appreciating your self covered in their manjuices. 'Thanks, we really needed a good little pet to service us. You are a really nice slut, aren't you?' You blush at his compliment and thank him for the good time. 'Not to hit it and quit it,' Gurke says, 'but we do have to rest up now. We got plenty more fucking to do today, and as fun as it would be it can't only be with you.' You let out a quiet sigh and nod in agreement. 'Don't get too down. You're more than welcome to come back and be our little cum collector some other time,' Kogs says, smacking you in the face with his cock.";
			say "     They then help you get up and clean up before you are all ready to gather your things and go. You hesitantly put your clothes back on and head back out onto the streets, waving to the three of them as you leave.";
			CreatureSexAftermath "Player" receives "OralCock" from "Ogre Male";

to say OgreMissionTalk:
	say "     Once again, you end up wanting to chat with the ogres after hearing more about them and what their lives were before this. You have to admit that they are much better storytellers than you would've imagined. Though you assume all of their stories about slaying beasts and whatnot are ever so slightly exaggerated, you can't help but hear more of their tales. You walk up to Gurke, asking him if there are any stories he could think of. He stands there for some time before shaking his head. 'None that you'd be interested in.' Still shaking his head, 'I guess I could tell you more about what us and the other ogres are planning.' You look at him a little bewildered that he'd give away such sensitive information just like that, then you remember that he already spilled the beans in a different story. Deciding to hear him out, you nod and tell him you'd love to hear more about their mission.";
	say "     'I wouldn't call it a mission,' he says, shaking his head. You don't really know what else it could be called, a job, quest, maybe even hunt, but you don't bring it up and let him continue. 'As you already know, we were tasked to figure out where the orcs['] lair was, which we did without much effort.' He lifts his left arm up and flexes, 'Everything seemed a little too easy if you ask me. Most orcs are too tough headed to just give up information like that, and I know damn well they wouldn't get turned into little fuck toys so easily either. My guess is we found one of their little breeders. They'll tell you anything for some dick. Let me tell ya, I've fucked a few of those pathetic creatures in my time, and they will practically beg you to fuck them over and over again without any hesitation. To be honest, it isn't any fun fucking them over and over again if they're little sluts to begin with. It's more fun fucking them so hard that you turn them into weak little sluts, then you have a sense of pride once they start begging for more. Though when they start following you around, it ruins the whole thing.'";
	WaitLineBreak;
	say "     You remind him that he's getting off track. He just laughs full-heartedly and continues. 'Getting a little jealous, are we? Don't worry, you're always welcome to jump on this dick any time.' He gives you a sly wink before continuing. 'Where were we before you interrupted me?' He pauses for a few seconds trying to backtrack the conversation. 'Right, how we found the information. It was easy, just fucked it out of the thing. Had I known before wasting all of my energy interrogating him in front of the lair - I didn't know it was the lair until after - I would've just walked right on in and beat every single one of their asses myself. Unfortunately I was just too tired after all that interrogating to even try. So I went back and told our leader that we found the base and that it wasn't guarded on the outside at all. That we could just walk on in there and start kicking ass. Our leader wasn't too keen on the idea, and he told us that we couldn't just walk on in there without knowing what it looked like inside. So we sent in a spy. He should be done any day now and give us all the information we need to plan an attack on their lair.'";
	say "     You give him a concerned look and ask what they plan on doing once they break in. 'That should be easy to see,' he chuckles. 'We're going to break in, kick their asses and fuck them senseless. What else would we do?' He tilts his head as if waiting for a response. You shrug and say you don't know. 'It's not like we'll kill [']em or anything crazy like that,' he says. 'That's not how we like to do things. We're not barbarians. We just want them to stop messing with us, and the best way to do that is to ruin their pride. Besides afterward they'll be too busy fighting each other over who gets ogre dick next to be messing with us. We'll turn [']em into cock hungry sluts.' You give a silent sigh of relief knowing that no one is going to get seriously harmed, just their egos.";
	WaitLineBreak;
	say "     'There's really nothing to it, we go in, kick some ass, fuck some ass, and leave. If they stopped trying to boss some of us around, this wouldn't be a problem. Just because we got a little more heft on us than those muscles do doesn't mean they are superior.' You nod in agreement. 'Plus, they turned one of us into their slave, and we are going to get revenge for our fallen brother. It's as simple as that.' You ask if they plan on freeing their fallen friend. 'We won't be able to, I doubt we'd be able to recognize him at this point and he's more than likely too far gone to be saved. All that we'd have is a cock hungry version of him, and it's just not the same. If we do find him and he's half of what he used to be, we will for sure get him out of there, but we aren't getting our hopes up. Any other questions?' You shake your head, and he gives a small smile. 'Well, then that's all I can do for ya then.' With that, you two both get up and bid each other farewell while you make your way back to the monster-infested streets.";

to say OgreLeaderTalk:
	say "     Deciding you want to know more about this ogre leader, you walk up to Gurke and ask to learn more about their leader. 'Well, you're looking at him.' Gurke laughs and is quickly followed by Kogs and Mogs. You shake your head and tell him you meant the leader of all the ogres and not just his group. 'Oh, you mean Tarth. He's a good guy. What do you want to know?' You tell him you'd just like a little bit of insight on the guy. 'Well, I guess I can give you a rundown of what he's like,' he says cheerfully. 'Tarth is a big guy,' he says. 'He's probably half a foot taller than me and weighs a hundred fifty pounds more than I do.' Curious to know Gurke's weight, you ask. 'A lot,' he says, though that did absolutely nothing to answer your question, but before you have time to respond, he continues.";
	say "     'He's not only the fattest, and tallest of us all. He's by far the strongest. One time he picked up a truck and threw it a whole city block because it was in his way. He certainly has a temper on him, to say the least.' He looks down at his feet for a brief moment before looking at the other two who just nod and agree. They seem a little frightened for a moment, but Gurke keeps his composure and continues. 'Even with his temper he's a super cool guy. He certainly does care about each and every ogre. He takes us in, feeds and teaches those who don't know how to fight the basics of fighting. He'd do just about anything for an ogre in trouble. That's why we're planning this whole orc raid. Because he wants revenge for hurting one of our brothers. He also has this belt with teeth he's knocked out of creatures he's defeated. I hear that it's over a hundred teeth on that belt.' You nod knowing that he's likely exaggerating again, but it does make for a better story, so you let him continue uninterrupted.";
	WaitLineBreak;
	say "     'Rumor has it he once took on an entire orc army and defeated them single-handedly. I really wish I was as strong as him, but he wipes the floor with me every time we spar.' You find that a little hard to believe having seen him fight and hearing Gurke's stories about all of the monsters he's beaten up, but if it's true, Tarth sounds like someone you don't want to make angry. You tell Gurke that he sounds really cool, but before you have a chance to follow up that statement, he cuts you off. 'You're damn right, he's cool!' he shouts at the top of his lungs. 'Never in my life have I met someone as strong and brave as him. He's like a post-apocalyptic warlord. There's nothing he can't do. He can even lead an army of ogres and trust me, we are a hard group to bark orders too. We like doing our own thing and doing things our way. We don't take too kindly to being bossed around, but when he tells us what to do, we do it no questions asked and with a smile on our face.'";
	say "     His face glows with excitement just talking about Tarth. 'Besides, we do really need him to keep us in check. Without him, we'd be beating everything up without direction. Now we at least have direction. Now here's a little tidbit that will be more exciting for you. He, by far, has the largest cock of us all. I'm talking in every which way; he's the longest and the fattest out of everyone, which unsurprisingly also describes his body.' That last bit does grab your attention - you know just how long and fat these three cocks are and just imagining something longer and wider is slightly arousing and intimidating.";
	WaitLineBreak;
	say "     'I knew that would pique your interest; I saw that little glimmer in your eye after I mentioned it. Who knows, maybe one day you'll get to see it. I'm sure that would make you pretty happy,' he says with a not so subtle wink. He looks around at the other two and asks if they have anything to add. 'You forgot to mention his scar,' Kogs says. 'I did forget to mention that, Kogs. Why don't you tell him about it?' Gurke says, motioning for him to start talking. 'Well, he has this scar that runs from the middle of his cheek down to the middle of his chest,' Kogs says. 'Apparently it's from when he fought the orc army, he got that scar from getting hit with a sword.' Gurke nods and agrees with Kogs, looking at Mogs. 'I think that's about it. You two have covered everything,' Mogs says cheerfully.";
	say "     'Well, that's everything you need to know about Tarth.' You ask if there's a way that you can meet him. Gurke justs laughs and says, 'I'll tell you how you can meet him some other time.' The four of you just sit there in silence for a few minutes not sure what to talk about next. Eventually, you realize that there isn't going to be much more meaningful conversation. You decide that it's best to just take your leave. You say your goodbyes and head out.";

to say OgreLeaderMeet:
	say "     You've heard an awful lot about the ogre leader. You've grown more and more interested in meeting him. You decide it's best to ask Gurke since he seems to close their leader Tarth, he should be able to pull some strings and set up a meeting, right? You walk up to the ogre and ask him if there is a way you can meet Tarth. 'I'm not entirely sure.' He says resting his fist under his chin in thought. 'He's hard to get a hold of at times even for me.' You look down slightly discouraged.";
	say "     'But,' Gurke says, 'If you were able to go around and do stuff for his cause, he might catch wind, or I'll even bring up that there's someone with the same goal in mind.' You look at him a little less discouraged. 'As you know, we are trying to raid the orc base after what they did to one of our own. Just taking him captive and making him their breeder. It's disgusting, and I get so angry every time I talk about it. If you were up to it though, I'm sure there are a few things that you could do.' You continue staring blankly at him, waiting for him to get to what you have to do to meet Tarth.";
	WaitLineBreak;
	say "     'I guess one thing you could do is take out a few orcs here and there. You could break in and learn more about them or even just start talking to random creatures about how much you hate the orcs and want them to be taught a lesson. Though just beating them up should be more than enough. Beating up enough of them would really catch his attention. We don't solely rely on other ogres to get stuff done; we are always open to other allies that could blend in easier.' He pauses for a moment and takes a long look at you before continuing. 'Now you should really take time and think this over, though. You don't want the orcs coming after you next or sending hunting parties out for you. You'd be putting yourself in a lot of anger over this. So, I repeat, do take time to think this over and come back to me with a decision, ok?' With that, the ogre waves you off in order not to persuade you either way.";
	say "     <Writer's Note: This is the current end of the ogre content. Please check back in the future for continuing this string of events.>";

Section 2 - Creature Insertion

Table of CombatPrep (continued)
name(text)	PrepFunction(text)
"Ogre Male"	"[PrepCombat_Ogre Male]"

to say PrepCombat_Ogre Male:
	say "";

Table of Random Critters (continued)
NewTypeInfection (truth state)	Species Name	Name	Enemy Title	Enemy Name	Enemy Type	Attack	Defeated	Victory	Desc	Face	Body	Skin	Tail	Cock	Face Change	Body Change	Skin Change	Ass Change	Cock Change	str	dex	sta	per	int	cha	sex	HP	lev	wdam	area	Cock Count	Cock Length	Ball Size	Nipple Count	Breast Size	Male Breast Size	Cunt Count	Cunt Depth	Cunt Tightness	SeductionImmune	Libido	Loot	Lootchance	TrophyFunction	MilkItem	CumItem	Scale (number)	Body Descriptor (text)	Type (text)	Magic (truth state)	Resbypass (truth state)	non-infectious (truth state)	Cross-Infection (text)	DayCycle	Altcombat (text)	BannedStatus (truth state)
--	--	--	--	--	--	--	--	--	--	--	--	--	--	--	--	--	--	--	--	--	--	--	--	--	--	--	--	--	--	--	--	--	--	--	--	--	--	--	--	--	--	--	--	--	--	--	--	--	--	--	--	--	--	--	--	--;

When Play begins:
	Choose a blank row from Table of Random Critters;
	now NewTypeInfection entry is false;
	now Species Name entry is "Ogre"; [ Name of the overall species of the infection, used so a "male x" and "female x" have "pureblood X" children. ]
	add "Ogre Male" to infections of OtherworldlyList;
	add "Ogre Male" to infections of MaleList;
	add "Ogre Male" to infections of BipedalList;
	now Name entry is "Ogre Male";
	now enemy title entry is "Male Ogre"; [ Name of the encountered creature at combat start - Example: "You run into a giant collie." instead of using "Smooth Collie Shemale" infection name. ]
	now enemy Name entry is ""; [ Specific name of unique enemy. ]
	now enemy type entry is 0; [ 0 = non unique enemy; 1 = unique (unknown name); 2 = unique (known name) | Used to disqualify unique enemies from Vore/UB and showing the enemy name in encounters. ]
	now attack entry is "[one of]The ogre hits you![or]With a swing of his bat, the ogre smacks you in the stomach, knocking the wind out of you![or]He charges you shoulder-first, slamming his shoulder into your chin.[at random]";
	now defeated entry is "";
	now victory entry is "";
	now desc entry is "";
	now face entry is "";
	now body entry is "";
	now skin entry is "";
	now tail entry is "";
	now cock entry is "";
	now face change entry is "";
	now body change entry is "";
	now skin change entry is "";
	now ass change entry is "";
	now cock change entry is "";
	now str entry is 20;
	now dex entry is 8;
	now sta entry is 22;
	now per entry is 12;
	now int entry is 8;
	now cha entry is 8;
	now sex entry is "Nochange"; [ Defines which sex the infection will try and make you. current options are 'Male' 'Female' 'Both']
	now HP entry is 80; [ How many HP has the monster got? ]
	now lev entry is 10; [ Level of the Monster, you get this much HP if you win, or this much HP halved if you loose ]
	now wdam entry is 15; [ Amount of Damage monster Does when attacking.]
	now area entry is "Nowhere"; [ Case sensitive]
	now Cock Count entry is 1; [ number of cocks if sex is 'Male' or 'Both' ]
	now Cock Length entry is 16;
	now Ball Size entry is 3; [ Size of balls ]
	now Nipple Count entry is 2; [ Number of nipples. ]
	now Breast Size entry is 0; [cup size as number, counting Flat Pecs = 0, A = 1, B = 2, ...]
	now Male Breast Size entry is 0; [ Breast size for if Sex="Male", usually zero. ]
	now Cunt Count entry is 0; [ number of pussies if sex is 'Female' or 'Both' ]
	now Cunt Depth entry is 0; [penetrable length in inches; some minor stretching allowed, or more with Twisted Capacity]
	now Cunt Tightness entry is 0; [size 1-5, generates adjectives of extremely tight/tight/receptive/open/gaping]
	now SeductionImmune entry is false;
	now libido entry is 75; [ As part of infection, the Player will be gradually moved towards this value; also used for the creature's seduce defense as a penalty ]
	now loot entry is ""; [ Loot monster drops, usually infective with the monster's _own_ strain (for example if there is a Cross-Infection from sex)]
	now lootchance entry is 0; [ Chance of loot dropping 0-100 ]
	now MilkItem entry is "ogre male milk"; [ Item to be given to the player if they have this infection and milk themselves. ]
	now CumItem entry is ""; [ Item to be given to the player if they have this infection and jerk off. ]
	now TrophyFunction entry is "-"; [ Function to generate a list of optional loot items, of which the player can choose one after victory. ]
	now scale entry is 4; [ Number 1-5, approx size/height of infected PC body: 1=tiny, 3=avg, 5=huge ]
	now body descriptor entry is "ogre";
	now type entry is "ogre";
	now magic entry is false;
	now resbypass entry is false;
	now non-infectious entry is true;
	now Cross-Infection entry is ""; [ Infection that this infection will give the player when they lose; can be left empty if they infect with the monster's own strain. ]
	now DayCycle entry is 0; [ 0 = Up at all times; 1 = Diurnal (day encounters only); 2 = Nocturnal (night encounters only);]
	now altcombat entry is "default";
	now BannedStatus entry is false;

[
Table of New Infection Parts (continued)
Species Name	Name	Body Weight	Body Definition	Androginity	Head Change	Head Description	Head Adjective	Head Skin Adjective	Head Color	Head Adornments	Hair Length	Hair Shape	Hair Color	Hair Style	Beard Style	Body Hair Length	Eye Color	Eye Adjective	Mouth Length	Mouth Circumference	Tongue Adjective	Tongue Color	Tongue Length	Torso Change	Torso Description	Torso Adjective	Torso Skin Adjective	Torso Adornments	Torso Color	Torso Pattern	Breast Adjective	Breast Size	Male Breast Size	Nipple Count	Nipple Color	Nipple Shape	Back Change	Back Adornments	Back Skin Adjective	Back Color	Arms Change	Arms Description	Arms Skin Adjective	Arms Color	Locomotion	Legs Change	Legs Description	Legs Skin Adjective	Legs Color	Ass Change	Ass Description	Ass Skin Adjective	Ass Color	Ass Width	Tail Change	Tail Description	tail skin adjective	Tail Color	Asshole Depth	Asshole Tightness	Asshole Color	Cock Change	Cock Description	Cock Adjective	Cock Color	Cock Count	Cock Girth	Cock Length	Ball Description	Ball Count	Ball Size	Cunt Change	Cunt Description	Cunt Adjective	Cunt Color	Cunt Count	Cunt Depth	Cunt Tightness	Clit Size
--	--	--	--	--	--	--	--	--	--	--	--	--	--	--	--	--	--	--	--	--	--	--	--	--	--	--	--	--	--	--	--	--	--	--	--	--	--	--	--	--	--	--	--	--	--	--	--	--	--	--	--	--	--	--	--	--	--	--	--	--	--	--	--	--	--	--	--	--	--	--	--	--	--	--	--	--	--	--	--;

When Play begins:
	Choose a blank row from Table of New Infection Parts;
	now Species Name entry is ""; [ Name of the overall species of the infection, used so a "male x" and "female x" have "pureblood X" children. ]
	now Name entry is ""; [matching infection name to Table of Random Critters]
	now Body Weight entry is 5; [scale of 1-9 for body weight, grouped into low weight (1-3), mid weight (4-6) and high weight (7-9)]
	now Body Definition entry is 5; [scale of 1-9 for body definition, grouped into low muscle (1-3), mid muscle (4-6), high muscle (7-9)]
	[Body Adjective is generated out of the body weight and body definition and can be used in scenes - one word descriptive adjective depending on weight and definition groups: low weight group: skinny/slender/lithe; mid weight group: average/fit/muscled; high weight group: pudgy/husky/jacked]
	now Androginity entry is 5; [1-9 scale of hypermasculine to hyperfeminine]
	[Gender Adjective is generated out of androginity 1-9: hypermasculine/masculine/effeminate/somewhat effeminate/androgynous/feminine butch/tomboyish/feminine/hyperfeminine]
	now Head Change entry is ""; [partial sentence that fits in: "Your head and face [one of]tingle[or]go flush[or]vibrate with odd pleasure[or]go cold[or]feel oily[at random] as [head change entry]."]
	now Head Description entry is ""; [partial sentence that fits in "Your face and head resemble that of [Head Description of Player]. You have [Eye Adjective of Player], [Eye Color of Player] eyes and an overall [Gender Adjective of Player] appearance."]
	now Head Adjective entry is ""; [one word descriptive adjective (avian/canine/...)]
	now Head Skin Adjective entry is ""; [one word descriptive adjective]
	now Head Color entry is ""; [single word color adjective for the dominant color of the skin/fur/feathers/scales]
	now Head Adornments entry is "";[partial sentence that fits in "Before moving on from your head, you give your [Head Adornments of Player] a proud glance followed by a light caress."]
	now Hair Length entry is 2; [hair length in inches]
	now Hair Shape entry is ""; [one word shape descriptor (curly/straight/...)]
	now Hair Color entry is ""; [one word color descriptor]
	now Hair Style entry is ""; [one word style descriptor (ponytail/mohawk/buzzcut/...) to fit "On top of your head you have [Hair Length of Player] inch long, [Hair Shape of Player] [Hair Color of Player] hair in the [Hair Style of Player] style."]
	now Beard Style entry is ""; [short beard style (goatee/3-day stubble beard/porn stache/mutton chops beard/...) to go into "You have a [Hair Color of Player] [Beard Style of Player]."]
	now Body Hair Length entry is 0; [numerical value, 0-4 (no body hair/light/moderate/heavy/furry) - only set to > 0 if the infection does not have fur/scales/etc. !]
	now Eye Color entry is ""; [one word color descriptor]
	now Eye Adjective entry is ""; [one word descriptive adjective (slitted/round/...)]
	now Mouth Length entry is 3; [inches deep for face fucking; maximum possible will be double this number (when deep throating)]
	[Mouth Length Adjective is generated by a function and can be used in scenes too - "petite, shallow, average, deep, bottomless"]
	now Mouth Circumference entry is 3; [mouth circumference 1-5, see Mouth Circumference Adjective]
	[Mouth Circumference Adjective is generated by a function and can be used in scenes too - "tiny, small, normal, wide, gaping"]
	now Tongue Adjective entry is ""; [one word descriptive adjective (wide/slobbery/...)]
	now Tongue Color entry is ""; [one word color descriptor]
	now Tongue Length entry is 3; [length in inches]
	now Torso Change entry is ""; [partial sentence that fits in: "Your torso [one of]tingles[or]goes flush[or]vibrates with odd pleasure[or]goes cold[or]feels oily[at random] as [Torso Change entry]."]
	now Torso Description entry is ""; [partial sentence, fitting in "Looking down at yourself, you appear [Gender Adjective of Player] with a [Body Adjective of Player] build. Your torso is [Torso Description of Player][if Body Hair Length of Player > 1], covered in [Torso Color of Player] skin and [Body Hair Description of Player][else if Body Hair Length of Player is 1], covered in smooth, [Torso Color of Player] skin[end if]."]
	now Torso Adjective entry is ""; [one word descriptive adjective (avian/canine/...)]
	now Torso Adornments entry is ""; [(pouch/udders/...); partial sentence to fit: "You take a moment to feel your [Torso Adornments of Player]."]
	now Torso Skin Adjective entry is ""; [one word adjective (feathered/furred/scaly/...); EMPTY "" for creatures with just skin]
	now Torso Color entry is ""; [single word color adjective for the dominant color of the skin/fur/feathers/scales]
	now Torso Pattern entry is ""; [single word color adjective for the dominant pattern of the skin/fur/feathers/scales]
	now Breast Adjective entry is ""; [adjective(s) example: round, pointy, perky, saggy, bouncy. This would serve as either a general appearance of a infections breasts or possibly something that may be effected by a item or NPC.]
	now Breast Size entry is 0; [cup size as number, counting Flat Pecs = 0, A = 1, B = 2, ...]
	now Male Breast Size entry is 0; [cup size as number, counting Flat Pecs = 0, A = 1, B = 2, ...]
	now Nipple Count entry is 2; [count of nipples]
	now Nipple Color entry is ""; [one word color descriptor]
	now Nipple Shape entry is ""; [shape example: any shape will do as long as it has a baseline with a current infection or item]
	now Back Change entry is ""; [partial sentence that fits in: "Your back [one of]tingles[or]goes flush[or]vibrates with odd pleasure[or]goes cold[or]feels oily[at random] as [Back Change entry]."]
	now Back Adornments entry is ""; [partial sentence to fit: "Your back tickles with the feeling of movement caused by [back adornments of Player]."]
	now Back Skin Adjective entry is ""; [one word adjective (feathered/furred/scaly/...); EMPTY "" for creatures with just skin]
	now Back Color entry is ""; [single word color adjective for the dominant color of the skin/fur/feathers/scales]
	[Limbs Adjective is generated by a function and can be used in scenes too - "rail-thin, slender, sinewy, average, firm, muscular, flabby, meaty, rippling"]
	now Arms Change entry is ""; [partial sentence that fits in: "Your arms [one of]tingle[or]go flush[or]vibrate with odd pleasure[or]go cold[or]feel oily[at random] as [Arms Change entry]."]
	now Arms Description entry is ""; [partial sentence to fit: "Your [Limbs Adjective of Player] arms are [Arms Description of Player]."]
	now Arms Skin Adjective entry is ""; [one word adjective (feathered/furred/scaly/...); EMPTY "" for creatures with just skin]
	now Arms Color entry is ""; [single word color adjective for the dominant color of the skin/fur/feathers/scales]
	now Locomotion entry is ""; [one word adjective: (bipedal/quadrupedal/octapedal/serpentine/sliding)]
	now Legs Change entry is ""; [partial sentence that fits in: "Your legs [one of]tingle[or]go flush[or]vibrate with odd pleasure[or]go cold[or]feel oily[at random] as [Legs Change entry]."]
	now Legs Description entry is ""; [partial sentence to fit: "As your inspection goes even lower, you come to the two [Body Adjective of Player] legs supporting you. They are [Legs Description of Player]."]
	now Legs Skin Adjective entry is ""; [one word adjective (feathered/furred/scaly/...); EMPTY "" for creatures with just skin]
	now Legs Color entry is ""; [single word color adjective for the dominant color of the skin/fur/feathers/scales]
	now Ass Change entry is ""; [partial sentence that fits in: "Your ass [one of]tingles[or]goes flush[or]vibrates with odd pleasure[or]goes cold[or]feels oily[at random] as [Ass Change entry]."]
	now Ass Description entry is ""; [partial sentence to fit: "Using your hands you feel your behind enjoying the sensation of your [Ass Width Adjective of Player], [Ass Shape Adjective of Player] [Ass Description of Player]." (For players with skin, instead of the period: ", covered in [Ass Color of Player] skin and [Body Hair Description of Player]"]
	now Ass Skin Adjective entry is ""; [one word adjective (feathered/furred/scaly/...); EMPTY "" for creatures with just skin]
	now Ass Color entry is ""; [single word color adjective for the dominant color of the skin/fur/feathers/scales]
	now Ass Width entry is 3; [ass width from 1-5]
	[Ass Width Adjective generated by function out of ass width: dainty/small/round/huge/enormous]
	[Ass Adjective generated by function out of body definition and ass width]
	now Tail Change entry is ""; [partial sentence that fits in: "Your rear [one of]tingles[or]goes flush[or]vibrates with odd pleasure[or]goes cold[or]feels oily[at random] as [if HasTail of Player is true]your existing tail is changed into a [Tail Description entry][else][Tail Change entry][end if]."]
	now Tail Description entry is ""; [partial sentence to fit: "Just below your lower back sprouts a [Tail Description of Player], which you move back and forth with glee."]
	now Tail Skin Adjective entry is ""; [one word adjective (feathered/furred/scaly/...); EMPTY "" for creatures with just skin]
	now Tail Color entry is ""; [single word color adjective for the dominant color of the skin/fur/feathers/scales]
	now Asshole Depth entry is 7; [inches deep for anal fucking]
	[Asshole Depth Adjective is generated by a function and can be used in scenes too - "petite (< 3), shallow (< 5), average (< 9), deep (< 15), bottomless (15+)"]
	now Asshole Tightness entry is 3; [asshole tightness 1-5, "extremely tight, tight, receptive, open, gaping"]
	[Asshole Tightness Adjective is generated by a function and can be used in scenes too - "extremely tight, tight, receptive, open, gaping"]
	now Asshole Color entry is ""; [one word color descriptor]
	now Cock Count entry is 0;
	now Cock Girth entry is 0; [thickness 1-5, generates the Cock Girth Adjective]
	[Cock Girth Adjective is generated by a function and can be used in scenes too: thin/slender/average/thick/monstrous]
	now Cock Length entry is 0; [length in inches]
	now Cock Adjective entry is ""; [one word adjective: avian/canine/...]
	now Cock Change entry is ""; [partial sentence that fits in: "Your cock [one of]tingles[or]goes flush[or]vibrates with odd pleasure[or]goes cold[or]feels oily[at random] as [Cock Change entry]."]
	now Cock Description entry is ""; [partial sentence to fit: "You have a [Cock Girth Adjective of Player], [Cock Length of Player]-inch-long [Cock Adjective of Player] [one of]cock[or]penis[or]shaft[or]maleness[at random] that [cock Description of Player]."]
	now Cock Color entry is ""; [one word color descriptor]
	now Ball Count entry is 0; [allowed numbers: 1 (uniball), 2 or 4]
	now Ball Size entry is 0; [size of balls 1-7: "acorn-sized", "dove egg-sized", "chicken egg-sized" "goose-egg sized", "ostrich-egg sized", "basketball-sized", "beachball-sized"]
	[Ball Size Adjective is generated by a function and can be used in scenes too]
	now Ball Description entry is ""; [partial sentence to fit: "Underneath it hangs a pair of [Ball Size Adjective of Player] [Ball Description of Player]."]
	now Cunt Count entry is 0;
	now Cunt Depth entry is 0; [penetrable length in inches; some minor stretching allowed, or more with Twisted Capacity]
	now Cunt Tightness entry is 0; [size 1-5, generates adjectives of extremely tight/tight/receptive/open/gaping]
	[Cunt Tightness Adjective is generated by a function and can be used in scenes too: extremely tight/tight/well-used/open/gaping]
	now Cunt Adjective entry is ""; [one word adjective: avian/canine/...]
	now Cunt Change entry is ""; [partial sentence that fits in: "Your pussy [one of]tingles[or]goes flush[or]vibrates with odd pleasure[or]goes cold[or]feels oily[at random] as [Cunt change entry]."]
	now Cunt Description entry is ""; [partial sentence to fit: "You have a [Cunt Tightness Adjective of Player] [one of]cunt[or]pussy[or]vagina[or]cleft[at random] that [Cunt Description of Player]."]
	now Cunt Color entry is ""; [one word color descriptor]
	now Clit Size entry is 0; [size 1-5, see Clit Size Adjective]
	[Clit Size Adjective is generated by a function and can be used in scenes: very small/small/average/large/very large]
]



Ogres ends here.
