Version 1 of Bouncy Succubus by Qazarar begins here.
[Version 1 - adds Bouncy Succubus enemy to the Bouncy Castle]

Section 1 - Monster Responses

BouncyCorruption is a number that varies.[@Tag:NotSaved]
BouncyTemptation is a number that varies.[@Tag:NotSaved]

to say BouncySuccubusLoss: [player loses]
	if inasituation is true: [special event]
		say ""; [dealt with in the file where the event is described]
	else: [regular scene]
		if BouncyCorruption < 2: [oral]
			say "     You are knocked to the ground, defeated by the strange succubus. You look up, uncertain what exactly she is going to do to you, but you immediately find your vision filled with a close up view of her pumped mound. Even with your sight obscured, you can clearly hear as she giggles at you, the bouncy sound a perfect fit for her equally bouncy body. 'Oh, aren't you a cute little thing?' Clearly not waiting for any sort of response from you, she instead steps in even closer, pressing her feminine entrance right up by your face. 'Don't be shy, I'm sure this is just going to be the start of a very fulfilling relationship, or at least it will be for one of us.' As if to dispel any lingering doubt about what it is she's implying to you, she thrusts her pelvis even further forward, grinding her mound against your face.";
			say "     Unable to resist her forceful advance, you start to use your mouth as she so clearly desires, beginning with an array of small kisses on the rubbery surface of her opening. For several moments you continue with the relatively tame affection, until the succubus takes issue with the effort you're putting in and grips you more tightly, pressing you in more deeply. Taking the hint, you start to lick and suck with abandon, whatever will satisfy the bouncy demoness with you at her mercy. This seems to placate her for the moment as her grip eases slightly, and you can hear her chuckle over the sounds of your oral efforts. A scant few seconds later, something feels ever so slightly different, a strange feeling throughout your body, though something you can't quite place.";
			WaitLineBreak;
			say "     Eventually the feeling rises to a peak, and it becomes all too obvious what exactly happened. Somehow the attention you were giving to the succubus caused a reaction in you, leaving you ever so slightly bloated and bouncy, a pale imitation of the nature of the succubus herself. It's as if going down on her was the equivalent of inhaling some sort of helium concoction, not enough to truly pump you up like a balloon animal, but enough to give you a taste of that sensation. Before you can truly process the implications of that, the dull murmurs of pleasure from the demoness rise to a crescendo, finally hitting a powerful gasp as she spasms, for a brief moment grinding you more forcefully than ever against her. When the moment passes, she relaxes her hold on you entirely, and steps back, staring admiringly at your prone form. 'That's a good look on you! We'll have to make sure you look like this more often!' She gives you a coy wink before bouncing away, leaving you to slowly expel whatever air was filling you, until you finally return to normal.";
			CreatureSexAftermath "Player" receives "OralPussy" from "Bouncy Succubus";
			increase BouncyCorruption by 1;
		else if BouncyCorruption < 4: [tentacle teasing + inflation]
			say "     Once more you find yourself defeated by the unusual demoness, and waiting on the ground at her mercy. Similarly to before, she giggles at the sight of you, but the similarity ends there. 'Well, looks like I've put you in quite the position, hmm? Don't worry, I've got quite a treat for you.' She doesn't keep you in suspense for very long, as the question of what she considers a treat is answered almost immediately. She raises her arms, and from behind her rise a large number of tentacles, the color and material clearly the same as that of the demoness. You're given no further time to examine this new revelation, as mere moments later several of them dart forward, winding themselves around your limbs and rendering you even more helpless than you already were.";
			say "     'Oh, you look so lovely like that, don't you? Now, let's see what we can really do with you.' Once more her domineering personality shows itself, as without any chance to respond or question her, another of the rubbery appendages twist up from out of your field of view, and jams itself into your open mouth. That same tentacle seems content to just hold itself with the tip inside you for the moment, but each of the others tightens its grip to hold you firmly in place. At the same time, you can see a series of bulges start traveling down the tentacle in your mouth from the farthest visible edge, as if there was something inside it. Your unasked question is soon answered, however, as one of the bulges reaches your mouth, and you feel a burst of what seems like air is released into you.";
			WaitLineBreak;
			say "     Immediately you can tell that this is far from normal air, as a tingling sensation starts creeping throughout your body, followed everywhere it goes by a slight feeling of swelling. Though you can't see the affected areas directly with your current entangled position, prior experience with the succubus is cause enough for you to believe that swelling feeling is caused by parts of you starting to expand and inflate much like several parts of the demoness herself. What's worse is that the tentacle in your mouth has yet to stop its infernal task, and it continues to pump this demonic substance into you, the effects continuously increasing. Even as you try and brace yourself for what it's doing to you, the other tendrils start to act, staying just as tightly wound around you, but moving and undulating in sensuous motions across your flesh. At first they are more a nuisance than anything, but as you start to expand, the friction of the tentacles increases, slowly teasing your body without end.";
			say "     Unable to resist the pleasure being inflicted on you, your body starts to react against your wishes. You can feel your loins throbbing in time with the teasing tentacles, even as the rest of your inflated body is twitching and shaking with the ecstasy you're attempting to bottle up deep within. You can see a wicked grin on the face of the demoness as she watches your struggles, taking a perverse joy in watching you be overcome by her magical extremities. Eventually the efforts reach a fever pitch, and with a muffled scream you twitch and go limp in midair, a powerful climax ripping through your restrained form[if Player is male]. Your shaft jerks in place, shooting its load onto the ground as you give in to the pleasure[end if]. Finally as you hang there, exhausted and very thoroughly defeated, the tentacles release you, and you slump to the ground, more like a blow up doll than a person. 'I can see how much you're enjoying this, so don't worry. Soon it will be even better.' With that ominous declaration, the succubus leaves you behind. You notice the effects of her inflating enchantment fading, though they take longer to disappear than they once did. As you lay there and sputter weakly, you worry. If she was able to do this to you without any penetration, how much worse could she do?";
			CreatureSexAftermath "Player" receives "Stroking" from "Bouncy Succubus";
			increase BouncyCorruption by 1;
		else if BouncyCorruption < 6: [hardcore tentacles + more inflation]
			say "     The succubus has defeated you once more, and somehow you already know this time is going to be different than before. She proves your insights to be correct as without even a smug comment, she unleashes her previously-hidden tendrils in greater numbers, the writhing mass behind her enough to stupefy you even if you were capable of resisting. She smiles at you, and while you can see the traces of her earlier mocking smiles, the overall feeling the wide grin gives you is that of a predator sizing up its prey. With no further warning or delay, the first group of tentacles rush towards you. Rather than covering you entirely as before, you are simply lifted by a single coil being wrapped around each limb, and held in place as the demoness stalks closer.";
			say "     As if in preparation for the bouncy succubus herself, another tentacle squirms towards you and enters your mouth directly. The familiar sensation of being pumped full of enchanted vapors ensues almost immediately, heralding the tingling feeling in the rest of your body that marks the start of the real show. You can feel your body starting to expand, albeit incredibly slowly. The seeming reprieve from her attentions is quickly disproved, as the remaining tentacles that had previously been waving idly in the air spring into action. The storm of tendrils writhe across your body, seeking out every sensitive point they can, poised to strike.";
			WaitLineBreak;
			say "     Unlike last time where the tentacles had teased you relentlessly, they seem to be seeking far more. Finally deigning to speak to you, the succubus chuckles. 'Well, you're quite a pretty sight, trussed up for my pleasure. Don't worry, I'll be making excellent use of you, my plaything.' You feel flush of embarrassment across your face, but are shocked out of your musing by the tendrils acting in unison, no longer content to merely caress you. Instead, they jolt forward and finally penetrate you, joining the one that claimed your mouth in driving deeply into you. The wave of sensation that hits you in that moment is incredible, and only becomes more so as they collectively start to piston back and forth.";
			say "     Just when you think that you've reached the most strenuous portion of your defeat, the demoness yet proves you wrong. Just like with the first tentacle, each of them starts to fill you with the same emission, proven by a huge increase in the tingling feeling across your entire body. The difference is enough that you can noticeably tell that you've started growing faster than before, your flesh stretching and inflating steadily, enough for you to realize that the succubus is completely correct—you're more plaything than person right now. Her tittering laughter seems to echo all around you as you grow amidst the flurry of thrusting tentacles, filling you with a mix of shame and your ever growing arousal.";
			WaitLineBreak;
			say "     Soon your size has gone far beyond what she had brought you to before, your arms and legs widened enough that you would almost certainly be unable to move them even if they weren't wrapped up completely in rubbery appendages at the moment. The rest of your body is a perfect match to them, leaving you far more round than you once were. The tentacles holding you up seem to release their efforts slightly, not on tying you down, but on holding you up. All the same, however, your vertical position doesn't seem to change, your body keeping you slightly aloft on its own. You can feel your body tilt slightly to one side for a moment as if something were moving around on top of you, which is soon revealed to be the demoness herself. She has left her former position in front of you, and decided to take a seat on top of you, using you like a piece of floating furniture, evidenced by what can only be her plump mound grinding against you.";
			say "     You hang in that position for quite some time, events starting to blur together as you're overcome with a haze of sensations from every front. The weightless feeling your new shape is giving you, the way you're plundered by tentacles from every angle, the knowledge you've been reduced to a simple plaything by the demoness, all combined to have you sinking further into a madness you can't quite escape from. You experience more than one climax, you're sure, but how many is beyond you, lost in the sea of sensation you're drowning in. Eventually, however, your purgatory experience comes to an end, as the succubus seems to finally remove her hold over you, retracting her tentacles and moving until she stands in front of you again. 'There, now you've properly had a taste of what I can offer, my little toy. I know you'll look forward to more, and when you're ready, be sure to come back and visit again.' With that ominous final statement, she departs, leaving you with nothing but your ever-more slowly deflating form and the echo of her humiliating laughter.";
			CreatureSexAftermath "Player" receives "AssFuck" from "Bouncy Succubus";
			increase BouncyCorruption by 1;
		else: [bad end - become a blimp]
			say "     When you fall to your knees, overcome by the succubus once again, you can feel deep within you that this time there is no going back. Each time you succumb to her wiles, the effects have been both greater and longer lasting, and you have a sinking feeling you're about to find out just how long first hand, even if a part of you even deeper down is looking forward to it. Unconcerned with your own inner conflict, however, the demoness that has caused all of this seems all too pleased with the situation. 'Well, what a surprise. My newest toy just couldn't get enough of me, hmm? Decided that giving up on everything else to be my plaything was the way to go? A very wise choice, and the last one you'll need to worry about.' A wicked grin spreads across her features, the now-familiar sight of her tentacles springing into existence only compounding the sense that you no longer have a say in your own fate.";
			say "     The succubus seems to have dispensed entirely with the notion of teasing and foreplay, as a mere moment later the appendages spring into action, slipping into your eager holes with no difficulty, as if you were just waiting to be filled like this. With an almost unbelievable alacrity, the tendrils have already begun to thrust rhythmically into you. Along with the onrushing pleasure that comes naturally when you're fucked deeply by the tentacles, you can feel that each of them is pulsing further, dispensing more of that tingling magical essence, changing you further. What took several minutes of continuous penetration the last time you were in this position is now almost instant. You can't help but whine in pleasure through the tentacle muffling you as you can feel our flesh starts to grow and change to suit her desires.";
			WaitLineBreak;
			say "     Mere moments were all it took for your limbs and body to expand significantly, and all the while you can visibly see your skin change from it's natural appearance to the familiar slick red surface possessed by the demoness herself. Accompanying the visual changes, you can sense the shifts occurring inside, as you lighten and bloat up, keeping more in common with a toy balloon than a person. While you're caught up in the strange and unusual resonance, you're not so lost as to miss the tendrils changing their movements, and starting to lift you into the air. Almost like before, you're quickly strung up effortlessly, held in the air like a doll, but unlike before the succubus and her tentacles don't bother with grabbing your limbs, instead simply supporting you by way of the myriad penetrations, made easier by your own reduced weight.";
			say "     Amidst the flurry of tentacles visiting their lusts upon you, and the myriad sensations flowing through your body, you almost lost track of their source. The succubus demands your attention once more, however, as she strides closer and brings a hand up to caress your cheek, her rubbery skin squeaking slightly against your own. 'Oh, I was so very right about you. You're already coming along so well, I'm very certain you're going to be lovely when we're done here.' In contrast to her normal smug appearance, her expression is almost gentle. The appendage filling your mouth draws backwards, leaving you able to gasp for a breath of natural air for just a single moment before once more the demoness captures your lips—this time for a tender kiss. The shock is enough that you miss your solitary chance to respond when she draws back, and her former expression returns to her face just as the tentacle returns to yours.";
			if Player is not female: [grow pussy for rest of bad end]
				WaitLineBreak;
				say "     'Well, I almost forgot that there's just one last thing to take care of before we continue any further, hmm? You're becoming so lovely already, but there's one little thing you're missing—or rather, a large one.' With a chuckle to herself, she walks further under your airborne body, her hand trailing along your skin until it comes to rest near your crotch. She strokes her fingers back and forth across the region, filling you with more of the same infernal tingling, and then she moves her head in closer. Her tongue slips from her lips, extending outwards and lavishing the same area thoroughly. Through your own hazy thoughts you start developing an inkling of what's going on here, but before the vague ideas can coalesce into anything real, the succubus makes the whole point moot.";
				say "     A blindingly intense feeling comes together where she's touching you, a combination of a sharp pain and a bone deep pleasure all at once, overwhelming you. Even more intensely than before you can feel your body warping and changing under her touch, turning what was once smooth skin into a new feminine passage ripe for the taking. Even as the changes propagate deeper into you, making a fundamental difference somehow, you can also feel the brand new mound expanding hugely under her ministrations, growing far faster than any other part of your body. Soon your lower region is dominated by a massively inflated pussy, a realization you don't even have time to grapple with before your new entrance is being split open by one of the infernal tentacles. Being railed like this is almost more than you can possible endure, with more and more euphoria shooting through your veins.";
			WaitLineBreak;
			say "     Despite how thoroughly you're being fucked by the succubus at the moment, she decides that it's still not enough for your growing body. More and more of her writhing limbs seem to fill the air, and moments later they start to fill you as well. Your holes have already been impaled by tentacles, but that is clearly not enough to stop what's going on, as several more of varying sizes start to poke and prod at each of your entrances. Soon your newly enlarged orifices give way, and you find the new tentacles joining the previous ones inside you, stretching you even further—and bringing an indescribable rush of further pleasures with them. These intense feelings burn through your mind like a wildfire, bringing you closer and closer to the edge.";
			say "     Things blur together for a time after that, the endless experience of being so completely filled even as you continue to grow enough to make you lose track of anything else. Eventually there is a break in the constant stream when the punishing tentacles finally retreat from your [if player is not female]new [end if]pussy, much to your confusion. For a moment, you start to feel somewhat empty, already missing how full you were before. Before that newfound emptiness becomes too intense, however, the succubus leans in closely and plants her puffy lips directly against your own massive lower pair. She starts to breathe out more of that strange infernal air directly into you, causing your own growth to speed up even more, enough that your size has almost reached that of a city bus.";
			say "     The succubus takes advantage of the ongoing inflation to toy more heavily with your oversized mound, pushing her face deeper in and using her lengthy tongue to the fullest. At the same time, she reaches her hands up to paw at you, greedily using you in every way she can. Soon your pussy has reached a point where even that doesn't completely fill you, a problem she immediately solves by having several more of her tentacles join her in fiercely taking you. The combination of all her different methods is enough to drown you in the pleasure as virtually her entire body works your mound into a frenzy of lust and submission. You reach a climax more than once, but the demoness shows no signs of stopping, just like your body shows no signs of returning to what you once were. You've reached a point where you've almost filled the entire area like an overfilled balloon, but the constant haze of pleasure washes over you endlessly until your sense of time starts to fade.";
			trigger ending "Bouncy Succubus Live In Toy";
			end the story saying "Eventually, your size became so great that you take up the entire space inside the bouncy castle, almost like a building unto yourself. Appropriately, with your incredible size the demoness that inflicted this on you has made use of you in much the same way—in addition to toying with you, you're being used as a home for her. Each time she spreads your inflated lower lips open to enter or exit, you shudder in pleasure, though there's little else you can do besides enjoy everything she uses you for. After all, you're nothing but her personal toy.";
		if BouncyTemptation > 5: [using her in victory scenes speeds up loss progression]
			decrease BouncyTemptation by 5;
			increase BouncyCorruption by 1;

to say BouncySuccubusVictory: [player wins]
	if inasituation is true: [special event]
		say ""; [dealt with in the file where the event is described]
	else: [regular scene]
		say "     A";
		say "     [bold type]You could easily have your way with her if you want to.[roman type][line break]";
		LineBreak;
		say "     ([link]Y[as]y[end link]) - Amuse yourself with the Bouncy Succubus.";
		say "     ([link]N[as]n[end link]) - Walk away.";
		if Player consents:
			LineBreak;
			now sextablerun is 0;
			blank out the whole of table of fucking options;
			[]
			choose a blank row in table of fucking options;
			now title entry is "Get licked";
			now sortorder entry is 1;
			now description entry is "See how her tongue feels";
			[]
			if Player is male:
				choose a blank row in table of fucking options;
				now title entry is "Get sucked";
				now sortorder entry is 2;
				now description entry is "Use her mouth for something fun";
			[]
			if Player is male:
				choose a blank row in table of fucking options;
				now title entry is "Use her chest";
				now sortorder entry is 2;
				now description entry is "Put her bouncy breasts to use";
			[]
			[if BouncyCorruption > 2:
				choose a blank row in table of fucking options;
				now title entry is "Tentacle fun";
				now sortorder entry is 2;
				now description entry is "Make her use her tentacles on you";]
			[]
			sort the table of fucking options in sortorder order;
			repeat with y running from 1 to number of filled rows in table of fucking options:
				choose row y from the table of fucking options;
				say "[link][y] - [title entry][as][y][end link][line break]";
			say "[link]0 - Nevermind[as]0[end link][line break]";
			while sextablerun is 0:
				say "Pick the corresponding number> [run paragraph on]";
				get a number;
				if calcnumber > 0 and calcnumber <= the number of filled rows in table of fucking options:
					now current menu selection is calcnumber;
					choose row calcnumber in table of fucking options;
					say "[title entry]: [description entry]?";
					if player consents:
						let nam be title entry;
						now sextablerun is 1;
						if (nam is "Get licked"):
							say "[BouncySuccubusSex1]";
						if (nam is "Get sucked"):
							say "[BouncySuccubusSex2]";
						if (nam is "Use her chest"):
							say "[BouncySuccubusSex3]";
						if (name is "Tentacle fun"):
							say "[BouncySuccubusSex4]";
						wait for any key;
				else if calcnumber is 0:
					now sextablerun is 1;
					say "     You decide against it, and simply leave her there.";
					wait for any key;
				else:
					say "Invalid Option. Pick between 1 and [the number of filled rows in the table of fucking options] or 0 to exit.";
			clear the screen and hyperlink list;
		else:
			WaitLineBreak;
			say "     You're not interested, or at least not now, and so you simply ignore the curious demon, and return to your adventures.";

to say BouncySuccubusDesc:
	say "     The most fitting adjective to describe what you see in front of you is [']bouncy['], in every way. The exaggerated feminine figure has all the hallmarks of a succubus, with curling demonic horns, an incredibly plump and well-endowed figure, bright red skin, and a cute spade tail. Even more eye catching than the rest of her are the sheer size and bounce of her chest, almost resembling a pair of balloons—a comparison that becomes all the more fitting as you take in her entirety again, and realize that in fact her entire body seems to be made of some sort of rubber, like an inflatable toy. Her chest isn't the only thing that's has that particular trait you realize, as her feminine mound is also quite affected, leaving it round and inflated.";

to say BouncySuccubusSex1: [licked]
	if Player is female:
		say "     You decide that what you want most from the defeated demoness is some personal attention of the oral variety. You quickly bare yourself, leaving your feminine passage fully visible, and gesture broadly while you make your demand. In response, the succubus gives you a coy smile, and leans forward, looking at your opening appraisingly. 'Oh, you've certainly earned this victory, so enjoy it for now. But I'll be waiting for the next time.' Without further warning, she dives in, and starts offering you the attentions you so desired. Her first assault on you begins slowly, with her plush lips brushing against the surface to deliver light kisses, periodically interrupted by rapid flicks of her tongue across the sensitive areas. Her efforts are so gentle that true pleasure has not yet hit, and you are instead being filled by a slowly growing tingling sensation that heralds far more to come.";
		say "     The demoness soon begins increasing the pace of her work, her tongue working faster even as her lips move more rapidly across your flesh, until for a brief moment she stops entirely. A moment passes, enough for you to open your mouth, about to ask why she's stopped, when she takes the plunge. In one stroke she crosses from teasing to full action, planting her lips against yours, and wiggling her demonic tongue inside you in a single thrust. A moan escapes you at the moment of contact, an unconscious sign of the shifting pleasures that are rising in response to the energetic tonguing. You press your pelvis forward, grinding your pussy against her face in an attempt to get even more pleasure out of the experience. Her only response is to push back just as hard with her tongue, going deeper into you, revealing a length you had no idea she possessed.";
		WaitLineBreak;
		say "     Suddenly the appendage that had been lavishing your passage with attention accelerates, going from a comparatively simple barrage of sensations to a writhing mess of unthinkable pleasures. The sheer size and dexterity of her infernal tongue is enough to apply more varied and teasing feelings to you than any normal penetration, which contributes more to the building wave of pleasure deep within you. You start losing control of yourself in response to that unwavering tide, relinquishing all momentum to the demoness. She uses it to bring you to even more feverish heights, until finally the cascade of bliss reaches the pinnacle, leaving you shaking where you stand from the feeling, mind blanked by the sensory overload. The succubus leans back from you, her long oral appendage slowly winding back into her mouth. While you're distracted by the aftershocks of your powerful orgasm, she makes her getaway, leaving you with a parting gift that slips past your notice—a faint hint of rubbery texture and a boost in size to your own mound.";
		CreatureSexAftermath "Bouncy Succubus" receives "OralPussy" from "Player";
	else: [rimmed]
		say "     You decide that what you want most from the defeated demoness is some personal attention of the oral variety. You quickly bare yourself, before gesturing towards your own rear as you tell her exactly what you want out of her. She smiles coyly in response, her eyes revealing her own arousal. 'Well somebody is naughty I see. As the victor, you've earned the right, but next time we'll see who comes out on top.' Not waiting for any further response, the succubus crawls forward, snaking around your legs until she's out of your sight. For a moment you almost doubt that she's going to follow through, but the feeling of a lengthy tongue flicking across the edge of your rear passage assures you she's going to cooperate, and equally assures you that you're going to enjoy it.";
		say "     Not a moment later, and the succubus has started moving at a faster pace, a series of rapid motions across your sensitive flesh giving you a greater sensation than before, helped along by her fingers lightly drumming on your thighs as she works. Just as you're starting to get used to the treatment you're being given, the demoness once more raises the stakes. An unceremonious gasp escapes your lips, an unconscious response to having your tight hole penetrated in a single thrust by her infernal tongue. Far greater heights of pleasure start to radiate from your rear, with a slight hint of tingling underlying the ecstasy. You can't help but press yourself backwards, grinding against her face and bringing her even deeper, enjoying every moment of her writhing tongue inside you.";
		WaitLineBreak;
		say "     Without warning, her attentions speed up greatly, the singularly intense feelings they provoke evolving into a lurid mess of varied pleasures that you have no hope of escaping from. Each motion inflicted on you brings with it a new surge of sensation, enough to make you lose control in a dozen small ways. A breathy moan escapes your lips, your legs begin to quiver, your mind loses focus, and even more you can't fully identify in your lust-drunk state. The only thing you can be certain of is that the feeling is a blissful one, even as the pleasure rises to a new peak. One final frenzied rush from the demoness is enough to finally crest that mountain, and your knees go weak as you're overcome with mind-numbing pleasure. The demoness releases her grip on your legs, which is enough to allow you to collapse to the ground, too wracked with sensation to care. She takes the chance to leave you where you lie, and unbeknownst to you, she leaves you with more than that. The entrance she so mercilessly tongued has become slightly more rubbery, like the demoness' flesh, and has grown ever so slightly. Unaware of the changes wrought upon you, you return to your adventures.";
	increase BouncyTemptation by 1;

to say BouncySuccubusSex2: [sucked]
	say "     You decide that what you want most from the defeated demoness is some personal attention of the oral variety. Without waiting any longer, you brandish your member at the succubus, and firmly explain what you want from her. She gives you a coy smile in return, before reaching a rubbery hand forward to grasp the shaft, stroking gently as she looks at you. 'You won this round, so it's only fair. But next time, we'll see who comes out on top.' With that declaration made, she leans forward and starts to use her mouth on your [Cock of Player] cock, her inflated lips making for a tight seal as she sucks at the tip, amplifying the pleasure you're already starting to feel. For the moment, you simply let her do as she pleases, working her way slowly down the shaft[if Cock Length of Player > 9], her peculiar material allowing her to easily handle your size[end if].";
	say "     Soon her efforts start to increase, her bobbing increasing right alongside the pressure she applies to create a powerful sensation. She brings a hand up, starting to stroke and toy with any part of your shaft that isn't in her mouth at the moment, adding another layer to the stimulation. The feeling of her uniquely texture lips and hands is almost indescribable, but you can't deny that the feeling is a pleasant one, so much so that when combined with her skills, your own climax is rapidly growing closer. As that draws near, you decide you have a better option than simply passively accepting the pleasure, and instead grip her firmly. Barely a second later you shift the momentum and take control of your coupling, moving your hips with ease in order to pump your shaft into her with all your energy. This proves to be enough to tip you over the edge, jolts of heated sensations flowing through you, until they manifest as a [if Ball Size of Player > 6]huge [end if]surge of seed shooting into her mouth. You release your grip on the succubus, and watch as she sits back onto her heels and licks her ruby-red lips. Still reeling with sensation, you pay no mind to her as she leaves, and unnoticed by you, your shaft glistens slightly as it becomes ever so slightly closer to her material.";
	CreatureSexAftermath "Bouncy Succubus" receives "OralCock" from "Player";
	increase BouncyTemptation by 1;

to say BouncySuccubusSex3: [use her breasts]
	say "     There's one part of her body that you can't deny catches your attention immediately. Like being drawn in by gravity, you can't help but stare at her massive tits, entranced by the way they bounce so heavily with even the slightest motions. Easily noticing your fascination, the demoness reaches her hands up to grasp her own chest and gives it a playful bounce. 'So you like what you see, hmm? Well, you can play with them, since you're so strong. Don't worry, I won't bite.' Despite her statement being less than reassuring, you decide to take her up on the offer regardless, as her endowments are simply too enticing to avoid. You scramble to get yourself prepared, and in mere moments your shaft is standing firmly at the ready for what awaits.";
	say "     Taking the lead, the succubus leans forward and starts rubbing her chest against your member. The unusual material her breasts are made of feels somewhat strange as it caresses you, but it's undeniably an excellent feeling sort of strange. Perhaps seeing your positive reaction, the kneeling demoness pushes further forward, her soft flesh engulfing your cock[if Cock Length of Player < 6] completely[else], your endowment almost seeming to grow slightly to match[end if]. Your shaft is already twitching with a combination of pleasure and anticipation of what's to come, each stroke of her balloon-like tits almost more than you can handle. As the waves of sensation mount further, the succubus increase the bouncing on her heels just enough to keep her chest bobbing at ever-faster speeds";
	say "     Completely absorbed in the feeling of her actions, you barely notice a strange tingling sensation in your loins that accompanies the fervently growing pleasure. You gather enough mental focus to react, and are about to question the demoness, when she amplifies her efforts further, her tongue extending downward and joining her chest in serving you, finally bringing you to an explosive climax. The growing concern you'd been about to voice is lost completely in the bliss you feel as your shaft throbs powerfully, erupting a[if Ball Size of Player > 6] massive[end if] wave of spunk onto her enchanting tits. Her tongue laps up a few drops before returning to her mouth, and she follows it with a smile, before she gets to her feet and leaves you. You stay for several more moments, basking in the afterglow with your mind drifting. For a brief second, you can't help but wonder how it would feel if you had the kind of inflated endowments she did.";
	CreatureSexAftermath "Bouncy Succubus" receives "OralCock" from "Player";
	increase BouncyTemptation by 1;
	if Cock Length of Player < 6:
		increase Cock Length of Player by 1;

to say BouncySuccubusSex4: [tentacle'd]
	say "     Having seen what she can do with her strange tentacles, you can't help but want to experience more. You hardly hesitate to ask the succubus, and your request brings a self-satisfied smile to her face. 'Ohoho, so eager, are you? Practically ready to just walk into my clutches. Don't worry, you won this time, so I'll leave you as you are. Mostly.' She laughs at her own ominous commentary, and before you have time to rethink your decision, the waving mass of tendrils has already sprung into existence around her, dancing as if to an unseen tune. Your will wavers for a moment in the face of that sight, but that doubt becomes meaningless as they wind forwards and surrount you in a mass of undulating appendages.";
	say "     A";
	CreatureSexAftermath "Player" receives "AssDildoFuck" from "Bouncy Succubus";
	increase BouncyTemptation by 2;

Section 2 - Creature Insertion

Table of Random Critters (continued)
NewTypeInfection (truth state)	Species Name	Name	Enemy Title	Enemy Name	Enemy Type	Attack	Defeated	Victory	Desc	Face	Body	Skin	Tail	Cock	Face Change	Body Change	Skin Change	Ass Change	Cock Change	str	dex	sta	per	int	cha	sex	HP	lev	wdam	area	Cock Count	Cock Length	Ball Size	Nipple Count	Breast Size	Male Breast Size	Cunt Count	Cunt Depth	Cunt Tightness	SeductionImmune	Libido	Loot	Lootchance	TrophyFunction	MilkItem	CumItem	Scale (number)	Body Descriptor (text)	Type (text)	Magic (truth state)	Resbypass (truth state)	non-infectious (truth state)	Cross-Infection (text)	DayCycle	Altcombat (text)	BannedStatus (truth state)
--	--	--	--	--	--	--	--	--	--	--	--	--	--	--	--	--	--	--	--	--	--	--	--	--	--	--	--	--	--	--	--	--	--	--	--	--	--	--	--	--	--	--	--	--	--	--	--	--	--	--	--	--	--	--	--	--;

When Play begins:
	Choose a blank row from Table of Random Critters;
	now NewTypeInfection entry is false;
	now Species Name entry is "Succubus"; [name of the overall species of the infection, used for children, ...]
	now Name entry is "Bouncy Succubus";
	add "Bouncy Succubus" to infections of FemaleList;
	add "Bouncy Succubus" to infections of BipedalList;
	add "Bouncy Succubus" to infections of FlightList;
	add "Bouncy Succubus" to infections of TailList;
	add "Bouncy Succubus" to infections of LatexList;
	add "Bouncy Succubus" to infections of ToyList;
	now enemy title entry is "inflatable succubus"; [name of the encountered creature at combat start - Example: "You run into a giant collie." instead of using "Smooth Collie Shemale" infection name]
	now enemy Name entry is ""; [specific name of unique enemy]
	now enemy type entry is 1; [0 = non unique enemy; 1 = unique (unknown name); 2 = unique (known name) | Used to disqualify unique enemies from Vore/UB and showing the enemy name in encounters]
	now attack entry is "[one of]She slams directly into you.[or]She bounces into the air, and lands on you.[or]She hits you with a deceptively strong slap.[at random]";
	now defeated entry is "[BouncySuccubusVictory]";
	now victory entry is "[BouncySuccubusLoss]";
	now desc entry is "[BouncySuccubusDesc]"; [ Description of the creature when you encounter it.]
	now face entry is "smooth and beautiful, with curling devilish horns"; [ Face description, format as "Your face is (your text)."]
	now body entry is "humanoid in shape, but inhumanly bouncy"; [ Body Description, format as "Your Body is (your text)"]
	now skin entry is "[one of]rubbery[or]red rubber[or]elastic[at random]"; [ skin Description, format as "Looking at yourself, your body is covered in (your text) skin"]
	now tail entry is "You have a thin and winding tail that ends in a cute spade."; [ Tail description, write a whole Sentence or leave blank. ]
	now cock entry is "[one of]demonic[or]infernal[or]tainted[at random]"; [ Cock Description, format as you have a 'size' (your text) cock]
	now face change entry is "it twists into a new shape, leaving you with a cute and feminine face"; [ face change text. format as "Your face feels funny as (your text)." ]
	now body change entry is "it flows into a new form, becoming mostly human, apart from cute batlike wings"; [ body change text. format as "Your body feels funny as (your text)." ]
	now skin change entry is "the surface is overtaken by a bright red rubbery material, leaving you looking like some sort of inflatable toy"; [ skin change text. format as "Your skin feels funny as (your text)." ]
	now ass change entry is "it grows wider and bouncier, before a demonic spaded tail emerges"; [ ass/tail change text. format as "Your ass feels funny as (your text)." ]
	now cock change entry is "it twists into a demonic shape, and gains a rubbery texture"; [ cock change text. format as "Your cock feels funny as (your text)." ]
	now str entry is 13;
	now dex entry is 17;
	now sta entry is 18;
	now per entry is 15;
	now int entry is 13;
	now cha entry is 20;
	now sex entry is "Female"; 	[ Defines which sex the infection will try and make you. current options are 'Male' 'Female' 'Both']
	now HP entry is 49;
	now lev entry is 7; [ Level of the Monster, you get this much HP if you win, or this much HP halved if you loose ]
	now wdam entry is 11; [Amount of Damage monster Does when attacking.]
	now area entry is "Beach"; [ Current options are 'Outside' and 'Mall'. Case sensitive]
	now Cock Count entry is 1; [ How many cocks will the infection try and cause if sex is 'Male' or 'Both']
	now Cock Length entry is 14; [ Length infection will make cock grow to if cocks]
	now Ball Size entry is 3; [ Size of balls ]
	now Nipple Count entry is 2; [ Number of nipples infection will give you (males have nipples too) ]
	now Breast Size entry is 12; [Size of breasts infection will try to attain ]
	now Male Breast Size entry is 12; [ Breast size for if Sex="Male", usually zero. ]
	now Cunt Count entry is 1; [ if sex = "Female or both", indicates the number of female sexes infection will grant you.]
	now Cunt Depth entry is 9;
	now Cunt Tightness entry is 10;
	now SeductionImmune entry is false;
	now libido entry is 60; [ As part of infection, the Player will be gradually moved towards this value; also used for the creature's seduce defense as a penalty ]
	now loot entry is "";
	now lootchance entry is 0; [ Chance of loot dropping 0-100 ]
	now MilkItem entry is "";
	now CumItem entry is "";
	now TrophyFunction entry is "-";
	now scale entry is 3; [ Number 1-5, approx size/height of infected PC body: 1=tiny, 3=avg, 5=huge ]
	now body descriptor entry is "[one of]plump[or]curvy[or]demonic[at random]"; [ Ex: "plump" "fat" "muscled" "strong" "slimy" "gelatinous" "slender". Use [one of] to vary ]
	now type entry is "demonic"; [ one-word creature type. Ex: feline, canine, lupine, robotic, human... Use [one of] to vary ]
	now magic entry is false;
	now resbypass entry is false;
	now non-infectious entry is false;
	now Cross-Infection entry is ""; [infection that this infection will give the player when they lose; can be left empty if they infect with the monster's own]
	now DayCycle entry is 0; [ 0 = Up at all times; 1 = Diurnal (day encounters only); 2 = Nocturnal (night encounters only);]
	now altcombat entry is "default";
	now BannedStatus entry is false;

[
Table of New Infection Parts (continued)
Species Name	Name	Body Weight	Body Definition	Androginity	Head Change	Head Description	Head Adjective	Head Skin Adjective	Head Color	Head Adornments	Hair Length	Hair Shape	Hair Color	Hair Style	Beard Style	Body Hair Length	Eye Color	Eye Adjective	Mouth Length	Mouth Circumference	Tongue Adjective	Tongue Color	Tongue Length	Torso Change	Torso Description	Torso Adjective	Torso Skin Adjective	Torso Adornments	Torso Color	Torso Pattern	Breast Adjective	Breast Size	Male Breast Size	Nipple Count	Nipple Color	Nipple Shape	Back Change	Back Adornments	Back Skin Adjective	Back Color	Arms Change	Arms Description	Arms Skin Adjective	Arms Color	Locomotion	Legs Change	Legs Description	Legs Skin Adjective	Legs Color	Ass Change	Ass Description	Ass Skin Adjective	Ass Color	Ass Width	Tail Change	Tail Description	tail skin adjective	Tail Color	Asshole Depth	Asshole Tightness	Asshole Color	Cock Change	Cock Description	Cock Adjective	Cock Color	Cock Count	Cock Girth	Cock Length	Ball Description	Ball Count	Ball Size	Cunt Change	Cunt Description	Cunt Adjective	Cunt Color	Cunt Count	Cunt Depth	Cunt Tightness	Clit Size
--	--	--	--	--	--	--	--	--	--	--	--	--	--	--	--	--	--	--	--	--	--	--	--	--	--	--	--	--	--	--	--	--	--	--	--	--	--	--	--	--	--	--	--	--	--	--	--	--	--	--	--	--	--	--	--	--	--	--	--	--	--	--	--	--	--	--	--	--	--	--	--	--	--	--	--	--	--	--	--;

When Play begins:
	Choose a blank row from Table of New Infection Parts;
	now Species Name entry is ""; [name of the overall species of the infection, used for children, ...]
	now Name entry is ""; [matching infection name to Table of Random Critters]
	now Body Weight entry is 5; [scale of 1-9 for body weight, grouped into low weight (1-3), mid weight (4-6) and high weight (7-9)]
	now Body Definition entry is 5; [scale of 1-9 for body definition, grouped into low muscle (1-3), mid muscle (4-6), high muscle (7-9)]
	[Body Adjective is generated out of the body weight and body definition and can be used in scenes - one word descriptive adjective depending on weight and definition groups: low weight group: skinny/slender/lithe; mid weight group: average/fit/muscled; high weight group: pudgy/husky/jacked]
	now Androginity entry is 5; [1-9 scale of hypermasculine to hyperfeminine]
	[Gender Adjective is generated out of androginity 1-9: hypermasculine/masculine/effeminate/somewhat effeminate/androgynous/feminine butch/tomboyish/feminine/hyperfeminine]
	now Head Change entry is ""; [partial sentence that fits in: "Your head and face [one of]tingle[or]go flush[or]vibrate with odd pleasure[or]go cold[or]feel oily[at random] as [head change entry]."]
	now Head Description entry is ""; [partial sentence that fits in "Your face and head resemble that of [Head Description of Player]. You have [Eye Adjective of Player], [Eye Color of Player] eyes and an overall [Gender Adjective of Player] appearance."]
	now Head Adjective entry is ""; [one word descriptive adjective (avian/canine/...)]
	now Head Skin Adjective entry is ""; [one word descriptive adjective]
	now Head Color entry is ""; [single word color adjective for the dominant color of the skin/fur/feathers/scales]
	now Head Adornments entry is "";[partial sentence that fits in "Before moving on from your head, you give your [head adornments of Player] a proud glance followed by a light caress."]
	now Hair Length entry is 2; [hair length in inches]
	now Hair Shape entry is ""; [one word shape descriptor (curly/straight/...)]
	now Hair Color entry is ""; [one word color descriptor]
	now Hair Style entry is ""; [one word style descriptor (ponytail/mohawk/buzzcut/...) to fit "On top of your head you have [Hair Length of Player] inch long, [Hair Shape of Player] [Hair Color of Player] hair in the [Hair Style of Player] style."]
	now Beard Style entry is ""; [short beard style (goatee/3-day stubble beard/porn stache/mutton chops beard/...) to go into "You have a [Hair Color of Player] [Beard Style of Player]."]
	now Body Hair Length entry is 0; [numerical value, 0-4 (no body hair/light/moderate/heavy/furry) - only set to > 0 if the infection does not have fur/scales/etc. !]
	now Eye Color entry is ""; [one word color descriptor]
	now Eye Adjective entry is ""; [one word descriptive adjective (slitted/round/...)]
	now Mouth Length entry is 3; [inches deep for face fucking; maximum possible will be double this number (when deep throating)]
	[Mouth Length Adjective is generated by a function and can be used in scenes too - "petite, shallow, average, deep, bottomless"]
	now Mouth Circumference entry is 3; [mouth circumference 1-5, see Mouth Circumference Adjective]
	[Mouth Circumference Adjective is generated by a function and can be used in scenes too - "tiny, small, normal, wide, gaping"]
	now Tongue Adjective entry is ""; [one word descriptive adjective (wide/slobbery/...)]
	now Tongue Color entry is ""; [one word color descriptor]
	now Tongue Length entry is 3; [length in inches]
	now Torso Change entry is ""; [partial sentence that fits in: "Your torso [one of]tingles[or]goes flush[or]vibrates with odd pleasure[or]goes cold[or]feels oily[at random] as [Torso Change entry]."]
	now Torso Description entry is ""; [partial sentence, fitting in "Looking down at yourself, you appear [Gender Adjective of Player] with a [Body Adjective of Player] build. Your torso is [Torso Description of Player][if Body Hair Length of Player > 1], covered in [Torso Color of Player] skin and [Body Hair Description of Player][else if Body Hair Length of Player is 1], covered in smooth, [Torso Color of Player] skin[end if]."]
	now Torso Adjective entry is ""; [one word descriptive adjective (avian/canine/...)]
	now Torso Adornments entry is ""; [(pouch/udders/...); partial sentence to fit: "You take a moment to feel your [torso adornments of Player]."]
	now Torso Skin Adjective entry is ""; [one word adjective (feathered/furred/scaly/...); EMPTY "" for creatures with just skin]
	now Torso Color entry is ""; [single word color adjective for the dominant color of the skin/fur/feathers/scales]
	now Torso Pattern entry is ""; [single word color adjective for the dominant pattern of the skin/fur/feathers/scales]
	now Breast Adjective entry is ""; [adjective(s) example: round, pointy, perky, saggy, bouncy. This would serve as either a general appearance of a infections breasts or possibly something that may be effected by a item or NPC.]
	now Breast Size entry is 0; [cup size as number, counting Flat Pecs = 0, A = 1, B = 2, ...]
	now Male Breast Size entry is 0; [cup size as number, counting Flat Pecs = 0, A = 1, B = 2, ...]
	now Nipple Count entry is 2; [count of nipples]
	now Nipple Color entry is ""; [one word color descriptor]
	now Nipple Shape entry is ""; [shape example: any shape will do as long as it has a baseline with a current infection or item]
	now Back Change entry is ""; [partial sentence that fits in: "Your back [one of]tingles[or]goes flush[or]vibrates with odd pleasure[or]goes cold[or]feels oily[at random] as [Back Change entry]."]
	now Back Adornments entry is ""; [partial sentence to fit: "Your back tickles with the feeling of movement caused by [back adornments of Player]."]
	now Back Skin Adjective entry is ""; [one word adjective (feathered/furred/scaly/...); EMPTY "" for creatures with just skin]
	now Back Color entry is ""; [single word color adjective for the dominant color of the skin/fur/feathers/scales]
	[Limbs Adjective is generated by a function and can be used in scenes too - "rail-thin, slender, sinewy, average, firm, muscular, flabby, meaty, rippling"]
	now Arms Change entry is ""; [partial sentence that fits in: "Your arms [one of]tingle[or]go flush[or]vibrate with odd pleasure[or]go cold[or]feel oily[at random] as [Arms Change entry]."]
	now Arms Description entry is ""; [partial sentence to fit: "Your [Limbs Adjective of Player] arms are [Arms Description of Player]."]
	now Arms Skin Adjective entry is ""; [one word adjective (feathered/furred/scaly/...); EMPTY "" for creatures with just skin]
	now Arms Color entry is ""; [single word color adjective for the dominant color of the skin/fur/feathers/scales]
	now Locomotion entry is ""; [one word adjective: (bipedal/quadrupedal/octapedal/serpentine/sliding)]
	now Legs Change entry is ""; [partial sentence that fits in: "Your legs [one of]tingle[or]go flush[or]vibrate with odd pleasure[or]go cold[or]feel oily[at random] as [Legs Change entry]."]
	now Legs Description entry is ""; [partial sentence to fit: "As your inspection goes even lower, you come to the two [Body Adjective of Player] legs supporting you. They are [legs description of Player]."]
	now Legs Skin Adjective entry is ""; [one word adjective (feathered/furred/scaly/...); EMPTY "" for creatures with just skin]
	now Legs Color entry is ""; [single word color adjective for the dominant color of the skin/fur/feathers/scales]
	now Ass Change entry is ""; [partial sentence that fits in: "Your ass [one of]tingles[or]goes flush[or]vibrates with odd pleasure[or]goes cold[or]feels oily[at random] as [Ass Change entry]."]
	now Ass Description entry is ""; [partial sentence to fit: "Using your hands you feel your behind enjoying the sensation of your [Ass Width Adjective of Player], [Ass Shape Adjective of Player] [Ass Description of Player]." (For players with skin, instead of the period: ", covered in [Ass Color of Player] skin and [Body Hair Description of Player]"]
	now Ass Skin Adjective entry is "";  [one word adjective (feathered/furred/scaly/...); EMPTY "" for creatures with just skin]
	now Ass Color entry is ""; [single word color adjective for the dominant color of the skin/fur/feathers/scales]
	now Ass Width entry is 3; [ass width from 1-5]
	[Ass Width Adjective generated by function out of ass width: dainty/small/round/huge/enormous]
	[Ass Adjective generated by function out of body definition and ass width]
	now Tail Change entry is ""; [partial sentence that fits in: "Your rear [one of]tingles[or]goes flush[or]vibrates with odd pleasure[or]goes cold[or]feels oily[at random] as [if HasTail of Player is true]your existing tail is changed into a [Tail Description entry][else][Tail Change entry][end if]."]
	now Tail Description entry is ""; [partial sentence to fit: "Just below your lower back sprouts a [tail description of Player], which you move back and forth with glee."]
	now Tail Skin Adjective entry is ""; [one word adjective (feathered/furred/scaly/...); EMPTY "" for creatures with just skin]
	now Tail Color entry is ""; [single word color adjective for the dominant color of the skin/fur/feathers/scales]
	now Asshole Depth entry is 7; [inches deep for anal fucking]
	[Asshole Depth Adjective is generated by a function and can be used in scenes too - "petite (< 3), shallow (< 5), average (< 9), deep (< 15), bottomless (15+)"]
	now Asshole Tightness entry is 3; [asshole tightness 1-5, "extremely tight, tight, receptive, open, gaping"]
	[Asshole Tightness Adjective is generated by a function and can be used in scenes too - "extremely tight, tight, receptive, open, gaping"]
	now Asshole Color entry is ""; [one word color descriptor]
	now Cock Count entry is 0;
	now Cock Girth entry is 0; [thickness 1-5, generates the Cock Girth Adjective]
	[Cock Girth Adjective is generated by a function and can be used in scenes too: thin/slender/average/thick/monstrous]
	now Cock Length entry is 0; [length in inches]
	now Cock Adjective entry is ""; [one word adjective: avian/canine/...]
	now Cock Change entry is ""; [partial sentence that fits in: "Your cock [one of]tingles[or]goes flush[or]vibrates with odd pleasure[or]goes cold[or]feels oily[at random] as [Cock Change entry]."]
	now Cock Description entry is ""; [partial sentence to fit: "You have a [Cock Girth Adjective of Player], [Cock Length of Player]-inch-long [cock adjective of Player] [one of]cock[or]penis[or]shaft[or]maleness[at random] that [cock description of Player]."]
	now Cock Color entry is ""; [one word color descriptor]
	now Ball Count entry is 0; [allowed numbers: 1 (uniball), 2 or 4]
	now Ball Size entry is 0; [size of balls 1-7: "acorn-sized", "dove egg-sized", "chicken egg-sized" "goose-egg sized", "ostrich-egg sized", "basketball-sized", "beachball-sized"]
	[Ball Size Adjective is generated by a function and can be used in scenes too]
	now Ball Description entry is ""; [partial sentence to fit: "Underneath it hangs a pair of [Ball Size Adjective of Player] [ball description of Player]."]
	now Cunt Count entry is 0;
	now Cunt Depth entry is 0; [penetratable length in inches; some minor stretching allowed, or more with Twisted Capacity]
	now Cunt Tightness entry is 0; [size 1-5, generates adjectives of extremely tight/tight/receptive/open/gaping]
	[Cunt Tightness Adjective is generated by a function and can be used in scenes too: extremely tight/tight/well-used/open/gaping]
	now Cunt Adjective entry is ""; [one word adjective: avian/canine/...]
	now Cunt Change entry is ""; [partial sentence that fits in: "Your pussy [one of]tingles[or]goes flush[or]vibrates with odd pleasure[or]goes cold[or]feels oily[at random] as [Cunt change entry]."]
	now Cunt Description entry is ""; [partial sentence to fit: "You have a [Cunt Tightness Adjective of Player] [one of]cunt[or]pussy[or]vagina[or]cleft[at random] that [cunt description of Player]."]
	now Cunt Color entry is ""; [one word color descriptor]
	now Clit Size entry is 0; [size 1-5, see Clit Size Adjective]
	[Clit Size Adjective is generated by a function and can be used in scenes: very small/small/average/large/very large]
]

Section 3 - Endings

Table of GameEndings (continued)
Name (text)	Type (text)	Subtype (text)	Ending (rule)	Priority (number)	Triggered (truth state)
"Bouncy Succubus Infection"	"Infection"	""	Bouncy Succubus Infection rule	1000	false
"Bouncy Succubus Live In Toy"	"Leaving"	""	Bouncy Succubus Live In Toy rule	1000	false

This is the Bouncy Succubus Infection rule:
	if Player has a body of "Bouncy Succubus":
		trigger ending "Bouncy Succubus Infection"; [Here it states, that the ending has been played.]
		if humanity of Player < 10:
			say "";
		else:
			say "";

This is the Bouncy Succubus Live In Toy rule:
	if the ending "Bouncy Succubus Live In Toy" is triggered:
		the Player has left;

Bouncy Succubus ends here.
