Version 3 of Magic Drake by Qazarar begins here.
[ Version 2.0 - cock/ball staff adjustment - by Stripes ]
[ Version 2.1 - additional scenes and bad end - by Qazarar]
[ Version 3.0 - further scene expansions and content - by Qazarar]

[                mdasslevel               ]
[ 0 = not met                             ]
[ 1 = met                                 ]
[ 2 = initial ass infection - bubble butt ]
[ 3 = smallest enchanted    - plump / rounded ]
[ 4 = medium enchanted      - large / meaty /impressive / hefty ]
[ 5 = big enchanted         - huge butt / super meaty ]
[ 6 = max enchanted         - mega-booty  ]

[								mdrakequest								]
[ 0 = not active                          ]
[ 1 = used gilded staff once              ]
[ 2 = quest accepted                      ]

"Adds a shemale drake sorceress creature to Flexible Survival's Wandering Monsters table."

a postimport rule: [bugfixing rules for players that import savegames]
	if mdrakequest is 0 and Wallstuck is active: [deactivate the event if the staff was never used (using staff activates the event correctly now)]
		now Wallstuck is inactive;

Section 1 - Creature Responses

mdasslevel is a number that varies.
mdrakeloss is a number that varies.			[fights lost]
mdrakebeaten is a number that varies.		[fights won]
mdrakeoversized is a number that varies.		[times oversized own ass]
mdrakeanal is a number that varies.			[times fucked by MD]
mdstaffface is a truth state that varies.	[staff blasted face]
mdmaxlossscene is a number that varies.	[helps cycle max loss scenes]
mdrakequest is a number that varies.

to say magicdrakedesc:
	if debugactive is 1:
		say "DEBUG -> mdasslevel: [mdasslevel], mdrakeloss: [mdrakeloss], mdrakebeaten: [mdrakebeaten], mdrakeoversized: [mdrakeoversized], mdrakeanal: [mdrakeanal], mdstaffface: [if mdstaffface is true]Y[else]N[end if] <- DEBUG[line break]";
	if mdasslevel is 0:
		say "     'Ah yes! You should do nicely! With a little remodeling, you'll make for a fine familiar,' you hear an excited voice say. It is coming from a shemale dragon-woman wearing a sheer blue dress over her green scales, wings flapping as she approaches you. The dragoness's figure is very striking, even beyond being an imposing ten feet tall. While most of her body is of an average build (for her size) with a few inches to pinch, her breasts, balls, cock and ass are all outlandishly oversized. Each jiggling ass cheek is larger around than her stomach. Her breasts are similarly voluminous, bouncing buoyantly as she advances on you. And it's quite clear she's becoming excited, her nipples hard and her titanic cock throbbing as it dribbles sticky patches of precum with every slap of her basketball-sized nuts against her scaly flesh.";
		say "     So awestruck are you by her transformed figure that you only notice the details of her garments after that. Her blue dress, aside from made being almost transparently thin silk, is decorated by stars that actually twinkle. Atop her horned head, she wears a golden tiara that is molded right around her ridged brow and long horns. Around her neck is a golden talisman adorned with a fiery stone. Lastly, she holds an ebon staff with a rather phallic headpiece, also made of gold. It shimmers and leaves a streak of golden sparkles in its wake as she brings it to bear on you.";
	else:
		say "     You've ended up crossing paths with that dragon sorceress again. Her ultra-wide hips sway as the green-scaled shemale strides towards you. Her sheer blue dress hides nothing of her imposing figure - ten foot tall body, beachball breasts, titanic cock, basketball sized testicles and of course her two meter wide ass. The sight of you has clearly gotten her excited as well, her nipples hard and her cock perking up quickly.";
		say "     '[one of]There you are! Let's continue your training to become my perfect familiar. Now come here and bend over,' she commands[or]Perfect! I could use some quality time with my new familiar-to-be,' she rumbles[or][if mdasslevel < 4]Familiar! Come here! We must finish improving your body so you can be my cocksleeve whore[else if mdasslevel < 6]That ass of yours isn't quite what I need it to be. Come here so we can get you ready to take my cock[else]Come, Familiar! I need to refresh my magical energies. Bend over to receive your mistress's gift[end if],' she commands[cycling]. When you don't immediately comply, she raises her staff and energy glows around its phallic headpiece, preparing to force the issue.";
	if mdasslevel is 0, now mdasslevel is 1; [met her]

to say losetomagicdrake:
	choose row MonsterID from the Table of Random Critters;
	setmonster "Magic Drake";
	if TailName of Player is not "Magic Drake":
		if mdasslevel < 2:	[first loss]
			say "     [if HP of Player > 0]Submitting yourself to the dragoness's whims rather than fight further, you[else]Resisting as best you can, you can eventually fight no longer and[end if] are groped and manhandled by your assailant. Her clawed hands squeeze, pinch and fondle you all over, inspecting your [bodydesc of Player] body, especially your ass. While this is going on, she is also grinding her throbbing cock over you, a five foot pillar of green flesh that drools thick precum. 'Mmm... yes... I can work with this.'";
			say "     Having reached some kind of decision, she takes her staff and slaps its headpiece against your ass repeatedly. 'Gj v fem yenf wef bmjl jbrab Ahrtob's sab-n-datbjl,' she chants incomprehensibly. Tingles run through your flesh beyond just the sting of the spanking. Looking back, you can see a glowing aura around the end of the staff that seems to spew forth from the golden phallus. It clings to you and seeps into your ass, inducing a transformation to make it fuller and rounded. As the dragoness cums, veritably soaking you in her excessive spooge, there comes an orgasmically pleasurable surge through you and a long, reptilian tail forms at your rear.";
			now TailName of Player is "Magic Drake";
			now TailSpeciesName of Player is "Magic Drake";
			now Tail of Player is tail entry;
			now mdasslevel is 2;
		else:
			say "     [if HP of Player > 0]Submitting yourself to the dragoness's whims rather than fight further, you[else]Resisting as best you can, you can eventually fight no longer and[end if] are groped and manhandled by your assailant. She eyes your altered ass and gives it a hard swat. 'Oh, this will not do at all. Where's the fine booty we were working on? You're a naughty familiar and deserve to be punished,' she says with a teasing growl. She grinds her throbbing cock against you, that five foot pillar of green flesh drooling precum onto you.";
			say "     Drawing upon her magical powers, she takes her staff and slaps its headpiece against your ass repeatedly. 'Gj v fem yenf wef bmjl jbrab Ahrtob's sab-n-datbjl,' she chants incomprehensibly. Tingles run through your flesh beyond just the sting of the spanking. Looking back, you can see a glowing aura around the end of the staff that seems to spew forth from the golden phallus. It clings to you and seeps into your ass, inducing a transformation to make it fuller and rounded. As the dragoness cums, veritably soaking you in her excessive spooge, there comes an orgasmically pleasurable surge through you and a long, reptilian tail forms at your rear[if mdasslevel is 3]. By the time her spell's completed, that plump, rounded booty from before has returned[else if mdasslevel is 4]. By the time her spell's completed, that impressively large booty from before has returned[else if mdasslevel is 5]. By the time her spell's completed, that huge booty from before has returned[else if mdasslevel is 6]. By the time her spell's completed, that titanic mega-booty from before has returned[end if].";
			now TailName of Player is "Magic Drake";
			now TailSpeciesName of Player is "Magic Drake";
			now Tail of Player is tail entry;
	else if mdasslevel < 2:		[first loss, but already infected]
		say "     [if HP of Player > 0]Submitting yourself to the dragoness's whims rather than fight further, you[else]Resisting as best you can, you can eventually fight no longer and[end if] are groped and manhandled by your assailant. Her clawed hands squeeze, pinch and fondle you all over, inspecting your [bodydesc of Player] body, especially your ass. While this is going on, she is also grinding her throbbing cock over you, a five foot pillar of green flesh that drools thick precum. 'Mmm... yes... Already started, I see. All the better; I can certainly work with this.'";
		say "     Having reached some kind of decision, she grabs you by your draconic tail and easily raises your ass in the air. Holding you like that with one arm, she swings her staff with the other, swatting your rear with it. 'Mbk feth jsic rf'btvr fem yn wef bmjl jbra Wj-Thiban jc febj gibs sa,' she chants incomprehensibly. Tingles run through your flesh beyond just the sting of the spanking. Looking back, you can see a glowing aura around the end of the staff that seems to spew forth from the golden phallus. It clings to you and seeps into your ass, inducing a transformation to make it fuller and rounded. As the dragoness cums, veritably soaking you in her excessive spooge, you feel it and the magic seeping into you, corrupting you further even as your ass plumps up a little more.";
		now mdasslevel is 3;
	else if mdasslevel is 2:		[smallest ass]
		say "     [if HP of Player > 0]Rather than fight the seemingly magical dragoness, you give up and let her do as she will. She pushes you down onto your back and slides that meaty rod of hers heavily across your chest. At her prompting, you wrap your arms and legs around her pulsing pillar. You hug around its five foot length with your [bodydesc of Player] body as she starts thrusting into your grip[else]You try to stand up to the seemingly magical dragoness, but eventually can fight no longer. She pushes you roughly onto your back and drops that meaty rod of hers heavily across your chest, knocking the wind out of you. As you struggle to catch your breath, she grabs your arms and legs, wrapping them around her pulsing pillar. Having little choice in the matter, you hug around its five foot length with your [bodydesc of Player] body as she starts thrusting into your grip[end if].";
		say "     As she thrusts into your grip, drooling precum onto you, she raises her staff aloft and starts incanting. 'M-prf! Gj v feth f'mbab jgip'l vmp ubp pty.' A glowing aura seems to spew forth from the golden phallus topping the staff, leaving streaks in the air as she waves it around. After etching some incomprehensible sigil with the light, the dragoness points the staff down at you and the glowing particles stream towards your ass. Tingles run through your flesh as it clings to you and starts seeping into your draconic ass. You can feel your butt cheeks swelling, growing fuller and rounder as the strange energies transform you further. 'Oh yes! Yes! More! My slutty pet will need a nice, big ass!' she screams excitedly as she sees your bottom enlarging.";
		say "     In her excitement, the green dragon cums with a roar, splattering your face and shoulders in a torrential series of blasts from her emerald cock[if HP of Player > 0]. You gulp down what you can catch in your mouth, but much of it ends up on you rather than in you[else]. Already panting and aroused by the pleasure you're feeling from your swelling bottom, you end up catching several mouthfuls of her gooey seed, though most of it ends up on you rather than in you[end if]. Once drained, the dragoness gets up, wipes the sticky tip of her cock against your increased ass and sends you on your way for now.";
		now mdasslevel is 3;
	else if mdasslevel is 3:
		say "     [if HP of Player > 0]Giving in, you stop resisting and allow the sorceress to push you down to your knees. The shemale smears your face with her drooling cock, the musky scent wetting your appetite for more[else]Once you're unable to continue resisting her, the sorceress pushes you roughly to your knees. The shemale smears your face with her drooling cock, the musky scent of it arousing you despite yourself[end if]. You lick at her cumslit, even working the tip of your tongue up into it. 'Yes, my good familiar-to-be, pleasure your mistress.' Some sane part of you wants to refuse, but there is only a brief hesitancy. Perhaps frustrated by your lack of immediate compliance or just to prove a point, she grabs the back of your head and forces her massive prick into your mouth.";
		say "     With the dragoness holding you and her super-sized cock speared into you, you can only squirm[if HP of Player > 0] and lick[end if] as she fucks your face with that pillar of emerald flesh. While she uses little more than the first foot and a half or so, that's more than enough to force your maw to stretch around it. Her assault bulges your mouth and throat open to take her, a clear impression of the tool stuffed into you easily felt by your hands rubbing over the oddly enjoyable bump moving inside you.";
		say "     As she picks up the pace, she waves her staff around and strikes your ass with another tingling blast of energy. 'Pho jib mag pjngit pomb k'fey pvr ubp pty os pobjg. Thfr fsen pth jn gihpt T'freth bnab-nab s sayp vuc bn taf v fnewr bpayp vrub rmsab rp vnd,' she incants. While it is hard to focus on her words with her foot thick meat stuffed uncomfortably into your excessively stretched mouth, you are becoming quite familiar with the power of her magic flowing into you. Your ass grows and swells further as the corrupting energies splatter across your rear and seep into you just as the dragoness cums with a mighty roar.";
		say "     'Take it! Take it, my slutty familiar. Guzzle down your mistress's load so you can grow a nice, plump booty for me to fill.' With a snap and a pop that's surprisingly pleasant, your hips actually widen to allow your butt to grow several inches rounder. By the time the spell's complete and your belly is bloated with draconic semen, you're left with an impressively large booty, an aching jaw and a sloshing in your belly as you stagger off to recover.";
		now mdasslevel is 4;
	else if mdasslevel is 4:
		if HP of Player > 0:
			say "     Rather than fight, you submit to the dragoness, much to her delight. 'That's a good slut. I think it's time for some proper training so you can fulfill your duties as my familiar and whore,' she rumbles as she pushes you to the ground on all fours. Standing in front of you, she grabs your draconic tail and raises it up, showing off your ass while offering up her throbbing cock to your mouth once again. Knowing what's needed of you, you lick all over her titanic green glans before opening your mouth. With a firm press of her powerful hand, it's forced back into your mouth, stretching it wide to take the foot-thick pillar of meat.";
		else:
			say "     Despite your attempts to fight, you're beaten by the dragoness, much to her delight. 'Don't you see, you willful creature? There is no point in resisting your mistress. I think it's time for some proper training so you can fulfill your duties as my familiar and whore,' she growls as she pushes you to the ground on all fours. Standing in front of you, she grabs your draconic tail and yanks it up, showing off your ass while offering up her throbbing cock to your mouth once again. Knowing what she wants and that she'll take it by force if need be, you start licking her titanic green glans before opening your mouth. With a firm press of her powerful hand, it's forced back into your mouth, stretching it wide to take the foot-thick pillar of meat.";
		say "     Tightening her grip on your tail, she waves her free hand in the air, directing her staff to levitate. It moves around behind you and soon you're feeling a cool, sticky prodding at your anus. Your ass squirms at its touch, but the dragoness's grip is strong and your infected bottom wants to be filled. With a slick pop, the golden phallus atop the staff pops into you and starts thrusting with a casual flick of the dragoness's talon. You can't help but moan as you feel it pumping into you, your plump booty grinding back onto it and squeezing around it as you're spitroasted.";
		say "     As she uses her magical staff like a dildo on you, your front end fares no better, her epic cock being forced into your mouth and down your throat, stretching your flesh to the point of bulging to be able to fit it. You can feel it pulsating and throbbing with every beat of her heart, leaking more precum down your throat and into your belly. She works her penis deeper to stretch out more of your insides, panting and rumbling with pleasure as she does. She pushes and thrusts to get it roughly half-buried inside you before the dragoness seems satisfied for now. She swaps to thrusting back and forth inside your bulging throat and torso as she starts to chant.";
		say "     'Lp pkob tath j'sis Lvtus vckum yuc-pck. Jtin ffdse bab jg, ifb tabs safp romfet pof vckul jkfem bd,' she intones and you can feel a growing fullness in your ass. That tingling energy from the staff wells up from it, flowing into you directly now. You can feel it collecting around the headpiece as a thickening gooey coating, stretching your back door open even further as it builds up into a growing layer of soft, squishy goo over the firm, golden core. Your hips widen markedly to deal with your growing ass, swelling up and out to become huge and heavy.";
		say "     The dragoness rocks her hips faster and motions her talons to have the staff keep pace with her rapid thrusting. All you can do is moan and squirm with growing pleasure as you're abused from both ends. This eventually culminates in the sorceress's roaring release as she blasts a torrent of draconic cum down your throat and into your bloating belly. She lets herself drain into you before withdrawing from your abused holes. Gooey cum leaks from your overflowing mouth and some of the sparkling goo trickles out of your stretched asshole before eventually getting absorbed into you. Collecting yourself, you stagger off with a wet sloshing of your overfull belly.";
		now mdasslevel is 5;
	else if mdasslevel is 5:
		say "     With the fight over, the shemale pins you down [one of]on the ground[or]across some rubble[or]over a smashed car[or]over a fallen tree[as decreasingly likely outcomes]. 'Well, you're almost to the point I want you, my little plaything. Let's see if we can't get you finished up,' she says with a chuckle. She then moves overtop of you, pinning you beneath her crushing booty. She grinds her ass in your face and you can feel her bloated balls and swollen cock also pressing down upon you.";
		say "     As she starts to rock herself overtop of you, your head ends up wedged between her ass and ballsack, the musky scent of the shemale making your already oxygen-deprived brain all the more foggy and muddled. The comes an odd tickle at your back door as something flicks against it a few times, followed by a more firm prodding. As it pushes its way into you, stretching your tight hole open, the way it wriggles brings the realization that it's her tail squirming into you to stretch you open. Despite, or perhaps even because of, your helpless situation, you start to grow aroused and moan[if anallevel is 3 or (anallevel is 2 and Player is submissive)]. With her tight tailhole before you and a growing lust overtaking you, you start licking at her puckered hole[end if].";
		say "     You can faintly hear the dragoness incanting, but cannot make out the words. But you know the feeling when it comes, another stream of energy running across and flowing into your ass, causing it to swell and bloat even further. Your hips pop and snap, widening a great deal as they're stretched to accommodate more and more of her thick tail pushing into you. Your anus is stretched and widened by the steady advance of the scaled appendage, which sends a surprising amount of pleasure into you. It seems your draconic booty's been made extra-sensitive and ripe for fucking[if anallevel is 3 or (anallevel is 2 and Player is submissive)]. And with you rimming her pucker wildly, she doesn't hold back in her own moans either[end if].";
		say "     Eventually this builds to a peak when the dragoness roars and cums hard, spraying her load. You can feel the heavy, gurgling throbs of her balls pumping their white payload to paint the area with her seed[if Player is not neuter]. You end up cumming as well, driven to climax by the incessant squirming of her scaly appendage inside you[else]. This is further aggravated by the incessant squirming of her scaly appendage inside you[end if]. Eventually, you are released, the dragoness removing her bulk from you slowly and easing that textured tail from your hypersensitive hole. Helping you up, the sorceress gives your ass a pat and a fondling. 'Yes, that's just how I like it. You're ready to be my cock-sleeve next time we meet, my cute familiar,' she says, fingering your loose hole. You're then left to stumble away, walking funny from both your comically overgrown ass and delightfully aching, widely gaping asshole.";
		now mdasslevel is 6;
	else if mdasslevel is 6:		[maxed ass, ready for fucking]
		[Ask player if they want intense scene, if no play old losses. If yes play new content.]
		say "     [bold type]Does the dragoness push you even further than before?[roman type][line break]";
		LineBreak;
		say "     ([link]Y[as]y[end link]) - Bigger is better.";
		say "     ([link]N[as]n[end link]) - Just be her familiar.";
		LineBreak;
		if Player consents:
			say "[mdrake_bigger_better]";
		else if (mdmaxlossscene > 1 and a random chance of 1 in 2 succeeds):
			say "[mdrake_more_scenes]";
		else:
			if the remainder after dividing mdrakeloss by 3 is 1:
				say "     'Now, this is just how I like [']em,' the dragoness rumbles as she gropes your ultra-plump ass. 'Mmm... you look good enough to fuck.' And with that, she pushes you over, yanks your tail into the air and slaps that huge pillar of meat across your back. At five feet in length and a foot across, you shudder at what that thing will do to you. Your enchanted ass though wiggles back as your tailhole relaxes and readies itself of its own accord, as if sensing its mistress at the ready.";
				say "     'That's a good familiar. You're my fine, fat-assed slut. It's time for you to serve me. I know you want it,' she rumbles, teasing her drooling glans against your pucker, which quivers and kisses at it. You can feel your rear want her inside you, feeling empty without your mistress. This feeling grows and by the time she's done teasing you, you're panting heavily and on the edge of begging for it.";
				say "     Holding your ass tightly in both taloned hands, she thrusts [if HP of Player > 0]slowly into you, letting your back passage stretch gradually at first[else]into you firmly, sending a sharp twinge through your back passage as it's forced open[end if]. Your body stretches and bulges, your insides distorting and shifting to accommodate the massive intruder ploughing into you[if scalevalue of Player < 3]. Her cock is so big compared to your [Body Size Adjective of Player] [bodytype of Player] form that you end up stretched around her meat like a fleshy condom[else if scalevalue of Player < 5]. Her cock, nearly as big as a normal person on its own, stuffs you impossibly full and leaves a clear impression of it against your bulging flesh[else]. Her cock, nearly as big as a normal person, stuffs you incredibly full, so much so that there's a definite bulge formed by it[end if]. And even with this, the experience is incredibly arousing, your whole body squeezing and tugging at the pulsating pillar pounding away at you, working steadily deeper[if scalevalue of Player < 5] until finally there's a phallic protrusion of her glans stretching your torso[end if].";
				say "     Struggling for breath as her throbbing, thrusting log pumps inside you, you can only pant weakly as you're suspended in the air upon her massive prick. Overcome with arousal at being so fully used by the dragoness, you run your hands over your cock-stretched body, loving being able to feel every twitch and throb it makes. Your mistress rumbles on about what a fine fuck you are, and a good, slutty familiar, and a naughty cocksleeve. Her words send shivers of delight through your sex-addled mind[if Player is not neuter], and already on the edge of release, you're driven to climax, cumming hard with feeble gasps and moans of ecstasy[end if]. Feeling your body squeeze and clench down around her, your mistress achieves her own climax and cums hard into you, releasing a torrent of semen that [if scalevalue of Player < 3]fills you to overflowing as your body sloshes beyond fullness[else if scalevalue of Player < 5]fills you to the point of rounding your body with fullness[else]fills your belly to a sloshing fullness that leaves it visibly plumper[end if].[mimpregchance][mimpregchance]";
				if Player is male and Cock Length of Player < Cock Length entry and "Female Preferred" is not listed in feats of Player and "Modest Organs" is not listed in feats of Player:
					say "     While cumming, the draconic sorceress reaches around to grab your throbbing, spurting cock and pumps it vigorously. Chanting softly, words obscured by the gurgling blasts of all the cum filling you, she sends magical power through her hands that causes your manhood to grow further. When she's done both her climax and her spell, she [if scalevalue of Player < 3]peels you off her softening penis[else]eases her you off her softening penis[end if] and leaves you there, bloated with her semen and leaking a steady flow of it from your gaping back door.";
					increase Cock Length of Player by 1;
					now Cock Length of Player is ( ( Cock Length of Player * 3 ) + Cock Length entry ) / 4;
					decrease humanity of Player by 1;
					increase Libido of Player by 5;
				else if Player is male and Ball Size of Player < Ball Size entry and "Female Preferred" is not listed in feats of Player and "Modest Organs" is not listed in feats of Player:
					say "     While cumming, the draconic sorceress reaches around to [if CockName of Player is listed in infections of InternalCockList]rub over your hidden balls[else]grab your twitching balls and knead them[end if]. Chanting softly, words obscured by the gurgling blasts of all the cum filling you, she sends magical power through her hands that causes your testicles to grow further. When she's done both her climax and her spell, she [if scalevalue of Player < 3]peels[else]eases[end if] you off her softening penis and leaves you there, bloated with her semen and leaking a steady flow of it from your gaping back door.";
					BallsGrow Player by 1;
					decrease humanity of Player by 1;
					increase Libido of Player by 5;
				else if Breast Size of Player < Breast Size entry and "Flat Chested" is not listed in feats of Player:
					say "     While cumming, the draconic sorceress reaches around to [if Nipple Count of Player is 0 or Breast Size of Player is 0]your flat chest and rubs it[else]your bouncing tits and kneads them[end if]. Chanting softly, words obscured by the gurgling blasts of all the cum filling you, she sends magical power through her hands that causes your breasts to grow further. When she's done both her climax and her spell, she [if scalevalue of Player < 3]peels[else]eases[end if] you off her softening penis and leaves you there, bloated with her semen and leaking a steady flow of it from your gaping back door.";
					follow the breast change rule;
					decrease humanity of Player by 1;
					increase Libido of Player by 3;
				else:
					say "     While cumming, the draconic sorceress grips your ass all the tighter and kneads at your jiggly bottom. Chanting softly, words obscured by the gurgling blasts of all the cum filling you, she sends magical power through her hands that sends more pleasure through you. With it comes a greater longing to be with the dragoness who's remade you to be so beautiful and brought you amazing carnal delights. When she's done both her climax and her spell, she [if scalevalue of Player < 3]peels[else]eases[end if] you off her softening penis and leaves you there, bloated with her semen and leaking a steady flow of it from your gaping back door.";
					decrease humanity of Player by a random number between 2 and 4;
					increase Libido of Player by a random number from 2 to 4;
				if "Strong Psyche" is listed in feats of Player, increase Humanity of Player by 1;
				if "Weak Psyche" is listed in feats of Player, decrease humanity of Player by 1;
				if "Horny Bastard" is listed in feats of Player, increase Libido of Player by 1;
				if "Cold Fish" is listed in feats of Player, decrease Libido of Player by 1;
				if Libido of Player > 100, now Libido of Player is 100;
				increase mdrakeanal by 1;
			else if the remainder after dividing mdrakeloss by 3 is 2:
				say "     [if HP of Player > 0]Choosing to submit rather than fight on, you allow the huge dragoness to push you to the ground. Thinking you know what comes next, you move onto all fours, raising your inflated backside in the air with trepidation as well as a twinge of excitement[else]Try as you might, you eventually fall before the mighty dragoness. With the fight knocked out of you, she pushes you to the ground easily. Fearing what will come next, you try to scramble away before she can pin you down on all fours[end if]. But the shemale creature surprises you, grabbing you just above the knees and raising your legs up into the air. Now with your face and shoulders pressed to the ground, all you can do is prepare for the inevitable reaming. The dragoness takes a little time to check out your massive backside, first lusting over it with her eyes before fingering your stretchy hole. Yet despite your concerns for what's to come, your body - that draconic booty especially - grows excited, and soon you're panting [if HP of Player > 0]with growing anticipation[else]regardless of your attempts to resist[end if].";
				say "     'Such a cockslut you are. I knew you'd be a fine familiar,' she rumbles, popping her fist free. 'You have that air of someone who longs for a good, full fucking. Isn't that right?' Before you can even attempt a response, your recently vacated anus is plugged full with the even larger intrusion of her cock, reducing your words to an incoherent moan[if scalevalue of Player < 3]. Her cock is so big compared to your [Body Size Adjective of Player] [bodydesc of Player] form that you end up stretched around her meat like a fleshy condom[else if scalevalue of Player < 5]. Her cock, nearly as big as a normal person on its own, stuffs you impossibly full and leaves a clear impression of it against your bulging flesh[else]. Her cock, nearly as big as a normal person, stuffs you incredibly full, so much so that there's a definite bulge formed by it[end if]. As she pounds deeper into you, your insides are stretched or pushed out of the way to make room for the massive, throbbing penis.";
				say "     Now stuffed full of cock, your stretched-out chest is pressed to the ground by the weight of the meat filling you. All you can do is moan weakly as she pumps into you over and over again by yanking on your legs. And while this should be fatal, or at least quite painful, it instead becomes increasingly pleasurable for you. Your hands stop trying to support yourself and instead move to rubbing over your [if scalevalue of Player < 3]phallus-encasing[else if scalevalue of Player < 5]distorted[else]bulged[end if] body, also better sandwiching your sensitive flesh between the ground and the throbbing glans inside you.";
				say "     Greatly enjoying her cock-sleeve familiar, the dragoness's climax is a powerful one. She releases a veritable torrent of semen that doesn't so much come in spurts as a continuous flow with surges and ebbs. Her grand output is more than enough to [if scalevalue of Player < 3]fill you to overflowing, the excess gurgling out your mouth and spurting from your overstuffed rectum[else if scalevalue of Player < 5]fill you to the point of bloating your body with her seed[else]fill your belly to a sloshing fullness that leaves it markedly plumper[end if].[mimpregchance][mimpregchance]";
				say "     Lost in a haze of pleasure and the wet feeling of overfullness, it takes some time to realize that her climax has ended. After taking a minute to enjoy the gooey feeling of your cum-stuffed insides around her softening member, she pulls out with a slurping pop. She slaps her sticky shaft across your back, splattering you up and down with her seed before heading off.";
				say "     'I'll leave you to enjoy that for now, my [if HP of Player <= 0]reluctant [end if]familiar. I look forward to savoring that beautiful butt of your again soon, my pet.'";
				increase mdrakeanal by 1;
			else:
				if HP of Player > 0:	[submitted]
					say "     The seemingly magical dragoness smiles as she runs her taloned hands gently over you, petting and caressing you even as she gropes your ultra-plump ass. 'That's better, my sexy familiar. You'll see things are much nicer if you don't resist me. Mistress knows best,' she rumbles, fingering your asshole. Your pucker, wide and stretchy now from the repeated growth, welcomes the wriggling fingers and you moan softly. Reaching around to your front, she [if Cock Count of Player > 1]takes hold of one of your cocks and starts stroking it as well[else if Player is male]takes hold of your cock and starts stroking it[else if Player is female]teases across your puss[yfn], rubbing your wet folds and sensitive clit[sfn][else]rubs your bare crotch with softly pleasurable motions[end if].";
					say "     This excites you further and your expanded butthole relaxes further, almost tugging on her hand until she pushes her fist fully into it. Getting fisted is somewhat more satisfying and fulfilling, but it also makes you all the more aware of how your ass can take - no, needs to take - more. And that big, throbbing cock of hers pressed against your body further increases that longing. The dragoness is clearly aware of your growing need as well and rumbles happily, working both hands faster. 'Does my fucktoy familiar need something? You want me to fuck you, don't you?' she purrs softly in your ear. You release another moan and your rectum squeezes firmly around her pumping fist, your [bodydesc of Player] body rubbing back against her enormous rod. After that, all it takes is a lick along the edge of your ear and a sensual tickle [if Player is male]to your prostate[else]along your sensitive anal walls[end if] to have you moan out in need, almost begging the dragoness to fuck you.";
					WaitLineBreak;
					say "     She rumbles happily as you assent, giving your ear another lick. 'That's my good, sexy familiar,' she purrs, easing her fist out slowly. Spreading your cheeks wide, she moves to get her mighty cock lined up before thrusting her thickness into your stretched-out hole. She enters you with a smooth, steady motion and you give one long moan of delight as she does. Your butt, after all of that warming up and teasing, is more than ready to take her into it and the penetration and sense of growing fullness is wonderful. Soon enough, she's buried the whole of her majestic penis into you[if scalevalue of Player < 3]. Her cock is so big compared to your [Body Size Adjective of Player] [bodytype of Player] form that you end up stretched around her meat like a fleshy condom[else if scalevalue of Player < 5]. Her cock, nearly as big as a normal person on its own, stuffs you impossibly full and leaves a clear impression of it against your bulging flesh[else]. Her cock, nearly as big as a normal person, stuffs you incredibly full, so much so that there's a definite bulge formed by it[end if].";
					say "     Pressed to the ground by the weight of cock filling you, you squeeze and wriggle over the pulsing rod filling you. You grip the ground and steady yourself as best you can as she eases back a couple of feet and thrusts back into you. Soon she's buggering you steadily and your pleasure-addled body struggles to maintain a grip so your mistress can continue to screw you senseless. The much-needed fucking is almost mind-numbingly good, almost literally fucking your brains out - eroding your will and humanity a little more. And just as you start to notice this happening, the dragoness cums and cums hard. Almost roaring she screams her lustful release so loud, you gasp as the air is pushed from your lungs as a torrent of semen floods your body, bloating your belly. The sudden rush of ecstasy that comes with this also pushes your thoughts of resistance from your mind as you succumb momentarily to the carnal delights[if Player is not neuter] and orgasm powerfully[end if]. Her grand output is more than enough to [if scalevalue of Player < 3]fill you to overflowing, the excess gurgling out your mouth and spurting from your overstuffed rectum[else if scalevalue of Player < 5]fill you to the point of bloating your body with her seed[else]fill your belly to a sloshing fullness that leaves it markedly plumper[end if].[mimpregchance][mimpregchance]";
					WaitLineBreak;
					say "     After stuffing your insides with her gooey cum, she pulls out of you with a slurping pop. Striding around to your front, she brings her sticky and still leaking shaft to your lips. Like a good pet, you do your best to lick and suck at it[if scalevalue of Player < 3] even if you're unable to swallow any more as her cum still drools from your mouth[else if scalevalue of Player < 5] even though there's no room left in your belly for the cum you try to swallow[else], barely managing to swallow down a few more mouthfuls of cum into your already overstuffed belly[end if]. The dragoness seems quite pleased with herself and you can't help but be pleased by this. 'Mmm... I'll let that all [']soak in['],' she says with a rumbling purr. 'If you keep being a good slut like that, you'll be properly ready to be my familiar very soon. Won't that be lovely?' She caresses your overstuffed, leaking butt and fingers your gooey hole, sending shivers of delight through you, making you long a little more to be a good pet for her.";
					increase mdrakeanal by 1;
					decrease humanity of Player by a random number between 5 and 10;
					increase Libido of Player by a random number from 3 to 6;
				else:		[lost combat]
					say "     The seemingly magical dragoness grumbles as she runs her taloned hands gently over you, groping you roughly even as she fondles your ultra-plump ass. 'Why must you resist me so, my sexy familiar? You'd find things much more enjoyable if you didn't resist me. You should obey your mistress,' she growls, fingering your asshole. Your pucker, wide and stretchy now from the repeated growth and abuse, welcomes the wriggling fingers even as you groan and try to squirm free. Reaching around to your front, she [if Cock Count of Player > 1]grabs hold of one of your cocks and starts pumping it as well[else if Player is male]grabs hold of your cock and starts pumping it[else if Player is female]gropes at your puss[yfn], rubbing your wet folds and sensitive clit[sfn][else]grabs your bare crotch[end if] to help curtail your flagging attempts to resist.";
					say "     As you grow increasingly aroused despite yourself, your expanded butthole relaxes further, almost tugging on her hand until she pushes her fist fully into it. You groan louder in shock, surprise and more than a little pleasure as she changes to fisting you. But it also makes you all the more aware of how your ass can take - no, needs to take - more. And that big, throbbing cock of hers pressed against your body further increases that dreadful longing. The dragoness is clearly aware of your growing need as well and rumbles teasingly, working both hands faster. 'Do you need something, you cocksleeve slut? You want me to fuck you, don't you? Say it,' she purrs softly in your ear. You release another moan and your rectum squeezes firmly around her pumping fist, your [bodydesc of Player] body rubbing back against her enormous rod. You shake your head and bite your lip, trying to hold back, so she keeps it up. She licks along the edge of your ear and presses firmly [if Player is male]against your now-throbbing prostate[else]against your sensitive anal walls[end if]. Eventually this wears you down and you moan out in need, almost begging the dragoness to fuck you at this point.";
					WaitLineBreak;
					say "     She chuckles as you assent, giving your ear another lick. 'See. Now was that so hard?' she purrs teasingly. She pulls her fist out with a quick pop that leaves your asshole gaping. Spreading your cheeks wide, she moves to get her mighty cock lined up and thrusts her thickness into that stretched-out hole. She enters you with a swift, steady motion and you give one long moan of strain and delight as she does. Your butt, after all of that warming up and teasing, is quite ready to take her into it and the penetration and sense of growing fullness is shockingly wonderful. Soon enough, she's buried the whole of her majestic penis into you[if scalevalue of Player < 3]. Her cock is so big compared to your [Body Size Adjective of Player] [bodytype of Player] form that you end up stretched around her meat like a fleshy condom[else if scalevalue of Player < 5]. Her cock, nearly as big as a normal person on its own, stuffs you impossibly full and leaves a clear impression of it against your bulging flesh[else]. Her cock, nearly as big as a normal person, stuffs you incredibly full, so much so that there's a definite bulge formed by it[end if].";
					say "     Pressed to the ground by the weight of cock filling you, you squeeze and wriggle over the pulsing rod filling you. You struggle to grip the ground and steady yourself as best you can as she eases back a couple of feet and thrusts back into you hard. Soon she's buggering you steadily and your pleasure-addled body gets pushed slowly across the ground each time. That is until your head and shoulders are pressed against the base of a wall, allowing you to remain steady so your mistress can continue to screw you senseless. The much-needed fucking is almost mind-numbingly good, almost literally fucking your brains out. A part of you wonders why you would even resist this, only partly realizing your will and humanity are being eroded a little more. And just as you start to notice this happening, the dragoness cums and cums hard. Almost roaring she screams her lustful release so loud, you gasp as the air is pushed from your lungs as a torrent of semen floods your body, bloating your belly. The sudden rush of ecstasy that comes with this also pushes your thoughts of resistance from your mind as you succumb momentarily to the carnal delights[if Player is not neuter] and orgasm powerfully[end if]. Her grand output is more than enough to [if scalevalue of Player < 3]fill you to overflowing, the excess gurgling out your mouth and spurting from your overstuffed rectum[else if scalevalue of Player < 5]fill you to the point of bloating your body with her seed[else]fill your belly to a sloshing fullness that leaves it markedly plumper[end if].[mimpregchance][mimpregchance]";
					WaitLineBreak;
					say "     After stuffing your insides with her gooey cum, she yanks out of you with a slurping pop that makes your ass quiver. Hauling you back from the wall, she turns you around so she can press her sticky and still-leaking shaft to your face. She smears her semen across your face and presses her gaping cumslit to your lips. Knowing what she wants, you do your best to lick and suck at it[if scalevalue of Player < 3] even if you're unable to swallow any more as her cum still drools from your mouth[else if scalevalue of Player < 5] even though there's no room left in your belly for the cum you try to swallow[else], barely managing to swallow down a few more mouthfuls of cum into your already overstuffed belly[end if]. The dragoness seems quite pleased with herself and you can't help but be pleased by this. 'Mmm... I'll leave this lesson to [']soak in['],' she says with a rumbling purr. 'Maybe that'll teach you to be a good slut next time. But don't worry, we'll have you properly ready to be my familiar soon enough. Won't that be lovely?' She slaps your overstuffed, leaking butt and fingers your gooey hole. This sends shivers of delight through you, making a part of you long a little more to be a good pet for her.";
					increase mdrakeanal by 1;
					decrease humanity of Player by a random number between 4 and 7;
					increase Libido of Player by a random number from 2 to 5;
				if "Strong Psyche" is listed in feats of Player, increase humanity of Player by 2;
				if "Weak Psyche" is listed in feats of Player, decrease humanity of Player by 2;
				if "Horny Bastard" is listed in feats of Player, increase Libido of Player by 1;
				if "Cold Fish" is listed in feats of Player, decrease Libido of Player by 1;
				if Libido of Player > 100, now Libido of Player is 100;
	say "[mdscaletweak]";
	if mdrakeanal >= 3 and player is not twistcapped:
		say "     From the way your asshole and insides have been so thoroughly used, abused and stretched by the dragoness's cock, you have a feeling that you'll never quite be the same again.";
		FeatGain "Twisted Capacity";
	increase mdrakeloss by 1;

to say mdrake_more_scenes:
	say "     You fall to your knees, overcome by the magic drake. Above you, the drake chuckles and walks towards you with a relaxed gait, one that doesn't quite mesh with the eager expression on her face. 'I was planning on improving my spell with you again, but you look so tempting, my familiar. I think instead I'll just enjoy you directly, and get back to work the next time. How does that sound, hmm?' You are at first unsure if it is a rhetorical question, but as the drake reaches down and gently lifts your face, making eye contact, you can tell what answer she wants. You nod slowly, powerless to resist her demands, and in response she smiles with only the slightest hint of smugness. 'I expected as much, I can tell you always enjoy our little... chats, almost as much as I do.'";
	if a random chance of 1 in 2 succeeds: [anal]
		say "     Rather than leave you in your current position, the drake gently pushes you back, using her surprising strength to control your movement carefully. For a moment you're simply lying on your back, looking like you'll be treated to a railing from missionary position, but you find that instead she grips your ankles and lifts. In a mere moment she has your legs raised above your head, leaving you completely at her mercy in a perfect position to receive a pounding. You can clearly see as her expression changes, features aligning into the smugly satisfied expression that is so familiar on her face. Equally visible is her massive shaft hanging in the air between you, though you know that it won't be there for much longer when there's a much better place for her to store it—inside you.";
		WaitLineBreak;
		say "     For a single moment she holds her shaft in place just at your entrance, as if savoring the experience. The next moment her hips grind into motion once more, powering her member forwards and impaling you on it. You've had this particular sensation a number of times, but each time is just as intense as the last, the drake never failing to deliver a world-class fucking. Each time she pistons in and out, she goes just a little bit deeper, the force of each thrust only amplified by the way she's leaning over you. You can already feel faint stirrings of pleasure within you, building up with each pump into your jiggling rear. Finally she hits the deepest point she can, something you can tell by the feeling of her basketball sized orbs colliding with your cheeks when she bottoms out, and further confirmed by the visible outline of her huge cock.";
		say "     Your mistress lets out a sigh of satisfaction as she rests for a moment, fully sheathed inside you. 'Truly, you're the best familiar a sorceress could ask for. You feel so perfect wrapped around my cock, and the blissed out look it gives you is a sight to behold.' With that, she slowly moves again, this time staying almost fully within you, each time pulling only a few inches out before gliding back in, steadily teasing you. In addition to the sensations you were already feeling, a familiar tingle has returned, with your plush behind gaining a little extra bit of stuffing each time she stuffs you, until it's massive enough to match her own endowments fully.";
		WaitLineBreak;
		say "     Once she has you exactly the way she wants you, she continues her sensual motions. Each stroke subjecting you to the feeling of her smooth flesh against your inner walls, the rising friction only increasing the positive sensations. The repeating actions start to lull you into a surprisingly calm state, passively taking everything she gives you as the pleasure simply washes over and through you, her face the only thing on your mind. She looks down in the midst of her thrusting, and her eyes meet yours. Everything comes to a stop, forming a surprisingly tender moment. Within that moment you wonder where this might lead, but those questions are quickly buried under the onslaught of bliss that arrives when she starts to thrust once more, this time with even more feeling.";
		say "     As if a spell has been broken, the peaceful aura you were both surrounded in is torn away, leaving only the powerful contact between you. Her pace accelerates, and taken with the way her expression is twisting, you're almost certain she's about to hit her peak. Your faint, breathy noises finally erupt into full fledged moans, as you eagerly await what she has in store for you. She's about to treat you like nothing more than a receptacle for her enchanted seed, and as her familiar you're happy to comply. Eventually her voice matches yours, moaning alongside, as she slams her titanic member fully into you for the last time, one final shockwave of pleasure and jiggling flesh leading the way directly into a shared climax.";
		say "     The moment the two of you orgasm, your pleasures intertwined, you can feel the surge of cream flooding into you, wave after wave of the magical load being released from the magic drake. It seems to keep coming, jet after jet, enough to leave you with a visible belly from just how much is being stored in your rear, until finally the wave subsides. The drake does not pull out as you expect her to, but instead adjusts your position until you're held in her arms, still full of her member, at least for now. For several minutes she remains like that, without a word, but eventually she disentangles from your joining, leaving you to finish your recovery on your own. 'That was most delightful, my familiar. I'm looking forward to the next time.'";
	else: [oral]
		say "     Without moving you from your position at all, the drake stands back up fully, only pausing to adjust her dress, revealing her massive endowments to the world. From where you are, the tip of her shaft hangs enticingly in the air only inches away from your face. It's easy to predict what she wants you to do at this point, and you can't see a good reason not to play along, not when your perspective is entirely taken up by the sight and smell of her draconic member. You decide to waste no time in adding taste to that very same list, and lean forward pressing your closed lips against the head in a gentle kiss, before gradually adding careful licking to your performance, working her up for the main event.";
		WaitLineBreak;
		say "     She's clearly willing to let you work at your own pace, and you repay that generosity with eager service. As you tease your way across the surface of her dick, you marvel at each tiny detail, committing it all carefully to memory. The overwhelming and heady scent of her member, with the matching taste of the shaft, the strong flavor of the streams of pre constantly drooling from her slit, the sensation of every vein and ridge dotting the surface as you run your tongue and fingers over them—together they form a perfect whole, a not-so-little piece of paradise right there in your mouth.";
		say "     After several minutes of savoring those sensations, you take a slight detour in your path along her magnificent cock, working your way down towards the equally beautiful orbs below, each one large enough to match a volleyball. In several ways what follows is a repeat of your earlier performance, mostly with your attention to detail. Despite perhaps being superficially less important, you dedicate no less effort and focus to worshiping her full balls, practically burying your face in them as you work. You massage them with both hands while you kiss and suck at the skin, almost able to feel the powerful load held within.";
		WaitLineBreak;
		say "     Finally, it's time for the main course. You work your way back up to the head, meeting the drake's eyes for just a moment of silent communication, before taking the plunge. The sheer size of her member makes the ordeal a rather daunting one, but you wouldn't have it any other way. With some effort, you're able to start slipping your lips around the tip, inching down slowly. Each step is a trial, challenging your resolve and skill both, but eventually your attempts bear fruit, and you manage to get the entire head into your mouth. From there, the task grows far simpler, the shaft sliding deeper into your maw with a practiced ease. From there you begin to bob back and forth along her cock slowly, all to bring her to the height of pleasure.";
		say "     In the end, her climax comes far sooner than you expected, apparently accelerated by your endless teasing and foreplay. You've only been down her shaft for a few minutes when you feel the member harden further, and start to throb more. Mentally you brace yourself for the rising tide about to happen, and your foresight is rewarded as non a moment later, she hits her peak. The dick twitches powerfully, each jerk accompanied by a huge spurt of enchanted jizz directly down your throat. You close your eyes, to focus purely on the sensation of being filled like this, enjoying the taste of her release as it floods into you. Even when you can't see it, you can tell that her cock is visible in your throat, as well as each jet of cream, if only through sheer volume.";
		say "     Eventually her ecstasy comes to an end, and you pull backwards off of her softening shaft. Your throat is somewhat sore, your entire being seems suffused with her cum, and most importantly she's satisfied. The drake steps back from you, a slight wobble in her legs informing you of just how powerful that orgasm was for her, and pulls her dress back into it's regular position. 'Excellent work, familiar. You always know just how to please me. I have other business to attend to, but rest assured, I'll be seeing you again.' Her smile as she says this seems more affectionate than usual, but you don't have very long to appreciate it before she turns around and leaves. You smile to yourself, satisfied with what you've done for her, and looking forward to doing it again.";
		[grinding, teasing, fucks player with her staff and tail, cums on their face]

to say mdrake_bigger_better:
	if mdmaxlossscene is 0:
		say "     [if HP of Player > 0]Losing the will to stand up to the drake, you fall to your knees in a daze of conflicting feelings and desires. Looking quite giddy from your submission, your master approaches you. As she does so, you can't help but lean against her lower body, looking closely at that massive shaft while resting your head against her soft and supple thighs. 'I'm so happy to see you've come around, my dear familiar. You must understand by this point how much you enjoy this. I really ought to take you home... but not yet. You have a spark of resistance left in you,' she coos, reaching down to stroke the side of your face gently, causing a wonderful sensation to flush through your cheeks. 'Lay down for me, dear. I have a wondrous idea,' she commands. You perform her will without hesitation, exposing your humongous backside and tail to her.[else]Try as you might, the draconic mage is too strong for you. You fall backwards on your soft, massive rear as your stamina runs out. Tsking softly, the drake saunters over to you, looking down on you with a mix of disappointment and what appears to be excitement. You can't help but wonder if she gets a kick out your attempts at resistance. 'Now, my dear familiar, you keep trying to resist, but it isn't getting you anywhere. We go through this every time. I come seeking what is rightfully mine, you try feebly to fight back, then you realize how wrong you were and enjoy pleasing me. I'll never understand why you keep at it,' she ponders aloud, reaching you. The massive figure bends down and reaches a hand down to under your chin, stroking it and bringing forth a shudder of pleasure from you. Then, with a smooth and fluid motion, she flips you over onto your chest, exposing your gargantuan rear and tail, causing the drake to lick her lips in excitement.[end if]";
		say "     'Wonderful, that's a view I like to see!' she laughs happily, giving one of your cheeks a hearty slap, causing it to jiggle wildly. Your rear entrance reflexively twitches, expecting a prompt filling, but it doesn't come, not yet. 'Such a lovely posterior, a perfect piece of juicy fuck-meat fitting for my familiar. I can't help but wonder, though. One cannot have too much of a good thing...' the drake muses. As she finishes her sentence, you feel a tingling begin to originate from where she slapped you. Slowly, your behind begins to feel quite warmly and prickly. It isn't long before the warmth becomes incredibly arousing, causing your cheeks to blush and your legs to squirm. 'Yes, my familiar, enjoy my magic running through you. Writhe in pleasure as it flows through your rear, making it fit my whims!' she commands dramatically. Causing a stirring in your loins, your already huge ass starts to pillow outwards, increasing in girth and softness. Just when you thought it couldn't get any bigger, it seems the drake is intent on increasing your size even more! You gulp as, despite your enjoyment, deep down you can't help but worry if you'll be able to move if it gets too much bigger.";
		WaitLineBreak;
		say "     Flowing with warm magic, your posterior inflates outward with soft flesh and blubber. The weight you feel pressing down on your lower body grows heavier and heavier, as flesh pools beneath your tail and bloats more and more. Looking back, you estimate each cheek must be reaching twice their original size! Your master lowers herself down to grope at your expanding ass with a look of delight plastered on her face. 'Wonderful, absolutely wonderful. So soft and supple, each one like a balloon of jelly,' she coos, sounding quite pleased with herself. You moan in bliss as the warmth and weight of your behind grows so much you feel almost pinned by your own ass, soft flesh weighing you down immensely. And, with the increasing size of your cheeks comes a matching increase to the size of your rear hole. The soft ring puffs up, growing even more sensitive and pillowy by the second. Your tongue hangs out of your mouth as you moan with pleasure from the wonderful sensations, which is further stimulated by the drake reaching a hand between your massive cheeks to toy with your engorged pucker. Without hesitation your body thrashes around with lust as she dips her fingers into your hole, bringing a sly smile to her face.";
		say "     'Enjoying yourself? You should be, I figured this would be something quite enjoyable to the both of us... Bigger is always better to me, and I think this should help you come around,' the drake whispers in your ear, before pulling those fingers from your entrance. It isn't long before the drake's massive pillar of meat slaps down onto your back, resting on the crack between your hyper cheeks, throbbing and leaking pre onto your neck. Her massive cock twitches atop you as she slides it backwards, farther and farther until the head slips into your crack and finds its way to your rear entrance. The cock head throbs against your twitching pucker, smearing pre all over until she pushes in with great force. You yell out a moan of ecstasy as her meat slides into your depths, your massive ass stretching around her even bigger shaft. Every inch of her draconic dick slides along your expanded ass-flesh before entering your cavern of a tailhole, only to slide back out as she thrusts into you steadily. 'O-oh my, this is divine! I should have tried this much earlier!' she calls out, gripping your oversized cheeks and ramming into you with great speed.";
		WaitLineBreak;
		say "     With each thrust, her cock slides along your sensitive inner walls and lining it with her pre. You can feel the liquid pooling inside of you, the warmth of it spreading throughout your body as your body wobbles and jiggles. The drake's thrusts slowly grow more and more frantic, both of your pants occurring much more frequently as you both grow closer to orgasm. Every second she spends inside of your rear feels so, so right, and the way her digits dig into your incredibly massive rear, blubber spilling out between the fingers drives you wild. With one final thrust, she pushes all the way in, causing that incredible shaft to bulge against your stomach as she unleashes her hefty load inside of you. The drake calls out in bliss as her spunk sprays into you, and as if on cue, you orgasm as well, feeling total pleasure encompass your entire body. Your belly bloats outward with her semen, giving you a nice stomach full of your master's spunk. Soon, after the climax ends, her softening cock slowly slides out of your well-fucked hole, causing a trail of cum to pour out of you. You lie on the ground, panting and feeling quite sleepy as she stands up. 'That was amazing, my dear familiar. You've made me incredibly happy... I'll leave you here to enjoy yourself... and you know where to find me,' she giggles, before heading off. In a daze of bliss, you slowly doze off, only to wake up later back at your original size and surrounded by a pool of her cum, before you head off.";
		increase mdmaxlossscene by 1;
	else if mdmaxlossscene is 1:
		say "     [if HP of Player > 0]The lure of your master proves too strong for you as you submit, expressing your surrender to the magic drake. Seeing your submission, she ceases her attacks and takes on a more casual stance. 'Good, good. Come to your senses, have you?' she coos. The drake saunters over to you as you gather your composure, recovering quickly from the brief spat. 'It pleases me to know you've accepted me for now... It's such a pity that you insist on wandering off... but that only makes it much more pleasing when you come to me, my familiar,' she sighs, reaching you. The drake runs a claw down the side of your face, inciting a pleasant shudder to creep down your spine[else]You stumble backwards, panting as your stamina runs out. Try as you might, you simply lack the further strength to fight back. Noticing your inability to continue fighting, the drake smirks proudly and approaches you. 'Naughty thing, thinking you can beat me? Such a feisty familiar... It's almost cute to watch you try to fight, but we both know who's more powerful,' the drake taunts, reaching you. She strokes your face, sending tingles down your body as you can feel traces of her magic coursing through you. You find your fatigue fading away, but in its place grows a powerful lust. It's clear to you that she's trying to bring you to submitting to her, even after your defeat[end if]. 'Now that that farce of a fight is over, my dear butt-slut, what shall I do with you? I feel... inspired. Simple sex won't do it for me!' she teases, groping your soft rear and causing a moan to escape your lips. You find your tail lifting naturally, granting your master access to your large, soft hole. The drake's hand makes its way from your cheek to your rear entrance, arm stuck between those massive and soft cheeks. Her soft, clawed digits slide into your moist and sensitive passageway, causing you to jolt forward slightly. 'Such a wonderful hole, so soft and inviting,' she compliments, fingers squirming within you as she slowly inserts her entire hand inside.";
		say "     Teasing your insides, alternating between fisting you and tickling your entrance, the drake relishes in your lustful squirming. 'What a good slut, you enjoy that don't you? Don't you love the gifts I've given you?' she says playfully, giving your interior one last caress before pulling her hand out with a soft pop. Your stretched hole gapes and twitches as your master takes a small step back. 'I have an idea I think you'll love...' the massive drake ponders, taking out a strange looking object. She throws it on the ground and, in a puff of smoke, appears a strange yet familiar creature. A small reptilian creature, shining bright like rubber, and with a massive pair of testicles- a koballoon. He looks around, confused and dazed. The drake grabs the koballoon, causing him to squirm in defiance, but a smack on the head from his captor calms him down. Carrying him, she gets close up to you again. 'Lay down for me,' she commands. You comply, not really in a position to refuse, but also curious and excited for what she has in store for you. Lowering yourself down on your knees first, you proceed to lie down on your front. The magic drake looks excited and pleased as she brings the koballoon over to you, the rubber reptile's gargantuan balls swaying with each step she takes. 'These beasts may be a failed creation, but... I think they might have their uses still,' your master giggles. You turn back to watch what she does, and you see quite the sight.";
		WaitLineBreak;
		say "     She chants under her breath, waving her staff, and suddenly some significant changes occur to the koballoon's nether regions. It seems like the drake has used her magic to supercharge the critter's endowment, making it something large enough to match your own oversized ass. The koballoon is just as enthused by the upgrade as you are, and when she releases her hold on him he immediately lunges forward at you. The tip bounces off your incredible cheeks several times before he corrects his aim, causing intense shockwaves across them, until he finally manages to shove it into your waiting hole. You can't stop yourself from letting out moan after moan, vocalizing the incredible pleasure you're feeling. As the rubber reptile is thrusting intensely, the drake looks even more pleased. 'I see you're enjoying my next plan for improving that marvelous behind of yours,' she coos. 'I'm going to have him pump you full of raw magic, and we'll see how that works, hmm?'";
		say "     True to her word, you can feel that when the koballoon starts to empty it's incredible balls into you, there's more than just jizz. Something is different about it, and you can feel that something flowing into your monumental rear, slowly inflating it further and further. Before you match up to the last time the drake oversized you, though, the sensation stops. You look to try and find out why it ended, but you can't see clearly over the obscuring curve of your ass. The expression on her face, however, is somewhat less pleased. 'Well, I guess that job was a bit much for one koballoon. I suppose we just have to try harder then.' She gestures with her staff, and you can feel what you're almost certain is the entire koballoon being forced into your gaping hole. In a mere moment it seems to shrink down until you feel empty again, and at the same time your cheeks grow yet larger, as if you somehow absorbed it. 'Oh, yes, that did the trick. That means it's time to add a few more to the mix.'";
		WaitLineBreak;
		say "     As you lay there, restrained by the incredible weight of your rear, the drake conjures up several more koballoons. Within moments, she works her magic once more, augmenting these newest additions to the fun the same way as she did the previous. Their newly-boosted endowments are incredible, and you shiver in anticipation, already eagerly waiting for them to pound you silly, stuffing you fuller and fuller. After what feels like far too much time, she releases them, and they immediately rush to you, shoving each other, each trying to be the first to slam their new cocks into your inviting ass. Finally, one manages to claim the position first, and begins the process of fucking you deeply. The remaining koballoons watch closely, enraptured by the sight, and attempt to stroke their new members, though to little success. All of that, however, is secondary to the sensation of your incredibly inflated rear, jiggling with each slap of the koballoon's balls against your cheeks, and the feeling of it growing even further all the while as he continues to pump you full of his magical liquid.";
		say "     Once he finishes releasing his entire load into you, magnified by the drake's magic, he meets the same fate as his predecessor, drained dry just to keep improving your monumental behind. For a moment, you wait there to be filled again, as the two remaining koballoons watch on. After that pause, however, they charge in, their desire to fuck you clearly overriding any self-preservation. This time, they don't even bother to fight over you, instead both trying their hardest to be the first to penetrate your passage. When one finally thrusts home, the other is still not discouraged, continuing to probe at your entrance, even as it's being pounded by the first one. Finally he succeeds, and you start gasping, barely able to comprehend the pleasure of being filled by two of those titanic members at once. The only thing keeping you from disappearing completely is the knowledge that it's all for the sake of your mistress.";
		WaitLineBreak;
		say "     The pair continue to pump in and out, sometimes managing to thrust in sync, causing even larger shockwaves across the flesh of your ass. Even when they lose rythm and start slamming out of you erattically, you're still overwhelmed by the constant slapping of their massively oversized balls against your equally huge behind. You close your eyes, and lose yourself to the incessant pounding, and the constant rising sensation of being fucked so deeply, and by so much cock. Eventually, however, it starts to come to an end, with the two koballoons both hilting themselves in you, and pumping every ounce of liquid pleasure they hold deep inside you. Even as they shoot everything they have left, simply becoming more mass for your rear, you can't bring yourself to do anything other than enjoy it.";
		say "     As the last two one finish, having unleashed their enchanted loads fully and left themselves nothing more than empty shells, the drake forces them inside, inflating your cheeks even more. With that, all the rubber creatures are gone, just another part of your immense cushion, leaving you alone with the drake once again. 'Oh, that worked almost perfectly! You're absolutely magnificent like this, even better than before.' She pauses, and caresses your soft, jiggling flesh, causing you to moan uncontrollably. 'I think I'll let you stay like this for a while, and we'll see how well it keeps. If you don't stay so deliciously oversized, then we'll just have to try again, and that's almost as much fun as seeing you like this.'";
		say "     Still in a daze of pleasure, you barely notice your mistress leaving. You stay there, sitting in the street immobilized by your own ass, for quite some time. Eventually, however, it begins to deflate, returning to your relatively normal size, leaving you somewhat... disappointed. Despite that, however, you know that your mistress will do her best to make you bigger and better than ever before, and you find yourself eager to see what else she may have in store for you. After several more moments of daydreaming about what else she might do to your soft behind, you finally climb back to your feet, with a normal jiggle from your merely-huge ass, and begin to leave.";
		increase mdmaxlossscene by 1;
	else if mdmaxlossscene is 2:
		say "     [if HP of Player > 0]Overcome by your lusts for your mistress, you surrender. As the sight of your submission, she steps forward, no longer planning on attacking you. 'Good, good. I'm glad you've decided to come back for more,' she coos. The drake saunters over to you as you gather your composure, recovering quickly from the brief spat. 'Don't worry, my familiar, I'm going to treat you so wonderfully that you'll never want to leave.' The drake runs a claw down the side of your face, inciting a pleasant shudder to creep down your spine.[else]You stumble backwards, completely beaten, unable to resist further even if you wanted to. Seeing the difference, the drake looks pleased with herself.. 'Naughty thing, thinking you can beat me? Such a feisty familiar... It's almost cute to watch you try to fight, but soon enough you'll know better,' the drake taunts, reaching you. She strokes your face, sending tingles down your body as you can feel traces of her magic coursing through you. You find your fatigue fading away, but in its place grows a powerful lust. It's clear to you that she's trying to make you submit to her, even after your defeat.[end if] 'Now, I suppose it's time to play with you again, my dear. Since your last visit I've come up with several wonderful ideas for how best to improve you.'";
		say "     For a moment you are simply waiting on your knees for your mistress to decide what to do with you, shivering in anticipation of what new heights of pleasure she could bring you to. The drake lets you simmer for a time, pacing around you, carefully eyeing every detail of your form. 'I'm glad that you've taken to my gifts so well, familiar. Now, follow me, my next plan requires somewhat more setup than before.' Without another word, she turns around and begins walking further into the Red Light District. Unwilling to disobey, you follow her, keeping to your hands and knees as you do so. The drake's occasional glances over her shoulder at you are marked by a smug grin, showing that she appreciates your method of transport.";
		WaitLineBreak;
		say "     Finally your mistress leads you into a small square, featuring what seems to be a set of old fashioned stocks. You're sure you've never seen them before, but your attempts to ponder their origins are interrupted by the magic drake guiding you towards them. You instantly realize what she has in store, as there could be no reason to bring you to these stockades other to then lock you in them. A moment later you're proven correct, as she waves her staff, causing one of the pillories to open. She gestures towards it with her free hand. 'Go on, familiar. You're going to have a wonderful time here, believe me,' she coos. The thought of being locked up in that contraption is a somewhat terrifying one, but at the same time you know that following the orders of your mistress has never lead you astray. You muster what little courage you have left, and climb up onto the raised dais, before finally settling yourself into position. The drake lets out a breathy laugh as she lowers the top back into place, locking you firmly into the wooden structure. 'Oh, what fun this is going to be for the both of us!'";
		say "     In no time at all, the drake places herself right behind you, caressing your large butt gently, sending tingles of pleasure through your body, before she jars you out of your reverie with a mighty slap. You gasp, cheeks jiggling from the force, and the drake goes back to less forceful attentions, kneading your rear between her hands, with all the skill of a masseuse. As she works, you begin to feel a tingling sensation everywhere her hands touch, a sensation that begins to slowly radiate outward, and you begin to recognize it. At this point, the feeling of your already large ass beginning to inflate into an even more incredible size is one you are intimately familiar with. You hear a moaning sound, getting louder and louder, and realize that it's coming from you, an undeniable expression of how much you enjoy everything the drake does to you. All you can do is savor the pleasure, and hope for her to fill you, mold you, and make you better than ever.";
		WaitLineBreak;
		say "     After your behind is boosted to a better size, if sadly not up to the highest heights it has reached before, the drake pulls her hands away from you. Instead, she replaces them with her large endowment, beginning to slide her shaft up and down space between your huge globes. Unconsciously, you start trying to push back into her, to force her member into your hole and satisfy the intense need you have for her, but the contraption holding your head and arms keeps you firmly in place, and at her mercy. The teasing continues for several minutes, building your frustration and need all the while, until finally she has pity on you, and sets the tip of her cock directly against your pucker. 'I know you want my cock, and my magic, and the biggest ass I can possibly give you. But before I do that, I want you to beg, my slutty little familiar.' Even though you can't turn your neck to look at the drake, you can tell she's grinning mockingly at you, but all that knowledge does is make you even more aroused and pliant to her whims. There was never any question about what you would do, and so you beg like your life depends on it.";
		say "     Your constant pleading is interrupted in a split second when your mistress finally thrusts forward, driving her huge member into your rear, filling you completely with her fat shaft, and stretching you open just enough to take the edge of your need for her. In no time at all, the drake is pounding in and out, sending shockwaves rippling across your ass, even as it continues to grow. At the same time, the force of the thrusts puts pressure on your upper body, as you're pushed up against the stocks, the discomfort transforming into greater pleasure with the thought that you're completely under her control. None of the notions running through your mind in this moment matter in the face of the experience that is being railed by the magic drake.";
		WaitLineBreak;
		say "     The constant fucking you receive at the hands of your mistress is a never-ending flow of ecstasy throughout your body. However, despite the flood of pleasure, you seem unable to truly experience that ultimate climax yourself, only building up a reserve of tightly corked lusts. For a time, all you can focus on is the thrusting, in and out, in and out, an almost hypnotic rhythm. When the drake finally thrusts in with more force than before, and begins unleashing her enchanted load, you're shocked from your reverie, and realize that now you're surrounded by an entire crowd of koballoons, laughing at your predicament. The drake steps away from you before letting out a haughty laugh of her own. 'Oh, what fun, I didn't even have to call them this time! I suppose you're just such a slut that you'll always attract dicks to fill you up, hmm?' She looks out at the rubber critters, none of them willing to make the first move with the Drake right in front of them. A moment passes in a tense silence before she gestures to your hole, still dripping her cum, and speaks. 'Well, what are you all waiting for?'";
		say "     Like floodgates opening, the koballoons waste no time in advancing, soon piling up upon you, all around, leaving you pressed upon by shafts, balls, and mouths at every angle. Still bound in the pillory, your only option is to endure the barrage of sexual activity, and just as you resolve to do so, the onslaught increases in intensity. This renders you unable to resist, instead cranking your pleasure centers up another notch, to a level you didn't realize even existed. Accompanying this realization is a matching one, as you become aware exactly what is preventing you from peaking in response to all this pleasure. Your butt has grown once more, rapidly approaching the levels the drake pumped it to in your previous encounter, and you know, somehow, that she's bottling up all your lust and pleasure in order to do so. That knowledge itself causes you to almost, but not, orgasm, instead merely moaning around the koballoon cock in your maw.";
		say "     To any outside observer you would seem to be nothing more than a vessel to hold all the cocks and cum being forced into you, if perhaps a vessel with an ass beyond compare. The drake herself seems to be quite happy with that notion, steadily stroking her shaft as she watches you pounded and prodded from all sides, all while trapped in your pillory. Her hands, as they run up and down her endowment, seem to be doing something similar to what she has wrought on your ass, increasing her member's size with each stroke, rapidly causing it to be a tool of incredible power. You would already be begging for it if you had any way to speak, and instead all you're able to do is tighten your holes around the myriad dicks you're busy servicing, in hopes of making them climax sooner, all in order for your mistress to take her rightful place railing you again, bigger and better than ever.";
		WaitLineBreak;
		say "     Eventually, you are left amidst a sea of half-deflated kobaloons, spunk trailing from your holes and across your skin, and a mountainous ass keeping you from budging even more securely than the stocks. The drake, your perfect match, stands alone, sporting a colossal cock, something sizeable enough to satisfy even your incredibly fat behind. 'Well, familiar, you've certainly taken well to my latest treatments, hmm? This has been such a success that I'm absolutely certain it will be my last experiment. But before I tell you the rest of that, I think we should enjoy the fruits of my labors. Well, you don't have much choice in the matter, anyway, so best brace yourself.' You are almost delirious with lust, but that still isn't enough to keep you from heeding the words of your mistress, even if you can't begin to fathom what fresh sensations this will bring. You eagerly brace yourself, unsure what part of the next event you're more excited about.";
		say "     The magic drake gives you no further time to worry yourself over the future, instead consigning you to the one true duty of a familiar: service. In this case, she does so by bringing her magnificent cock tip directly against your almost-gaping entrance, and driving it home. You have no time to comprehend the drake's lack of her usual foreplay, or how she must be almost as pent up as you, or how incredibly her release may be when she finishes inside you. The only thing you can comprehend is the enormity of her shaft as she impales you deeply on her pole. Her thrusting starts immediately, sawing in and out with incredible ferocity, the power causing your titanic cheeks to collide with her flesh, releasing a constant barrage of loud slapping sounds, while also sending an equally constant series of shockwaves across your entire body.";
		WaitLineBreak;
		say "     The impact occurring between the two of you is just as magnificent as your respective enhanced attributes, the powerful pleasures incited by the acts, causing yet further lust to build up. This in turn causes your ass and her cock to grow yet further, a cycle that you have no power in, exactly as it should be. However, as your truly monumental fucking continues onward, you realize that even the drake's incredible magical endurance has its limits. The part of her spell that keeps the pair of you from truly climaxing begins to unravel, and her wild rutting into you rapidly turns into something akin to a jackhammer, pounding with a speed and fervor you have rarely seen in anything. At last, the spell comes undone, and she releases the flood of liquid lust she had contained within, dumping a truly biblical quantity of magical jizz into your posterior. You can feel everything she had flowing into you through your tailhole, locked tightly around her shaft, and filling you with that unbelievable torrent. Your ass inflates with one last hurrah, reaching a size you can scarcely comprehend for a brief moment, before your own climax hits and you come crashing back down.";
		say "     The ecstasy coursing through your body is so great that what follows is a mere blur, your next clear thought afterwards is of you returned to your normal proportions, still locked tightly in the stocks, and soaked completely by the drake's essence. The drake herself seems clean, likely done through her own magic, though even she still seems slightly out of sorts. Nonetheless, she steps around the stocks, and leans in next to your ear. 'I do believe I've cracked the code, dear familiar. I know you love this as much as I do, so next time we meet, we'll make our arrangement rather more official, hmm? I do so look forward to your next, and final, visit.' With that, she unlatches the restraints on you, before she quickly strides away, leaving you to compose yourself. Eventually you manage to do so, climbing somewhat unsteadily to your feet, ready to return to the city. But you can't help but wonder what would happen instead of exploring further, you took her up on her offer...";
		increase mdmaxlossscene by 1;
	else if mdmaxlossscene is 3:
		say "[mdrake_bad_end]";


[scenes:
player hugs cock, cum in face
x-cum guzzling-x
oral
grinding
staff in butt + oral
tail fuck?
reach around, player made to cum on self
fucked and filled
p-victory possibilities:
- ride drake (if maxed out or Twisted Capacity)
- fuck drake
- force oral
	- male, suck cock eagerly
	- female, 'disappointingly mundane' but still does it
- made to suck self?
- use staff's dildo end on drake
- taunt w/maxed out booty denied her
- fuck her cock
]

to say beatthemagicdrake:
	choose row MonsterID from the Table of Random Critters;
	if mdrakebeaten is 0:
		say "     The dragoness hisses in frustration and waves her staff in a wide arc. A wall of colorful energy ripples between you both, allowing her the opportunity to make her escape. 'Oh, don't think that this will be the last of it. I shall have you as mine. A strong familiar is an even better one, once it's been properly [']broken in['],' she laughs before leaving.";
	else:
		say "     The dragoness hisses in frustration as you beat her again. As she raises her staff to form a barrier again so she might escape, you rush forward and knock it out of her hands. Your momentum has you barrel into her and thus body check her to the ground. Too weakened and bottom-heavy, she struggles to rise. With her disarmed and unable to get away, a part of you considers taking advantage of the situation and the buxom dragoness.";
		now sextablerun is 0;
		blank out the whole of table of fucking options;
		if Player is male:
			choose a blank row in table of fucking options;
			now title entry is "Fuck the dragoness";
			now sortorder entry is 1;
			now description entry is "pound that big bottom of hers";
			choose a blank row in table of fucking options;
			now title entry is "Titty-fuck";
			now sortorder entry is 2;
			now description entry is "wedge your meat between those plump melons";
			choose a blank row in table of fucking options;
			now title entry is "Receive fellatio";
			now sortorder entry is 6;
			now description entry is "get her to suck you off";
			if Cock Length of Player <= 18:
				choose a blank row in table of fucking options;
				now title entry is "Cock-fuck";
				now sortorder entry is 3;
				now description entry is "stuff your manhood down her cum slit";
[		if Player is female:
			choose a blank row in table of fucking options;
			now title entry is "Receive cunnilingus";
			now sortorder entry is 7;
			now description entry is "get her to eat you out";]
		if Player is female and ( Cunt Depth of Player > 30 or Cunt Tightness of Player > 18 ):
			choose a blank row in table of fucking options;
			now title entry is "Ride that cock - Vaginal";
			now sortorder entry is 4;
			now description entry is "stuff that meaty rocket of hers in your cunt";
		if ( mdasslevel is 6 and TailName of Player is "Magic Drake" ) or the player is twistcapped:
			choose a blank row in table of fucking options;
			now title entry is "Ride that cock - Anal";
			now sortorder entry is 5;
			now description entry is "stuff that meaty rocket of hers up your ass";
		choose a blank row in table of fucking options;
		now title entry is "Force self-oral";
		now sortorder entry is 8;
		now description entry is "make her suck herself";
		if mdasslevel is 6 and TailName of Player is "Magic Drake":
			choose a blank row in table of fucking options;
			now title entry is "Taunt her";
			now sortorder entry is 9;
			now description entry is "tease her with that big booty of yours";
		sort the table of fucking options in sortorder order;
		repeat with y running from 1 to number of filled rows in table of fucking options:
			choose row y from the table of fucking options;
			say "[link][y] - [title entry][as][y][end link][line break]";
		say "[link]0 - Leave her be[as]0[end link][line break]";
		while sextablerun is 0:
			say "Pick the corresponding number> ";
			get a number;
			if calcnumber > 0 and calcnumber <= the number of filled rows in table of fucking options:
				now current menu selection is calcnumber;
				choose row calcnumber in table of fucking options;
				say "[title entry]: [description entry]?";
				if Player consents:
					let nam be title entry;
					now sextablerun is 1;
					if nam is "Fuck the dragoness":
						say "[mdrake_pvictory_01]";
					else if nam is "Titty-fuck":
						say "[mdrake_pvictory_02]";
					else if nam is "Cock-fuck":
						say "[mdrake_pvictory_03]";
					else if nam is "Ride that cock - Vaginal":
						say "[mdrake_pvictory_04]";
					else if nam is "Ride that cock - Anal":
						say "[mdrake_pvictory_05]";
					else if nam is "Receive fellatio":
						say "[mdrake_pvictory_06]";
					else if nam is "Receive cunnilingus":
						say "[mdrake_pvictory_07]";
					else if nam is "Force self-oral":
						say "[mdrake_pvictory_08]";
					else if nam is "Taunt her":
						say "[mdrake_pvictory_09]";
			else if calcnumber is 0:
				say "     Resisting the [if Libido of Player > 0]strong [end if]temptation to play with the helpless dragoness, you instead take a few steps back and collect yourself.";
				now sextablerun is 1;
			else:
				say "Invalid Option. Pick between 0 and [the number of filled rows in the table of fucking options].";
		wait for any key;
		LineBreak;
		if mdasslevel > 1:
			now sextablerun is 0;
			blank out the whole of table of fucking options;
			if TailName of Player is "Magic Drake":
				say "     Before you depart, you look over the drake's strange staff. The headpiece is still aglow with eldritch energy that's leaking from its phallic end. You might be able to use to adjust the size of that [if mdasslevel is 2]bubble-butt[else if mdasslevel is 3]plump[else if mdasslevel is 4]large[else if mdasslevel is 5]huge[else]mega-booty[end if] ass she's given you";
				if mdasslevel < 6:
					choose a blank row in table of fucking options;
					now title entry is "Increase size";
					now sortorder entry is 1;
					now description entry is "Try using the magic staff to round out your ass further";
				else if mdasslevel is 6:
					choose a blank row in table of fucking options;
					now title entry is "One step beyond";
					now sortorder entry is 1;
					now description entry is "See if you can get your ass even bigger still";
				if mdasslevel > 2:
					choose a blank row in table of fucking options;
					now title entry is "Decrease size";
					now sortorder entry is 2;
					now description entry is "Try using the magic staff to reduce your ass";
			else:
				say "     Before you depart, you look over the drake's strange staff. The headpiece is still aglow with eldritch energy that's leaking from its phallic end. You feel an odd urge to use it to restore that [if mdasslevel is 2]bubble-butt[else if mdasslevel is 3]plump[else if mdasslevel is 4]large[else if mdasslevel is 5]huge[else]mega-booty[end if] ass she'd given you";
				choose a blank row in table of fucking options;
				now title entry is "Restore it";
				now sortorder entry is 3;
				now description entry is "Try using the magic staff to get your draconic butt back";
			if Player is male:
				say ". Alternatively, you might also try using it to alter your manhood";
			say ".";
[			say ". Alternatively, you might also try using it to alter your groin or your breasts."; [*** - once cunt/breasts added]	]
			if Player is male:
				choose a blank row in table of fucking options;
				now title entry is "Cock growth";
				now sortorder entry is 4;
				now description entry is "Attempt some magical male enhancement";
				choose a blank row in table of fucking options;
				now title entry is "Ball growth";
				now sortorder entry is 6;
				now description entry is "Try plumping up those balls of yours";
				if Cock Length of Player > 1:
					choose a blank row in table of fucking options;
					now title entry is "Cock reduction";
					now sortorder entry is 5;
					now description entry is "Attempt to shrink [if Cock Count of Player > 1]those [cock size desc of Player] cocks[else]that [cock size desc of Player] cock[end if] of yours down a little";
				if Ball Size of Player > 1:
					choose a blank row in table of fucking options;
					now title entry is "Ball reduction";
					now sortorder entry is 7;
					now description entry is "Attempt to shrink your [Ball Size Adjective of Player] [Balls] down a bit";
[			if Player is female:
				choose a blank row in table of fucking options;
				now title entry is "Cunt growth";
				now sortorder entry is 8;
				now description entry is "try making your cunt be able to take more";
				if Cunt Depth of Player > 1 or Cunt Tightness of Player > 1:
					choose a blank row in table of fucking options;
					now title entry is "Cunt reduction";
					now sortorder entry is 9;
					now description entry is "attempt to shrink your[if Cock Count of Player > 1][cunt size desc of Player] cunts[else][cunt size desc of Player] cunt[end if] down a little";
			if Nipple Count of Player > 0:
				choose a blank row in table of fucking options;
				now title entry is "Breast expansion";
				now sortorder entry is 10;
				now description entry is "try to give yourself bigger melons";
				if Breast Size of Player > 0:
					choose a blank row in table of fucking options;
					now title entry is "Breast reduction";
					now sortorder entry is 11;
					now description entry is "attempt to shrink those [short breast size desc of Player] tits of yours";]
			sort the table of fucking options in sortorder order;
			repeat with y running from 1 to number of filled rows in table of fucking options:
				choose row y from the table of fucking options;
				say "[link][y] - [title entry][as][y][end link][line break]";
			say "[link]0 - Leave it alone[as]0[end link][line break]";
			while sextablerun is 0:
				say "Pick the corresponding number> ";
				get a number;
				if calcnumber > 0 and calcnumber <= the number of filled rows in table of fucking options:
					now current menu selection is calcnumber;
					choose row calcnumber in table of fucking options;
					say "[title entry]: [description entry]?";
					if Player consents:
						let nam be title entry;
						let mdstaffaction be 0;
						now sextablerun is 1;
						if nam is "Increase size":
							now mdstaffaction is 1;
						else if nam is "Decrease size":
							now mdstaffaction is 2;
						else if nam is "Restore it":
							now mdstaffaction is 3;
						else if nam is "One step beyond":
							now mdstaffaction is 4;
						else if nam is "Cock growth":
							now mdstaffaction is 5;
						else if nam is "Cock reduction":
							now mdstaffaction is 6;
						else if nam is "Ball growth":
							now mdstaffaction is 7;
						else if nam is "Ball reduction":
							now mdstaffaction is 8;
						else if nam is "Cunt growth":
							now mdstaffaction is 9;
						else if nam is "Cunt reduction":
							now mdstaffaction is 10;
						else if nam is "Breast expansion":
							now mdstaffaction is 11;
						else if nam is "Breast reduction":
							now mdstaffaction is 12;
						if mdstaffaction < 4:
							say "     Taking the dragoness's staff in hand, you try to bend its charged power to your will. Pointing it at your rear, you make several attempts to get it to work for you. You try magical words and phrases, various gestures, stroking its cock-like headpiece and even banging it on the ground in a bout of frustration. It eventually ends up firing off a sticky blast of sparkling energy without warning when you ";
						else:
							say "     Taking the dragoness's staff in hand, you try to bend its charged power to your will. Pointing it at your [if mdstaffaction is 5 or mdstaffaction is 6]cock[else if mdstaffaction is 7 or mdstaffaction is 8]balls[else if mdstaffaction is 9 or mdstaffaction is 10]cunt[else if mdstaffaction is 11 or mdstaffaction is 12]chest[end if], you make several attempts to get it to work for you. You try magical words and phrases, various gestures, stroking its cock-like headpiece and even banging it on the ground in a bout of frustration. It eventually ends up firing off a sticky blast of sparkling energy without warning when you ";
						let x be a random number between 1 and 5;
						if mdstaffaction is 9 or mdstaffaction is 10:
							let x be a random number between 1 and 6;
						if mdstaffface is true and x is 1:
							now x is a random number between 2 and 5;
						if x is 1:
							say "lick the tip of the golden phallus, taking the blast in the face instead";
							if FaceName of Player is "Magic Drake":
								say ". The tingly energy floods your senses and dazes you, leaving you somewhat disoriented";
								decrease humanity of Player by a random number between 4 and 6;
								if "Strong Psyche" is listed in feats of Player, increase humanity of Player by a random number between 0 and 2;
								if "Weak Psyche" is listed in feats of Player, decrease humanity of Player by a random number between 0 and 2;
							else:
								say ". The tingly energy floods your senses and flows into you, causing your head to transform. You can feel your cranium pulse and throb, building up until there comes a loud snap. More pops and snaps follow as your head shifts and reshapes itself. A draconic muzzle pushes forth and a pair of small horns grow on the top of your head";
								choose row MonsterID from the Table of Random Critters;
								now FaceName of Player is "Magic Drake";
								now FaceSpeciesName of Player is "Magic Drake";
								now Face of Player is face entry;
							say ". The dragoness laughs at your feeble attempt to use her magic.";
							now mdstaffface is true;
						else:
							if x is 2:
								say "try saying '[one of]Open sesame[or]A-la-peanut-butter-sandwiches[or]Abracadabra[or]Alakazam[in random order]' for the [one of]third[or]fourth[or]second[or]fifth[as decreasingly likely outcomes] time";
							else if x is 3:
								say "spank your bottom with it a few times";
							else if x is 4:
								say "flail it around wildly, initially spewing magic into the air";
							else if x is 5:
								say "stroke it vigorously";
							else if x is 6:
								say "shoving its phallic headpiece right into your hot cunny. This blasts the thick, tingly magic right into your clenching tunnel in a rush of sexual pleasure that never quite fades";
								increase Libido of Player by 10;
							if mdstaffaction is odd:
								say ". The dragoness laughs at your confused attempt. 'And that is why you're meant to be a familiar and nothing more,' she teases.";
							else if mdstaffaction is 4:
								say ". The dragoness laughs at your confused attempt. 'Oh, you've done it now, my foolish familiar,' she chuckles, still fighting to right herself.";
							else:
								say ". The dragoness is quite upset by your actions. 'You're being a very -ngg- naughty familiar. I'll definitely need to -grunt- punish you severely -oof- as soon as I can get up,' she growls in frustration as she fails to rise and stop you.";
							if mdstaffaction <= 4:		[ass adjustments]
								say "     The magic does end up working though, seeping into you with a pleasant tingle that suffuses your rear. ";
								if mdstaffaction is 1:
									increase mdasslevel by 1;
									say "This causes it to swell and inflate, rounding out further until it becomes [if mdasslevel is 3]sexily plump[else if mdasslevel is 4]quite large[else if mdasslevel is 5]rather huge[else]titanically huge[end if]. Despite being upset with you for using her magic yourself, the sorceress certainly seems pleased with the outcome, at least.";
								else if mdstaffaction is 2:
									decrease mdasslevel by 1;
									say "This comes with a drop in pressure on your hips as your bottom shrinks down. The angry dragoness growls impotently as it loses several inches in size, dropping down to a [if mdasslevel is 2]cute bubble-butt[else if mdasslevel is 3]plump rear[else if mdasslevel is 4]large ass[else]huge bottom[end if] that feels a little more manageable for you to deal with.";
								else if mdstaffaction is 3:
									say "This power makes your ass quiver and your spine throb. Within a few minutes, the reptilian ass and tail you had before have returned, [if mdasslevel is 2]round[else if mdasslevel is 3]plump[else if mdasslevel is 4]large[else if mdasslevel is 5]huge[else]enormous[end if] and beautiful to the whistling dragoness.";
									now Tail of Player is "[mdtaildesc].";
								else:
									say "[mdstaff_overgrown]";
							else if mdstaffaction <= 10:		[sexual growth/reduction]
								if CockName of Player is not "Magic Drake":
									say "     The magic doesn't quite end up working as expected though, spraying all across your groin. It seeps into your crotch with a pleasant tingle that suffuses your [if Player is herm]cock[smn] and cunt[sfn][else if Player is male]cock[smn][else]cunt[sfn][end if]. The magical energy clings to your sensitive loins and sinks right into them, causing them to shift and change[if Player is herm]. The flesh of your loins changes and your manhood and your pussy lips are transformed[else if Player is male]. The flesh of your loins changes and your manhood is transformed[else]. The flesh of your loins changes and your pussy lips are transformed[end if], taking on a rich, green hue as you become infected, much to the dragoness's amused delight.";
									choose row MonsterID from the Table of Random Critters;
									now CockName of Player is "Magic Drake";
									now CockSpeciesName of Player is "Magic Drake";
									now Cock of Player is cock entry;
									increase Libido of Player by 5;
								else if mdstaffaction is 5:		[cock growth]
									increase Cock Length of Player by 2;
									follow the cock descr rule;
									increase Libido of Player by 5;
									say "     The magic does end up working though, seeping into you with a pleasant tingle that suffuses your green cock. This causes it to swell and grow a little larger, lengthening until it becomes a [cock size desc of Player] [Cock Length of Player]-incher. You try to keep going, but the pleasure of this sends you over the edge, moaning loudly. The remaining magical energy gets funneled into your climax and you splatter a larger-than-normal mess of fresh seed onto the ground. Despite being upset with you for using her magic yourself, the sorceress certainly seems pleased with the outcome, at least.";
								else if mdstaffaction is 6:		[cock reduction]
									decrease Cock Length of Player by 2;
									if Cock Length of Player < 1, now Cock Length of Player is 1;
									follow the cock descr rule;
									decrease Libido of Player by 3;
									say "     The magic does end up working though, seeping into you with a pleasant tingle that suffuses your green cock[smn]. This causes [itthemm] to shrink down, losing [if Cock Length of Player > 2]a couple of inches[else]an inch[end if]. You try to keep going, but the pleasure of this sends you over the edge, moaning loudly. The remaining magical energy gets funneled into your climax and you splatter a larger-than-normal mess of fresh seed onto the ground[if Cock Length of Player is 1]. As your tiny prick[smn] didn't go away completely, you doubt you'll be able to shrink yourself down any further this way[end if]. The angry dragoness growls impotently as your sexy penis[esmn] shrink[smv], leaving [itthemm] feeling a little more manageable for you to deal with.";
								else if mdstaffaction is 7:		[ball growth]
									BallsGrow Player by 1;
									follow the cock descr rule;
									increase Libido of Player by 5;
									say "     The magic does end up working though, seeping into you with a pleasant tingle that suffuses your transformed testicles. They swell up a little larger, growing until they become a [Ball Size Adjective of Player] pair of draconic balls. You try to keep going, but the pleasure of this sends you over the edge, moaning loudly. The remaining magical energy gets funneled into your climax and you splatter a considerably larger-than-normal mess of fresh seed onto the ground. Despite being upset with you for using her magic yourself, the sorceress certainly seems pleased with the outcome, at least.";
								else if mdstaffaction is 8:		[ball reduction]
									BallsShrink Player by 1;
									if Ball Size of Player < 1, now Ball Size of Player is 1;
									follow the cock descr rule;
									decrease Libido of Player by 3;
									say "     The magic does end up working though, seeping into you with a pleasant tingle that suffuses your transformed testicles. This causes them to shrink down in your scaled scrotum. You try to keep going, but between the compression on the load already in them and the pleasure of the change itself, you're sent over the edge, moaning loudly. The remaining magical energy gets funneled into your climax and you splatter a much larger-than-normal mess of fresh seed onto the ground[if Ball Size of Player is 1]. As your tiny balls didn't go away completely, you doubt you'll be able to shrink them down any further this way[end if]. The angry dragoness growls impotently as your juicy nuts shrinks, leaving you with a set that feels a little more manageable for you to deal with.";
								else if mdstaffaction is 9:		[cunt growth]
									say "***";
								else if mdstaffaction is 10:		[cunt reduction]
									say "***";
							else:
								say "***breast growth/reduction here.";
						if Libido of Player < 0, now Libido of Player is 0;
						if Libido of Player > 100, now Libido of Player is 100;
						if mdstaffaction is not 4 and x is not 1:
							say "     Now done, for better or for ill, you drop the spent staff and leave the grounded and bottom-heavy dragoness struggling to roll herself over so she can get up.";
				else if calcnumber is 0:
					say "     Resisting the temptation to meddle with it, you leave the strange artifact alone.";
					now sextablerun is 1;
				else:
					say "Invalid Option. Pick between 0 and [the number of filled rows in the table of fucking options].";
	increase mdrakebeaten by 1;

to say mdrake_pvictory_01:		[Fuck her]
	say "     Deciding that the sorceress deserves to be on the receiving end of what she planned for you, you stride over to her and, as she struggles to push herself over so she can get back up, you give her a firm shove. This sudden added momentum rolls her rounded bottom over, exposing that super-wide ass of hers. Running your hands across her plush rear causes her tail to arch up, exposing her fleshy pucker and allowing you to finger it. She moans and squirms a little as this stalls her attempts to get back up long enough for you to replace your digits with your [cock size desc of Player] [Cock of Player] cock. Gripping those massively wide hips of hers, you squeeze yourself between her meaty buns and fuck the horny shemale.";
	say "     Her struggles to stand are temporarily forgotten as you drive your manhood into her over and over again. Her tail wraps behind you in a soft hug and even pulls you to her with every thrust you make, urging you on. 'Mmm... yeah... that's good. I'll definitely have to let you do this to me some more once you're my familiar. Nothing like a good fucking to get the magical juices flowing,' she moans. And indeed there's a considerable amount of flowing going on from her titanic cock, precum forming a messy pool between those plump melons of hers. Stuffing that enormous ass of hers is very enjoyable for you as well, despite its excessive size, her back door adjusts to be a nice, snug fit for your [cock size desc of Player] rod readily enough.";
	say "     You pound away at the dragoness's hole, enjoying the warm grip of her cheeks against your hips as you drill into her again and again. Eventually though, you're ready to blow and plough into her hard, burying your full length in her bottom and release your hot cum with a cry of ecstasy. The dragoness gives a throaty roar and climaxes as well, blasting a flood of semen across her tits and the ground. Once you've drained your balls, you pull out and roll the dragoness right back over, leaving her in the same predicament as before, but this time sitting in a sticky mess of semen as your load leaks out of her well-fucked hole.";

to say mdrake_pvictory_02:
	say "     Deciding to have some fun of your own, you stride over to the struggling dragoness and move overtop her. She releases a muffled moan as you grab her gigantic breasts, your added weight atop her making sure she cannot rise. Pushing open her sheer dress, you press your [cock size desc of Player] [Cock of Player] cock between those giant globes and bask in the biggest of tit-fucks ever. Her scaly flesh is smooth and soft, cradling your pulsing rod in their warmth as you thrust away.";
	say "     'Such a naughty familiar, doing this to your poor, stranded mistress,' she says with a moan, making it hard to tell if she's truly upset or playfully teasing. Regardless, you forge on, pounding your [cock size desc of Player] penis into the warm embrace of her bosom. Placing your hands on her massive nipples, you grab them and start pinching and rubbing them, making the dragoness moan all the more. Each are a handful on their own, full, plump and sensitive. Her mighty cock is hard and slaps along your back as it twitches and throbs with excitement as if goading you on. With all this sexy flesh around you, it doesn't take you long before you're ready to blow and paint a sticky white picture of semen across and between her green tits. Having had your fun, you get up, leaving her to crane her muzzle to try and lick up the tasty treat you've left her.";

to say mdrake_pvictory_03:
	choose row MonsterID from the Table of Random Critters;
	say "     Deciding you need some relief after your vigorous battle, your eyes fall to her massive manhood and its drooling slit. The sight of that large, slick and juicy opening has a kinky idea pop into your mind. You stride over to her and, as she struggles to get back up, you grab her cock stroke it firmly. This causes her to moan and distracts her in part from her attempts to rise. Her titanic penis throbs as you run your hands over it, coaxing more precum from its tip. Angling her meaty rod into position, you get your [Cock of Player] shaft lined up and thrust right into its leaking urethra, causing the dragoness to moan in lustful surprise.";
	say "     With your hands gripping the rim of her glans, you pound into her juicy cock. Her cum slit is hot and wet with draconic pre, making your [cock size desc of Player] shaft's passage smooth and slick. The feel of this penile penetration is delightfully different from other sex you've had, this kinky violation very arousing. And it seems to be having a similar effect on your foe as well, the sorceress moaning and panting as her manhood is stuffed with yours. The flow of precum increases as you continue, soaking your crotch as you plough into that virile pillar.";
	WaitLineBreak;
	let x be a random number between 0 and Libido of Player;
	let y be a random number between 0 and 45;
	if x > y:
		say "     Eventually this perverse penetration becomes too much for the dragoness and she roars in climax. You can feel her cock throb with imminent release, but you're too busy thrusting to have the strength to resist the tug of her spasming cum slit. A torrent of draconic semen is pumped through her stuffed slit. And while much of it gushes out around your penis, plenty more is pushed into it by fluid pressure. You can feel her gooey sperm being forced into you, flowing back through your pipes. Your balls bloat with draconic cum being force-fed into them. As they get overloaded and struggle to keep taking more, your bladder and prostate are also stuffed with the invading rush of semen. And only when there's no more room for more inside you is your bloated penis finally forced free from her urethra.";
		say "     Filled to the point of overflowing, you ache for release like you never have before and grab your cock in both hands, pumping it until and rubbing your balls in an attempt to drain out all that excess dragon sperm. Your climax is powerful and launches your first few sprays well over ten feet. You aim the rest of your powerful blasts down onto the dragoness, who moans and rubs the sticky mess into her scales[if wslevel is 3]. With a groan, you release the mix of urine and semen filling your bladder, pissing it out over her[end if]. By the point you're eventually drained, you are weak and woozy, stumbling back several feet as you try to retain your balance. You're sexually sated by this kinky experience[if Ball Size of Player < 36], though your balls have been left larger than before[end if].";
		if CockName of Player is not "Magic Drake":
			say "     Having your genitals overloaded with the dragoness's semen has left your penis transformed. While human-like in shape, it is now made of green flesh and your pubic hair has been replaced by a patch of green scales. You can feel a warmth in your balls as your semen is corrupted and transformed by the lingering dragon cum still in there, making it draconic as well.";
			now CockName of Player is "Magic Drake";
			now CockSpeciesName of Player is "Magic Drake";
			now Cock of Player is cock entry;
			BallsGrow Player by 2;
			follow the sex change rule;
		else:
			BallsGrow Player by 2;
	else:
		say "     Eventually this perverse penetration becomes too much and you drive your cock fully into the dragoness's, cumming with a lustful groan. You blast shot after shot of your [Cum Load Size of Player] load down into her urethra[if Ball Size of Player > 4], feeding your some of your load all the way down into her balls[end if] as she moans and squirms beneath you. Once you're spent, you pull out and watch as her spasming penis twitches and slaps against her belly while some of your cum leaks back out. She moans and rubs it with a desperate need to release, soon cumming with a roar that splatters a mix of your semen and hers across herself and the ground beyond. She flops back onto the ground, your kinky abuse of her mighty manhood leaving her momentarily dazed.";

to say mdrake_pvictory_04:
	say "     Feeling your body's desire to have that mighty cock of hers in you, you decide to give in to that urge - but wanting it on your own terms. You stride over to the sorceress and take hold of her throbbing manhood, rubbing along its underside to push out a gooey gob of precum which you then spread over the pulsating flesh. As you move yourself into position and line her glans with your [cunt size desc of Player] pussy, she moans in needy anticipation even as she struggles to get up.";
	say "     'Oh you naughty pet. It's your ass your mistress wants,' she growls. But her displeasure is soon cut off as you push yourself several inches down onto her green cock and she releases a rumble of pleasure. You pause there, enjoying the feel of it stretching you open and also enjoying her increasingly needy moans for you to ride her. She squirms and tries to rocks her hips beneath you, but can't really get the leverage to push those ultra-wide hips off the ground. You delight in teasing her like this, [if Breast Size of Player > 0]playing with your breasts and [end if][if Player is male]stroking your cock[smn] and [end if]fingering your clit[sfn] in a lewd display that riles her up all the more.";
	say "     Only once your own arousal gets to be too much do you finally sink yourself down further onto her titanic pillar. Getting as much of it as you can, you wriggle yourself over the belly-stuffing log before slowly rising up again. You slide up and down it like this a few times, both letting you savor it and giving your body a chance to adjust in the hopes of getting even just a few more inches in[if scalevalue of Player < 3]. Her cock is so big compared to your [Body Size Adjective of Player] [bodydesc of Player] form that you end up stretched around her meat like a fleshy condom every time you lower yourself down[else if scalevalue of Player < 5]. Her cock, nearly as big as a normal person on its own, stuffs you impossibly full and leaves a clear impression of it against your bulging flesh[else]. Her cock, nearly as big as a normal person, stuffs you incredibly full, so much so that there's a definite bulge formed by it[end if]. Your pace does pick up though and soon you're riding up and down it as quickly as your legs can manage, weak and shaky with the physical pleasure you're feeling. The dragoness isn't doing much better, panting and rumbling with unbridled lust as her meat pulses and throbs in your hot, steamy tunnel.";
	say "     Eventually, it ends up being too much for the both of you and she ends up cumming moments before you. The mighty blasts of her semen pumping into you and flooding your womb are enough to send you over the edge into multi-orgasmic bliss[if Player is male]. Your own cock[smn] blast[smv] messy streams of your seed across the dragoness's face and body[end if][if scalevalue of Player < 3]. Her semen ends up filling you to the point of overflowing as your body sloshes beyond fullness[else if scalevalue of Player < 5]. Her semen ends up filling you to the point of rounding your body with her fills you to the point of rounding your body with fullness[else]. Her semen ends up filling your belly to a sloshing fullness that leaves it visibly plumper[end if]. The sheer weight of the load stuffed into you drags you down further onto her firing cannon and leaves you stuck there while you recover your senses and strength enough to slide off. The dragoness is left in a sticky, messy daze after her much-needed release.[fimpregchance][fimpregchance]";

to say mdrake_pvictory_05:
	say "     Feeling your body's desire to have that mighty cock of hers in you, you decide to give in to that urge - but wanting it on your own terms. You stride over to the sorceress and take hold of her throbbing manhood, rubbing along its underside to push out several gooey gobs of precum. You spread this over the pulsating flesh, getting it nice and lubed up. As you move yourself into position and line her glans with your asshole, she stops struggling to get up and moans in needy anticipation.";
	say "     'Now that's better, my pet. But if you wanted it, I would have gladly given it to you,' she rumbles as you push yourself several inches down onto her green cock. You pause there, enjoying the feel of it stretching you open and also enjoying her increasingly needy moans for you to ride her. She squirms and tries to rocks her hips beneath you, but can't really get the leverage to push those ultra-wide hips off the ground. You delight in teasing her like this, [if Breast Size of Player > 0]playing with your breasts and [end if][if Player is herm]stroking your cock[smn] and fingering your clit[sfn][else if Player is male]stroking your cock[smn][else if Player is female]fingering your clit[sfn][else]running your hands over your [bodydesc of Player] body[end if] in a lewd display that riles her up all the more. Doing this also gives your [if the player is twistcapped]super-stretchy asshole[else]overly-enhanced booty[end if] a chance to prepare itself for the titan that'll soon be filling it.";
	say "     Only once your feel your back passage is sufficiently ready and your own arousal has gotten to be too much to keep teasingly waiting, you finally sink yourself down further onto her titanic pillar. Getting as much of it as you can, you wriggle yourself over the belly-stuffing log before slowly rising up again. You slide up and down it like this a few times, both letting you savor it and giving your body a final chance to adjust in the hopes of getting even just a few more inches in[if scalevalue of Player < 3]. Her cock is so big compared to your [Body Size Adjective of Player] [bodydesc of Player] form that you end up stretched around her meat like a fleshy condom every time you lower yourself down[else if scalevalue of Player < 5]. Her cock, nearly as big as a normal person on its own, stuffs you impossibly full and leaves a clear impression of it against your bulging flesh[else]. Her cock, nearly as big as a normal person, stuffs you incredibly full, so much so that there's a definite bulge formed by it[end if]. Your pace does pick up though and soon you're riding up and down it as quickly as your legs can manage, weak and shaky with the physical pleasure you're feeling. The dragoness isn't doing much better, panting and rumbling with unbridled lust as her meat pulses and throbs in your hot, tight ass.";
	say "     Eventually, it ends up being too much for the both of you and she ends up cumming moments before you. The mighty blasts of her semen pumping into you and flooding your bowels are enough to send you over the edge into orgasmic bliss[if Player is male]. Your own cock[smn] blast[smv] messy streams of your seed across the dragoness's face and body[end if][if scalevalue of Player < 3]. Her semen ends up filling you to the point of overflowing as your body sloshes beyond fullness[else if scalevalue of Player < 5]. Her semen ends up filling you to the point of rounding your body with her fills you to the point of rounding your body with fullness[else]. Her semen ends up filling your belly to a sloshing fullness that leaves it visibly plumper[end if]. The sheer weight of the load stuffed into you drags you down further onto her firing cannon and leaves you stuck there while you recover your senses and strength enough to slide off. The dragoness is left in a sticky, messy daze after her much-needed release.[mimpregchance][mimpregchance]";
	increase mdrakeanal by 1;
	if mdrakeanal >= 3 and player is not twistcapped:
		say "     From the way your asshole and insides have been so thoroughly used, abused and stretched by the dragoness's cock, you have a feeling that you'll never quite be the same again.";
		FeatGain "Twisted Capacity";

to say mdrake_pvictory_06:		[Receive fellatio]
	say "     Feeling you deserve some small payback for the trouble this lust-crazed creature's been causing, you take hold of your [cock size desc of Player] cock and stroke it to erection. The sight of it catches the sorceress's attention, partially distracting her from her efforts to rise. As you approach her draconic muzzle, she licks her lips and releases a needy moan. And when you bring your [Cock of Player] manhood just barely within reach, her reptilian tongue stretches out to lick its tip.";
	say "     'Come on. Give it to me, my sweet,' she moans with an obvious need that brings a grin to your lips. While a little tempted to tease her longer, you want to get it on and so move forward, plunging your [Cock of Player] cock into her warm muzzle. Rocking your hips, you plunge into her sucking maw. Her tongue plays over your meat and her hands [if CockName of Player is listed in infections of InternalCockList]fondle your [Ball Size Adjective of Player] [Balls] with an obvious hunger[else]grab your hips to urge you onwards[end if].";
	say "     Seeing her meaty pillar bobbing in front of you, you grab it and start stroking it as further encouragement for the slutty sorceress. The titanic manhood is shaped like a normal cock, but taken to enormous size. Its smooth flesh, phallic shape and throbbing veins would have it seem human in form were it not for its green hue. This examination is a casual one, undertaken while enjoying the blowjob and giving a handjob (as best you can give its size) in return.";
	say "     As your climax hits you, you thrust deeply into the buxom beauty's maw. Cumming hard, you blast your [Cum Load Size of Player] load across her tongue and down her throat[if Ball Size of Player >= 6]. Your voluminous output is enough to plump the dragoness's belly with her feast of hot semen[end if]. With your orgasm waning, you shift your focus to her cock, rubbing and stroking it just right to finish her off. Angling it away, you delight in watching the high arcs and messy splatters her blasts of cum make until finally her spent shaft flops down onto the ground, temporarily sated.";

to say mdrake_pvictory_07:
	say "***";

to say mdrake_pvictory_08:		[Force self-oral]
	say "     In the mood to turn the tables on the sorceress, you stride over to her and, as she struggles to push herself up with her arms, you grab her cock. Her meat is stiff from the exertion and it just takes a little realignment to jam her throbbing pillar into her draconic muzzle. She gives an irritated grumble and tries to pull back at first, but you keep hold of her massive cock and one of her horns to keep in her maw. Tugging on the horn to plunge her mouth over her shaft a few times, you get her to start sucking herself off. At first, you have to firmly encouraging her like this, but soon enough she's lost herself in self-pleasure and only requires a light hand to guide her pace and drive her to push it even deeper.";
	say "     Her five foot long cock is smooshed between those voluminous globes on her chest and they jiggle and sway with every rocking thrust. Her hands go to her large nipples, pinching and rubbing them with lustful abandon. As the frantic self-sucking grows wilder, she even pushes a finger into those bloated nipples, fingerfucking her tits in a strangely arousing display. This is finally enough to push her over the edge, causing her to release the torrent of cum she'd intended for you down her own throat. Rubbing her pulsing cock, you can feel the surges and ebbs of the flow of semen from her overfull balls. By the end of it, her belly's stuffed and rounded from gobbling down her own cum. She flops back to the ground, momentarily dazed and drooling some of the excessive load from the corner of her muzzle.";

to say mdrake_pvictory_09:		[Taunt her]
	say "     In the mood to tease the dragoness with what she can't have, you stand out of reach and wiggle your ass at her. You sway your wide hips and raise your tail, giving her a tantalizing view of your tailhole, all while keeping it out of her reach. She grunts and groans, struggling in vain to grab your sexy ass. Laughing a little at her struggles, you go even further and reach back to play with your tailhole, first rubbing in a slow circle around the pulsing ring of flesh before plunging a pair of digits into it. As you do this, you tease her about how much she must want this and just how deliciously hot and empty your hole is without a cock to fill it. And speaking of, her pillar of meat bounces up and down, slapping against her massive breasts as it pulses with excitement.";
	say "     Bending over further, you plunge your fingers in deeper and faster. Growing aroused from playing with yourself, it adds to your fun and you continue on with the teasing show. The dragoness, with her familiar's much-desired ass is put on wanton display, is reduced to panting and drooling at the sight of it. Some more frantic fingering has you moaning with pleasure and this proves too be too much for the deprived dragoness, sending her to an orgasm that splatters great blasts of her semen into the air, across the ground and over herself. Getting off on your effect on her, you [if Player is not neuter]end up cumming as well[else]groan in unfocused pleasure as your anus clenches down onto your probing digits until the waves of delight ebb[end if]. Having had your release, you realize you'd carried things much further than you'd originally planned and should probably get moving on.";

to say mdstaff_overgrown:
	increase mdrakeoversized by 1;
	if mdrakeoversized >= 5 and inasituation is false:
		say "As with the previous times, this power makes your already oversized ass quiver as you're filled with the pleasant rush of your backside inflating further. As you fondle your expanding booty with both hands, you allow yourself to flop back onto the ground with a lustful moan as you grow increasingly back-heavy. You can't suppress a happy squeal as you land on your super-padded bottom.";
		WaitLineBreak;
		say "     As has happened before, you're now unable to get back up, though you're in no real hurry to do so. At least not until the sorceress has had her chance to enjoy the turnabout of fortune again. You'd resisted that the first few times, but you're almost looking forward to it by this point. And indeed she's back up soon enough, approaching you with an eager grin, cock throbbing and tongue licking her lips.";
		say "     'Why do you persist in trying this, my foolish familiar?' she rumbles with a smile in her voice as she takes hold of your flailing legs and spreads them wide. Knowing you're unable to fight her like this, you instead relax and ready yourself for the vigorous fucking that you know is coming soon. But she instead flops her massive prick down overtop of your [bodydesc of Player] body, grinding it against you[if Player is male]r manhood[smn][end if] with the sheer weight of it. 'One would almost think you're enjoying this. That you want me to claim you. That must be it,' she rumbles teasingly, rocking her hips so her pulsing, leaking prick slides over you. Her scent is added to the stimuli filling your pleasure-overloaded senses, further clouding your reason, and you even start running your hands over that sexy green phallus. 'You want this magic cock of mine in you, my pet? Promise to be my loyal familiar and I'll give you the fucking you so clearly need.'";
		WaitLineBreak;
		say "     In your pleasure-addled state, you struggle to remember why you should resist. There must have been some reason, but you can't really remember what that would be. As you try to recall, the dragoness simply continues to purr softly about the pleasures she'll provide even as she rubs her increasingly slick shaft across your [bodytype of Player] body. Soon enough the enticement of that lovely cock wins over your unfocused resistance to what sounds like an enticing offer. Moaning for your magic mistress to claim her familiar, you are filled with delight as she smiles down at you.";
		say "     She gets herself lined up and pushes her massive cock into your extra-wide and accommodating backside. Your pucker stretches itself open readily as she pushes into you and fills that aching need inside you. You release a long, lustful cry through your mistress's first several thrusts before being reduced to a series of ongoing moans, pants and groans of delight. 'That's right, you're my sexy ass-slut now, aren't you? My fat-assed, slutty pet? My cock-sleeve familiar? Come on, say it,' she rumbles firmly, pounding into you firmly with each slutty name she calls you. You nod and moan, repeating back loudly and lustfully that you're each of these and many more wanton terms, giving yourself up to the sorceress.";
		WaitLineBreak;
		say "     By the time she's done and cums in a torrent of belly-bulging seed, any last traces of your resistance have been eradicated by the thorough fucking and your complete submission to her magic. You cry out in [if Player is neuter]ecstasy as spasms of delight run through you and[else]orgasm, spasms of delight running through you as[end if] your mega-booty tries to squeeze as much seed as it can from your mistress to seal the bond. By the time she's done and pulled out, you're left stuffed to [if scalevalue of Player < 3]overflowing with your body sloshing beyond fullness[else if scalevalue of Player < 5]the point of rounding your body with fullness[else]a sloshing fullness that leaves your tummy visibly plumper[end if]. The warmth of her semen suffuses into you slowly as she starts drawing runes on your big butt and belly with the excess cum gushing from your over-fucked hole. Now that you've given into her fully, she's able to complete the ritual, bonding you to her as her familiar and sex slave - a fate you now fully embrace. And by the time the ritual's done, your over-inflated ass has shrunk back down to its previous, beautifully super-wide state and you're able to get up and follow your sorceress mistress away as her loyal companion.";
	else if mdrakeoversized is odd:
		say "This power makes your already oversized ass quiver and you're filled with the pleasant rush of your backside inflating further. Casting aside the staff, you reach back to fondle your expanding booty with both hands. You can't hold back a lustful moan as grow increasingly back-heavy, soon falling over onto your super-padded bottom with a happy squeal.";
		WaitLineBreak;
		say "     But thus your plan has gone awry[if mdrakeoversized > 0] again[end if]. After recovering from the initial rush of ecstasy from your gluteal growth, you find yourself unable to get up. Now like the defeated dragoness, you're having difficulty getting back up. After some grunting and rocking by both parties, the green sorceress has recovered enough to finally rise. And with the tables turned, she grins eagerly and approaches you, cock throbbing and tongue licking her lips.";
		say "     'You foolish, foolish thing. I think you need a proper lesson on who's the sorceress here and who's the lowly familiar,' she says, grabbing your flailing legs and spreading them wide. [if weapon object of Player is journal]Unable to reach her and still a-tingle with the excess magic affecting your ass[else]Having dropped your weapon to use her now-discarded staff[end if], you're unable to fight back as she lines up her massive rod with your magic-filled booty and plunges it into your quivering tailhole.";
		WaitLineBreak;
		say "     Overloaded on the excessive magic you've added to your enchanted booty, your anus spreads readily for the foot-thick pillar of dragonmeat. You release a long, lustful cry despite yourself, the feel of that draconic cock feeling so good. You hadn't noticed how empty your butthole was feeling until the filled it for you. 'You see - you're an ass-slut through and through. You're meant to be my fat-assed, slutty, cock-sleeve familiar. And you clearly need a good, hard lesson in why you should just accept that,' she says, her voice turning to a growl as she goes from firmly fucking you to pounding you hard and deep. Your body stretches and your hyper-inflated ass jiggles delightfully each time she pushes deep inside you, [if scalevalue of Player < 3]stretching you like a living condom around it[else if scalevalue of Player < 5]visibly bulging your belly to fit it[else]forming a bulge in your belly as it moves in and out of you[end if]. And while there's some discomfort from how roughly she's taking you, there's far more pleasure coming from your ensorcelled ass.";
		say "     By the time she's done and cums in a torrent of belly-bulging seed, you're lost in a confused haze of lust. You cry out in [if Player is neuter]ecstasy as spasms of delight run through you and[else]orgasm, spasms of delight running through you as[end if] your mega-booty tries to squeeze as much seed as it can from your mistress. By the time she's done and pulled out, you're left stuffed to [if scalevalue of Player < 3]overflowing with your body sloshing beyond fullness[else if scalevalue of Player < 5]the point of rounding your body with fullness[else]a sloshing fullness that leaves your tummy visibly plumper[end if]. Retrieving her staff, she leaves you like that - sticky and gushing her excess cum from your over-fucked hole - with a remark that the excess magic should fade in short order. Having enchanted your ass beyond its limits, the magic cannot maintain it in this state permanently and it gradually deflates down to its previous (but still super-sized) state. Once it's gone down enough and you've sufficiently recovered your wits, you manage to roll yourself over and get back up so you can be on your way.[mimpregchance][mimpregchance]";
	else:
		say "This power makes your already oversized ass quiver and you're filled with the pleasant rush of your backside inflating further. Casting aside the staff, you reach back to fondle your expanding booty with both hands. You can't hold back a lustful moan as grow increasingly back-heavy, soon falling over onto your super-padded bottom with a happy squeal.";
		WaitLineBreak;
		say "     But once again, your attempt has gone awry. After recovering from the initial rush of ecstasy from your gluteal growth, you find yourself unable to get up. As before and like the nearby dragoness, you're having difficulty getting back up. Having been struggling at it for a while, the green sorceress recovers enough to finally rise before you do. And with the tables turned, she grins eagerly and approaches you, cock throbbing and tongue licking her lips.";
		say "     'You foolish, foolish thing. I think you need another lesson on who's the sorceress here and who's the lowly familiar,' she says, grabbing your flailing legs and spreading them wide. Unable to defend yourself against the dragoness you'd earlier dispatched, she easily gets her massive rod lined up with your magically swollen booty. She grinds its glans against your pucker, pushing it open a little and then easing back time and again, getting you increasingly riled up. You bite your lip, trying to hold back your moans and whimpers, to no avail. 'You want this, don't you, pet?' she purrs teasingly as she taunts you by almost fucking you. Your transformed ass feels so empty that your butthole's downright aching for it. In the end you cry out for it, begging her to give it to you.";
		WaitLineBreak;
		say "     Delaying no longer, the dominant dragoness drives her dick in deep. Overloaded on the excessive magic you've added to your enchanted booty, your anus spreads readily for the foot-thick pillar of dragonmeat. You release a long, lustful cry despite yourself, the feel of that draconic cock feeling so good. 'You see - you're an ass-slut through and through. You're meant to be my fat-assed, slutty, cock-sleeve familiar. And you clearly need another good, hard lesson in why you should just accept that,' she says, her voice turning to a growl as she goes from firmly fucking you to pounding you wild and hard. Your body stretches and your hyper-inflated ass jiggles delightfully each time she pushes deep inside you, [if scalevalue of Player < 3]stretching you like a living condom around it[else if scalevalue of Player < 5]visibly bulging your belly to fit it[else]forming a bulge in your belly as it moves in and out of you[end if]. And while there's some discomfort from how roughly she's taking you, there's far more pleasure coming from your ensorcelled ass.";
		say "     By the time she's done and cums in a torrent of belly-bulging seed, you're lost in a confused haze of lust. You cry out in [if Player is neuter]ecstasy as spasms of delight run through you and[else]orgasm, spasms of delight running through you as[end if] your mega-booty tries to squeeze as much seed as it can from your mistress. By the time she's done and pulled out, you're left stuffed to [if scalevalue of Player < 3]overflowing with your body sloshing beyond fullness[else if scalevalue of Player < 5]the point of rounding your body with fullness[else]a sloshing fullness that leaves your tummy visibly plumper[end if]. Retrieving her staff, she leaves you like that - sticky and gushing her excess cum from your over-fucked hole - with a remark that the excess magic should fade in short order. Having enchanted your ass beyond its limits, the magic cannot maintain it in this state permanently and it gradually deflates down to its previous (but still super-sized) state. Once it's gone down enough and you've sufficiently recovered your wits, you manage to roll yourself over and get back up so you can be on your way.[mimpregchance][mimpregchance]";
	now fightoutcome is 20; [player now 'lost' the fight]
	decrease mdrakebeaten by 1; [removing this win from the tally...]
	increase mdrakeloss by 1; [...and counting it as a loss instead]
	increase mdrakeanal by 1;
	if mdrakeanal >= 3 and player is not twistcapped:
		say "     From the way your asshole and insides have been so thoroughly used, abused and stretched by the dragoness's cock, you have a feeling that you'll never quite be the same again.";
		FeatGain "Twisted Capacity";
	if mdrakeoversized < 5 or inasituation is true:
		infect "Magic Drake";
	decrease humanity of Player by a random number between 2 and 4;
	increase Libido of Player by a random number from 2 to 4;
	if "Strong Psyche" is listed in feats of Player, increase Humanity of Player by 1;
	if "Weak Psyche" is listed in feats of Player, decrease humanity of Player by 1;
	if "Horny Bastard" is listed in feats of Player, increase Libido of Player by 1;
	if "Cold Fish" is listed in feats of Player, decrease Libido of Player by 1;
	if Libido of Player > 100, now Libido of Player is 100;
	if mdrakeoversized >= 5 and inasituation is false:
		now mdrakeoversized is 100;
		now humanity of Player is 0;
		turn the Player into a "Magic Drake" silently; [NOTE: Avoid attributeinfect output in a game over (@Stadler#3007)]
		if hellHoundLevel is 0:
			follow the sex change rule;
			follow the sex change rule;
		if Libido of Player < 45, now Libido of Player is 45;
		wait for any key;
		trigger ending "Magic Dragoness's Familiar";
		end the story saying "Having accepted your role as the dragoness's familiar, you go off with the sorceress.";
		now battleground is "void";
		follow the turnpass rule;
		wait for any key;
		stop the action;


Section 2 - Creature Insertion

Table of CombatPrep (continued)
name(text)	PrepFunction(text)
"Magic Drake"	"[PrepCombat_Magic Drake]"

to say PrepCombat_Magic Drake:
	setmongender 6; [creature is shemale]

Table of Random Critters (continued)
NewTypeInfection (truth state)	Species Name	Name	Enemy Title	Enemy Name	Enemy Type	Attack	Defeated	Victory	Desc	Face	Body	Skin	Tail	Cock	Face Change	Body Change	Skin Change	Ass Change	Cock Change	str	dex	sta	per	int	cha	sex	HP	lev	wdam	area	Cock Count	Cock Length	Ball Size	Nipple Count	Breast Size	Male Breast Size	Cunt Count	Cunt Depth	Cunt Tightness	SeductionImmune	Libido	Loot	Lootchance	TrophyFunction	MilkItem	CumItem	Scale (number)	Body Descriptor (text)	Type (text)	Magic (truth state)	Resbypass (truth state)	non-infectious (truth state)	Cross-Infection (text)	DayCycle	Altcombat (text)	BannedStatus (truth state)
--	--	--	--	--	--	--	--	--	--	--	--	--	--	--	--	--	--	--	--	--	--	--	--	--	--	--	--	--	--	--	--	--	--	--	--	--	--	--	--	--	--	--	--	--	--	--	--	--	--	--	--	--	--	--	--	--;

When Play begins:
	Choose a blank row from Table of Random Critters;
	now NewTypeInfection entry is false;
	now Species Name entry is "Dragon"; [ Name of the overall species of the infection, used so a "male x" and "female x" have "pureblood X" children. ]
	add "Magic Drake" to infections of ReptileList;
	add "Magic Drake" to infections of FurryList;
	add "Magic Drake" to infections of MagicalList;
	add "Magic Drake" to infections of HermList;
	add "Magic Drake" to infections of TaperedCockList;
	add "Magic Drake" to infections of InternalCockList;
	add "Magic Drake" to infections of InternalBallsList;
	add "Magic Drake" to infections of BipedalList;
	add "Magic Drake" to infections of TailList;
	add "Magic Drake" to infections of OviImpregnatorList;
	add "Magic Drake" to infections of TailweaponList;
	add "Magic Drake" to infections of FirebreathList;
	now Name entry is "Magic Drake"; [ Infection/Creature name. Capitalized. ]
	now enemy title entry is ""; [ Name of the encountered creature at combat start - Example: "You run into a giant collie." instead of using "Smooth Collie Shemale" infection name. ]
	now enemy Name entry is ""; [ Specific name of unique enemy. ]
	now enemy type entry is 1; [ 0 = non unique enemy; 1 = unique (unknown name); 2 = unique (known name) | Used to disqualify unique enemies from Vore/UB and showing the enemy name in encounters. ]
	now attack entry is "[one of]The scaly sorceress[or]The magical drake[or]The dragon woman[or]The buxom shemale[at random] [one of]shoots you with a blast of sticky sparkles from her staff[or]hip-checks you with her massive bottom, slamming you between her ass and something else[or]slaps you hard with her throbbing erection[or]swings her staff in a wide arc, sending you tumbling as some unseen force sends you and debris flying back[or]conjures a spectral fist from her staff which then strikes you repeatedly[or]mashes your face between her tits, both suffocating and crushing your head between those plump globes[at random]."; [ Successful attack message ]
	now defeated entry is "[beatthemagicdrake]"; [ Text when monster loses. ]
	now victory entry is "[losetomagicdrake]"; [ Text when monster wins. ]
	now desc entry is "[magicdrakedesc]"; [ Description of the creature when you encounter it. ]
	now face entry is "pushed out with a draconic muzzle and a short set of backwards-pointing horns";
	now body entry is "a little on the pudgy side with a little extra fat to round out your somewhat girlish, 5['] 6' figure. Your hands and feet are changed as well, having been exchanged for reptilian talons. Upon your back is a pair of dragon wings";
	now skin entry is "[one of]scaley green[or]green-scaled[at random]";
	now tail entry is "[mdtaildesc]."; [ Ass/Tail. Write as a full sentence (with period) or leave blank for none. ]
	now cock entry is "green"; [ Cock. Format as "You have a 'size' [Cock of Player] cock." ]
	now face change entry is "it tingles with a strange energy. This builds until there comes a loud snap. More pops and snaps follow as your head shifts and reshapes itself. A draconic muzzle pushes forth and a pair of small horns grow on the top of your head";
	now body change entry is "an unusual sensation spreads through you. Starting off as a tingle of strange energy, it builds until your body starts reshaping itself. Your figure changes, becoming roughly five and a half feet tall, with a somewhat feminine figure and a few added pounds to round out your curves. The energy surges at your back, forming draconic wings[mdscaletweak]";
	now skin change entry is "it starts to flake and itch. The itching grows into tingles as a green tinge starts seeping into your skin. Soon it hardens into reptilian scales that are smooth and sensitive";
	now ass change entry is "[mdtailtf][mdscaletweak]";
	now cock change entry is "throbs and twitches. Precum drools from it and, as you watch with an odd excitement, it becomes green in color";
	now str entry is 22; [ These are now the creature's stats... ]
	now dex entry is 20; [ ...and are only altered onto the player via Shifting or the Mighty Mutation feat ]
	now sta entry is 12; [ These values may be used as part of alternate combat.]
	now per entry is 13;
	now int entry is 16;
	now cha entry is 15;
	now sex entry is "Male"; [ Infection will move the player towards this gender. Current: 'Male' 'Female' 'Both' ]
	now HP entry is 92; [ The monster's starting HP. ]
	now lev entry is 15; [ Monster level. (Level x 2) XP for victory. (Level / 2) XP for losing. ]
	now wdam entry is 17; [ Monster's average damage when attacking. ]
	now area entry is "Red"; [ "Outside" "Mall" "Park" "Beach" etc... Check an existing creature in the area. ]
	now Cock Count entry is 1; [ Number of cocks the infection will try to cause if sex entry is 'Male' or 'Both'. ]
	now Cock Length entry is 30; [ Length in inches infection will make cock grow to if cocks. ]
	now Ball Size entry is 5; [ Cock width, more commonly used for ball size. ]
	now Nipple Count entry is 2; [ Number of nipples the infection will give a player. ]
	now Breast Size entry is 10; [ Size of breasts the infection will try to attain (corresponds to letter cup size). ]
	now Male Breast Size entry is 10; [ Breast size for if Sex="Male", usually zero. ]
	now Cunt Count entry is 0; [ The number of cunts the infection will try to cause if sex entry is 'Female' or 'Both'. ]
	now Cunt Depth entry is 0; [penetrable length in inches; some minor stretching allowed, or more with Twisted Capacity]
	now Cunt Tightness entry is 0; [size 1-5, generates adjectives of extremely tight/tight/receptive/open/gaping]
	now SeductionImmune entry is false;
	now libido entry is 45; [ Target libido the infection will rise towards. ]
	now loot entry is ""; [ Dropped item, blank for none. Case sensitive. ]
	now lootchance entry is 0; [ Percentage chance of dropping loot, from 0-100. ]
	now MilkItem entry is "magic drake milk"; [ Item to be given to the player if they have this infection and milk themselves. ]
	now CumItem entry is ""; [ Item to be given to the player if they have this infection and jerk off. ]
	now TrophyFunction entry is "-"; [ Function to generate a list of optional loot items, of which the player can choose one after victory. ]
	now scale entry is 3; [ Number 1-5, approx size/height of infected PC body: 1=tiny, 3=avg, 5=huge ]
	now body descriptor entry is "[one of]plump[or]pudgy[or]curvaceous[or]girly[or]feminine[at random]";
	now type entry is "[one of]draconic[or]dragon[or]reptilian[as decreasingly likely outcomes]";
	now magic entry is true;
	now resbypass entry is false;
	now non-infectious entry is false;
	now Cross-Infection entry is ""; [ Infection that this infection will give the player when they lose; can be left empty if they infect with the monster's own strain. ]
	now DayCycle entry is 0; [ 0 = Up at all times; 1 = Diurnal (day encounters only); 2 = Nocturnal (night encounters only);]
	now altcombat entry is "firebreath"; [ Row used to designate any special combat features, "default" for standard combat. ]
	now BannedStatus entry is false;

[
Table of New Infection Parts (continued)
Species Name	Name	Body Weight	Body Definition	Androginity	Head Change	Head Description	Head Adjective	Head Skin Adjective	Head Color	Head Adornments	Hair Length	Hair Shape	Hair Color	Hair Style	Beard Style	Body Hair Length	Eye Color	Eye Adjective	Mouth Length	Mouth Circumference	Tongue Adjective	Tongue Color	Tongue Length	Torso Change	Torso Description	Torso Adjective	Torso Skin Adjective	Torso Adornments	Torso Color	Torso Pattern	Breast Adjective	Breast Size	Male Breast Size	Nipple Count	Nipple Color	Nipple Shape	Back Change	Back Adornments	Back Skin Adjective	Back Color	Arms Change	Arms Description	Arms Skin Adjective	Arms Color	Locomotion	Legs Change	Legs Description	Legs Skin Adjective	Legs Color	Ass Change	Ass Description	Ass Skin Adjective	Ass Color	Ass Width	Tail Change	Tail Description	tail skin adjective	Tail Color	Asshole Depth	Asshole Tightness	Asshole Color	Cock Change	Cock Description	Cock Adjective	Cock Color	Cock Count	Cock Girth	Cock Length	Ball Description	Ball Count	Ball Size	Cunt Change	Cunt Description	Cunt Adjective	Cunt Color	Cunt Count	Cunt Depth	Cunt Tightness	Clit Size
--	--	--	--	--	--	--	--	--	--	--	--	--	--	--	--	--	--	--	--	--	--	--	--	--	--	--	--	--	--	--	--	--	--	--	--	--	--	--	--	--	--	--	--	--	--	--	--	--	--	--	--	--	--	--	--	--	--	--	--	--	--	--	--	--	--	--	--	--	--	--	--	--	--	--	--	--	--	--	--;

When Play begins:
	Choose a blank row from Table of New Infection Parts;
	now Species Name entry is ""; [ Name of the overall species of the infection, used so a "male x" and "female x" have "pureblood X" children. ]
	now Name entry is ""; [matching infection name to Table of Random Critters]
	now Body Weight entry is 5; [scale of 1-9 for body weight, grouped into low weight (1-3), mid weight (4-6) and high weight (7-9)]
	now Body Definition entry is 5; [scale of 1-9 for body definition, grouped into low muscle (1-3), mid muscle (4-6), high muscle (7-9)]
	[Body Adjective is generated out of the body weight and body definition and can be used in scenes - one word descriptive adjective depending on weight and definition groups: low weight group: skinny/slender/lithe; mid weight group: average/fit/muscled; high weight group: pudgy/husky/jacked]
	now Androginity entry is 5; [1-9 scale of hypermasculine to hyperfeminine]
	[Gender Adjective is generated out of androginity 1-9: hypermasculine/masculine/effeminate/somewhat effeminate/androgynous/feminine butch/tomboyish/feminine/hyperfeminine]
	now Head Change entry is ""; [partial sentence that fits in: "Your head and face [one of]tingle[or]go flush[or]vibrate with odd pleasure[or]go cold[or]feel oily[at random] as [head change entry]."]
	now Head Description entry is ""; [partial sentence that fits in "Your face and head resemble that of [Head Description of Player]. You have [Eye Adjective of Player], [Eye Color of Player] eyes and an overall [Gender Adjective of Player] appearance."]
	now Head Adjective entry is ""; [one word descriptive adjective (avian/canine/...)]
	now Head Skin Adjective entry is ""; [one word descriptive adjective]
	now Head Color entry is ""; [single word color adjective for the dominant color of the skin/fur/feathers/scales]
	now Head Adornments entry is "";[partial sentence that fits in "Before moving on from your head, you give your [Head Adornments of Player] a proud glance followed by a light caress."]
	now Hair Length entry is 2; [hair length in inches]
	now Hair Shape entry is ""; [one word shape descriptor (curly/straight/...)]
	now Hair Color entry is ""; [one word color descriptor]
	now Hair Style entry is ""; [one word style descriptor (ponytail/mohawk/buzzcut/...) to fit "On top of your head you have [Hair Length of Player] inch long, [Hair Shape of Player] [Hair Color of Player] hair in the [Hair Style of Player] style."]
	now Beard Style entry is ""; [short beard style (goatee/3-day stubble beard/porn stache/mutton chops beard/...) to go into "You have a [Hair Color of Player] [Beard Style of Player]."]
	now Body Hair Length entry is 0; [numerical value, 0-4 (no body hair/light/moderate/heavy/furry) - only set to > 0 if the infection does not have fur/scales/etc. !]
	now Eye Color entry is ""; [one word color descriptor]
	now Eye Adjective entry is ""; [one word descriptive adjective (slitted/round/...)]
	now Mouth Length entry is 3; [inches deep for face fucking; maximum possible will be double this number (when deep throating)]
	[Mouth Length Adjective is generated by a function and can be used in scenes too - "petite, shallow, average, deep, bottomless"]
	now Mouth Circumference entry is 3; [mouth circumference 1-5, see Mouth Circumference Adjective]
	[Mouth Circumference Adjective is generated by a function and can be used in scenes too - "tiny, small, normal, wide, gaping"]
	now Tongue Adjective entry is ""; [one word descriptive adjective (wide/slobbery/...)]
	now Tongue Color entry is ""; [one word color descriptor]
	now Tongue Length entry is 3; [length in inches]
	now Torso Change entry is ""; [partial sentence that fits in: "Your torso [one of]tingles[or]goes flush[or]vibrates with odd pleasure[or]goes cold[or]feels oily[at random] as [Torso Change entry]."]
	now Torso Description entry is ""; [partial sentence, fitting in "Looking down at yourself, you appear [Gender Adjective of Player] with a [Body Adjective of Player] build. Your torso is [Torso Description of Player][if Body Hair Length of Player > 1], covered in [Torso Color of Player] skin and [Body Hair Description of Player][else if Body Hair Length of Player is 1], covered in smooth, [Torso Color of Player] skin[end if]."]
	now Torso Adjective entry is ""; [one word descriptive adjective (avian/canine/...)]
	now Torso Adornments entry is ""; [(pouch/udders/...); partial sentence to fit: "You take a moment to feel your [Torso Adornments of Player]."]
	now Torso Skin Adjective entry is ""; [one word adjective (feathered/furred/scaly/...); EMPTY "" for creatures with just skin]
	now Torso Color entry is ""; [single word color adjective for the dominant color of the skin/fur/feathers/scales]
	now Torso Pattern entry is ""; [single word color adjective for the dominant pattern of the skin/fur/feathers/scales]
	now Breast Adjective entry is ""; [adjective(s) example: round, pointy, perky, saggy, bouncy. This would serve as either a general appearance of a infections breasts or possibly something that may be effected by a item or NPC.]
	now Breast Size entry is 0; [cup size as number, counting Flat Pecs = 0, A = 1, B = 2, ...]
	now Male Breast Size entry is 0; [cup size as number, counting Flat Pecs = 0, A = 1, B = 2, ...]
	now Nipple Count entry is 2; [count of nipples]
	now Nipple Color entry is ""; [one word color descriptor]
	now Nipple Shape entry is ""; [shape example: any shape will do as long as it has a baseline with a current infection or item]
	now Back Change entry is ""; [partial sentence that fits in: "Your back [one of]tingles[or]goes flush[or]vibrates with odd pleasure[or]goes cold[or]feels oily[at random] as [Back Change entry]."]
	now Back Adornments entry is ""; [partial sentence to fit: "Your back tickles with the feeling of movement caused by [back adornments of Player]."]
	now Back Skin Adjective entry is ""; [one word adjective (feathered/furred/scaly/...); EMPTY "" for creatures with just skin]
	now Back Color entry is ""; [single word color adjective for the dominant color of the skin/fur/feathers/scales]
	[Limbs Adjective is generated by a function and can be used in scenes too - "rail-thin, slender, sinewy, average, firm, muscular, flabby, meaty, rippling"]
	now Arms Change entry is ""; [partial sentence that fits in: "Your arms [one of]tingle[or]go flush[or]vibrate with odd pleasure[or]go cold[or]feel oily[at random] as [Arms Change entry]."]
	now Arms Description entry is ""; [partial sentence to fit: "Your [Limbs Adjective of Player] arms are [Arms Description of Player]."]
	now Arms Skin Adjective entry is ""; [one word adjective (feathered/furred/scaly/...); EMPTY "" for creatures with just skin]
	now Arms Color entry is ""; [single word color adjective for the dominant color of the skin/fur/feathers/scales]
	now Locomotion entry is ""; [one word adjective: (bipedal/quadrupedal/octapedal/serpentine/sliding)]
	now Legs Change entry is ""; [partial sentence that fits in: "Your legs [one of]tingle[or]go flush[or]vibrate with odd pleasure[or]go cold[or]feel oily[at random] as [Legs Change entry]."]
	now Legs Description entry is ""; [partial sentence to fit: "As your inspection goes even lower, you come to the two [Body Adjective of Player] legs supporting you. They are [Legs Description of Player]."]
	now Legs Skin Adjective entry is ""; [one word adjective (feathered/furred/scaly/...); EMPTY "" for creatures with just skin]
	now Legs Color entry is ""; [single word color adjective for the dominant color of the skin/fur/feathers/scales]
	now Ass Change entry is ""; [partial sentence that fits in: "Your ass [one of]tingles[or]goes flush[or]vibrates with odd pleasure[or]goes cold[or]feels oily[at random] as [Ass Change entry]."]
	now Ass Description entry is ""; [partial sentence to fit: "Using your hands you feel your behind enjoying the sensation of your [Ass Width Adjective of Player], [Ass Shape Adjective of Player] [Ass Description of Player]." (For players with skin, instead of the period: ", covered in [Ass Color of Player] skin and [Body Hair Description of Player]"]
	now Ass Skin Adjective entry is ""; [one word adjective (feathered/furred/scaly/...); EMPTY "" for creatures with just skin]
	now Ass Color entry is ""; [single word color adjective for the dominant color of the skin/fur/feathers/scales]
	now Ass Width entry is 3; [ass width from 1-5]
	[Ass Width Adjective generated by function out of ass width: dainty/small/round/huge/enormous]
	[Ass Adjective generated by function out of body definition and ass width]
	now Tail Change entry is ""; [partial sentence that fits in: "Your rear [one of]tingles[or]goes flush[or]vibrates with odd pleasure[or]goes cold[or]feels oily[at random] as [if HasTail of Player is true]your existing tail is changed into a [Tail Description entry][else][Tail Change entry][end if]."]
	now Tail Description entry is ""; [partial sentence to fit: "Just below your lower back sprouts a [Tail Description of Player], which you move back and forth with glee."]
	now Tail Skin Adjective entry is ""; [one word adjective (feathered/furred/scaly/...); EMPTY "" for creatures with just skin]
	now Tail Color entry is ""; [single word color adjective for the dominant color of the skin/fur/feathers/scales]
	now Asshole Depth entry is 7; [inches deep for anal fucking]
	[Asshole Depth Adjective is generated by a function and can be used in scenes too - "petite (< 3), shallow (< 5), average (< 9), deep (< 15), bottomless (15+)"]
	now Asshole Tightness entry is 3; [asshole tightness 1-5, "extremely tight, tight, receptive, open, gaping"]
	[Asshole Tightness Adjective is generated by a function and can be used in scenes too - "extremely tight, tight, receptive, open, gaping"]
	now Asshole Color entry is ""; [one word color descriptor]
	now Cock Count entry is 0;
	now Cock Girth entry is 0; [thickness 1-5, generates the Cock Girth Adjective]
	[Cock Girth Adjective is generated by a function and can be used in scenes too: thin/slender/average/thick/monstrous]
	now Cock Length entry is 0; [length in inches]
	now Cock Adjective entry is ""; [one word adjective: avian/canine/...]
	now Cock Change entry is ""; [partial sentence that fits in: "Your cock [one of]tingles[or]goes flush[or]vibrates with odd pleasure[or]goes cold[or]feels oily[at random] as [Cock Change entry]."]
	now Cock Description entry is ""; [partial sentence to fit: "You have a [Cock Girth Adjective of Player], [Cock Length of Player]-inch-long [Cock Adjective of Player] [one of]cock[or]penis[or]shaft[or]maleness[at random] that [cock Description of Player]."]
	now Cock Color entry is ""; [one word color descriptor]
	now Ball Count entry is 0; [allowed numbers: 1 (uniball), 2 or 4]
	now Ball Size entry is 0; [size of balls 1-7: "acorn-sized", "dove egg-sized", "chicken egg-sized" "goose-egg sized", "ostrich-egg sized", "basketball-sized", "beachball-sized"]
	[Ball Size Adjective is generated by a function and can be used in scenes too]
	now Ball Description entry is ""; [partial sentence to fit: "Underneath it hangs a pair of [Ball Size Adjective of Player] [Ball Description of Player]."]
	now Cunt Count entry is 0;
	now Cunt Depth entry is 0; [penetrable length in inches; some minor stretching allowed, or more with Twisted Capacity]
	now Cunt Tightness entry is 0; [size 1-5, generates adjectives of extremely tight/tight/receptive/open/gaping]
	[Cunt Tightness Adjective is generated by a function and can be used in scenes too: extremely tight/tight/well-used/open/gaping]
	now Cunt Adjective entry is ""; [one word adjective: avian/canine/...]
	now Cunt Change entry is ""; [partial sentence that fits in: "Your pussy [one of]tingles[or]goes flush[or]vibrates with odd pleasure[or]goes cold[or]feels oily[at random] as [Cunt change entry]."]
	now Cunt Description entry is ""; [partial sentence to fit: "You have a [Cunt Tightness Adjective of Player] [one of]cunt[or]pussy[or]vagina[or]cleft[at random] that [Cunt Description of Player]."]
	now Cunt Color entry is ""; [one word color descriptor]
	now Clit Size entry is 0; [size 1-5, see Clit Size Adjective]
	[Clit Size Adjective is generated by a function and can be used in scenes: very small/small/average/large/very large]
]


to say mdtaildesc:
	say "[if mdasslevel < 3]You have a cute, fuckable bubble butt with a long, reptilian tail above it[else if mdasslevel is 3]You have a plump, rounded ass with a long, reptilian tail above it[else if mdasslevel is 4]You have an impressively large booty with a long, reptilian tail above it[else if mdasslevel is 5]Your hips are oversized for your body and your ass is huge and heavy. You have a long, reptilian tail attached above this super-meaty backside of yours[else]Your hips are widely oversized for your body and your ass end is enormous. Massive and meaty, you'd not even be able to put your arms fully around it. Above your mega-booty is a long, reptilian tail that swishes excitedly with every swaying step you take[end if]";

to say mdtailtf:
	say "[if mdasslevel < 3]your ass reforms into a cute, fuckable bubble butt with a long, reptilian tail above it[else if mdasslevel is 3]your ass reforms into a plump and rounded booty. Above your meaty backside is a long, reptilian tail[else if mdasslevel is 4]your hips widen as your ass reforms into an impressively large booty. Above your hefty backside is a long, reptilian tail[else if mdasslevel is 5]your hips widen markedly to deal with your growing ass. It swells up and out, becoming huge and heavy. Above your super-meaty backside is a long, reptilian tail[else]your hips widen greatly to deal with your swelling ass. It grows and grows comically large, passing the point you'd be able to putting your arms fully around it. Above your mega-booty is a long, reptilian tail that swishes excitedly with every swaying step you take[end if]";
	if mdasslevel > 4 and BodyName of Player is "Magic Drake":
		choose row MonsterID from the Table of Random Critters;
		now scale entry is 4;
		now scalevalue of Player is 4;
	else if BodyName of Player is not "Magic Drake":
		choose row MonsterID from the Table of Random Critters;
		now scale entry is 3;

to say mdscaletweak:
	choose row MonsterID from the Table of Random Critters;
	if BodyName of Player is not "Magic Drake":
		now scale entry is 3;
		now scalevalue of Player is 3;
	else if mdasslevel > 4 and TailName of Player is "Magic Drake":
		now scale entry is 4;
		now scalevalue of Player is 4;
	else:
		now scale entry is 3;


Section 3 - Endings

Table of GameEndings (continued)
Name (text)	Type (text)	Subtype (text)	Ending (rule)	Priority (number)	Triggered (truth state)
"Magic Dragoness's Familiar"	"Leaving"	""	Magic Dragoness's Familiar rule	100	false
"Magic Dragoness's Servant"	"Leaving"	""	Magic Dragoness's Servant rule	100	false
["Magic Drake Infection"	"Infection"	""	Magic Drake Infection rule	1000	false]

This is the Magic Dragoness's Familiar rule:
	if ending "Magic Dragoness's Familiar" is triggered:
		the Player has left;

This is the Magic Dragoness's Servant rule:
	if ending "Magic Dragoness's Servant" is triggered:
		the Player has left;

[
This is the Magic Drake Infection rule:
	if Player has a body of "Magic Drake":
		trigger ending "Magic Drake Infection"; [Here it states, that the ending has been played.]
		if humanity of Player < 10:
			say "     You succumb to your template infection.";
		else:
			say "     You survive, but were infected by the template.";
			if Player is male:							[MALE/HERM]
				say "     Additional text for a male/herm survivor.";
			else if "Sterile" is not listed in feats of Player:	[F-BREEDABLE]
				say "     Additional text for a female survivor who can become preggers.";
			else:									[F-STERILE]
				say "     Additional text for a female survivor who cannot become preggers.";
[succumb at low ass size - your mistress is nothing if not persistent...]
[epic mount?]
]

to say mdrake_bad_end:
	say "     Once more you lay helpless before the drake, begging to be taken by your mistress. The sight of you on the ground before her causes her to smirk, and with a twirl of her staff you can feel the now familiar sensation of your ass ballooning outward with her magic, reaching the incredibly size she pushed it to the last time you saw her. As you're distracted by the pillowy cheeks you now have, the drake circles around you and gives one a smack, sending a shockwave over the surface. 'Ah, you accept my magic so easily now, like the wonderful little familiar you are. I think that now I've perfected the spell, you see, and it's time to make you perfect. Doesn't that sound wonderful?' A moment passes, before you realize that it wasn't simply a rhetorical question. No matter what happens, you're not sure you'll ever escape her charms. [bold type]Do you give in fully to the drake?[roman type][line break]";
	LineBreak;
	say "     ([link]Y[as]y[end link]) - Become hers completely.";
	say "     ([link]N[as]n[end link]) - No, never!";
	LineBreak;
	if Player consents: [submit path]
		say "     Embracing what you want within, you nod your head slowly, and the drake breaks out into a wide, genuine smile. The sight of her happy expression fills you with an inner warmth, completely different from the usual kind of warmth she fills your backside with, but still just as satisfying. Knowing that you've pleased your mistress makes you content, and you relax under her, giving her total control. 'I'm so glad you see the truth of your place, familiar. You and I will have such fun! And I suppose I should reward you for your good behavior with a taste of what's to come, don't you think?' Rather than wait for an answer, she begins chanting under her breath, and soon enough you feel the now-familiar weight of her enchanted cock resting on your rear, at its full size and potential. You shiver slightly, not in fear, but in anticipation.";
		say "     Trusting the combination of her powers and your submission, she doesn't hesitate in the slightest to ravage you, promptly thrusting her shaft into you. The feeling of her huge member splitting you open, stretching you out, and filling you is one you can't describe, or even comprehend through the haze of pleasure it inflicts on you. Instead all you can do is moan breathlessly as it drives inward. Suddenly she stops, leaving you in a daze, wondering why she isn't going all the way. You try to ignore it, not giving in to her advances, but soon enough curiosity and need overwhelm you. Against your better judgment, you turn your head just enough to see her, and as the question is on your lips, you see her smirk. You realize you have fallen right into her trap, and gave her all the proof she needs of exactly how much you're enjoying it. 'Oh, don't worry, I won't keep you waiting, my sweet familiar.'";
		WaitLineBreak;
		say "     For one terrifying moment, the drake pulls back, and you're shocked by how much you can viscerally feel your own emptiness in that split second. Even if you haven't given in to the drake, your ass already has, and is begging for more. Fortunately, she keeps her promise, and not a second later she slams her wide hips forward, driving the entirety of her incredible cock into your stretched hole in one motion. The sounds that come out of you are as indecipherable as the pleasure storming through your body just from being completely full of her. However, the drake doesn't give you a moment to adjust, and instead starts to piston in and out of you with incredible force, battering your insides with her massive dick. The sensations and motions are so much, that all your energy and focus is being used to just hold on.";
		say "     Still, you do your best to stay in the moment, and to enjoy it without falling too far. For a time, it even works, and you're able to keep your attention on every second of being fucked by your mistress without it becoming your everything. A thrust in, a thrust out, steady and soothing as much as it is exciting, somehow able to be both at once. The constant bliss she barrages you with begins to take its toll, however, and as she continues to pound into you unrelentingly and unceasingly, you start to slip. Your focus and your thoughts draw inward, until after what seems like an eternity of being taken so powerfully, your entire world is just the sensation of her cock in you, of being owned so thoroughly by her.";
		say "     Eventually the raw sensuality starts to overwhelm you completely, and you start to lose all sense of reason to the tide of pleasure. The building waves reach a peak, and you shudder violently from force of your climax. Halfway through, the drake joins you in release, further amplifying your orgasm by filling you with her essence. For a moment, it feels as if you're being washed away by the sensations flowing through you, but you're called back from that brink by a completely different sensation—the feeling of the drake's scaled arms wrapping around you in a warm embrace. The combination of so many powerful experiences is overwhelming, and as you feel your awareness fade, the last lingering thought is of the soft grasp of your mistress.";
		WaitLineBreak;
		say "     When you come to, you find yourself engulfed entirely in warmth and comfort, but in total darkness. For an instant, panic starts to rise in the back of your mind before you remember your last previous thoughts and squash it. You were in the care of your mistress, and she would keep you safe no matter what. Still, you squirm slightly to try and find out exactly where you are. Once you move just a little bit, it becomes obvious, as your head emerges from under a set of thick covers on what seems to be an exceptionally large bed. Additionally, your mistress herself is alongside you, pressed tightly against you in a way that is both comforting and arousing. Beyond the confines of the bed you see a reasonably sized room, well furnished in a way that easily reminds you of the drake beside you.";
		say "     For a time, you simply relax where you are, content to enjoy being so close to your mistress and in such comfort. You examine the room around you passively, merely drinking in the sights as you wait for the drake to awaken. However, you realize there's something you can take care of yourself while you wait—the rather large endowment currently held tightly against your leg. Grinning, you wiggle your way down further under the covers until you bring yourself face to head with the magnificent shaft belonging to your mistress. Her member is only at partial hardness in her sleeping state, but that's something you can easily fix. You lick the tip eagerly, slowly extended the area you're working on down the shaft, careful not to miss a spot. Once you reach the base, you add your hands to the mix as you start to massage her overly large orbs. Bringing your hands with you this time, you reverse course and carefully work upwards until once more you're at the tip, ready to really get started.";
		say "     It takes barely any time at all for you to slide your lips downward to about the halfway point of her incredible dick, but from there your progress slows somewhat. Even with your large quantities of practice at orally serving your mistress, her shaft is still a challenge to fully get into your throat, even more so at the moment, since it seems to be noticeably larger than before. All the same, you're not going to give up, not when it's for her. Swallowing your reluctance, you work on doing the same to her member, slowly and carefully forcing yourself down it in small increments. After several minutes of concerted effort, you manage to get her entire cock down your throat, and touch your lips against the base. Deep inside you feel a glow of contentment, and resolve to hold your position until the drake awakens. You don't have to wait very long before your mistress rises from her slumber, her arms gripping you even more tightly as she does so. Still partially asleep, she murmurs down at you. 'Oh, what a wonderful familiar you are. I made the right choice with you.'";
		WaitLineBreak;
		say "     Rather than use words, you show your agreement by starting your motion once more, carefully pleasuring the drake while also maintaining eye contact. While you may not have the sorcerous powers she does, what you do to her using your mouth is almost as magical, judging by her expression as you work. Her beautiful eyes reflect her satisfaction with your actions, further cultivating the warm glow of pride within you as you continue to bob up and down her shaft. Eventually you realize she's starting to get close to her own climax, but you're not ready to finish quite yet. Feeling somewhat mischievous, you start to slow down, and shift towards a more gentle and steady rhythm, keeping her hard and feeling good without closing in on her peak. The corners of her lip pull up in a smirk, but she doesn't move to stop you.";
		say "     You continue to tease her for some time, leaving her right on the verge of erupting. At the same time you're able to just enjoy having her resting in your mouth, feeling so close to her without worrying about reaching the end so quickly. Eventually however, you decide to finally give her what she deserves, and you speed up your bobbing again, swallowing her member with growing ease. Your new pace would easily defeat the efforts of a lesser familiar, but you've spent so much time serving your mistress that you have no difficulty. As you keep up your more energetic efforts, the drake's grin morphs from her satisfied smile to one of ecstasy, and you're finally rewarded with the prize of the drake's release.";
		say "     Eagerly you swallow everything she gives you, a prize you treasure deeply because it comes from your mistress—and because she's trained you to be a perfect slut. It takes quite some time to drink down her load, as massive and filling as it is, but eventually you are able to pull back off of her member, with only a tiny spurt landing on your face as you moan in satisfaction. For a moment, that finale is the only thing in your thoughts. Then the drake reaches down to you, pulling you closer in as she basks in the afterglow of your treatment. You fully let her hold on to you, content to be by her side, as her trusty familiar. You know there's nowhere in the world you'd rather be.";
		WaitLineBreak; [Epilogue]
		say "     After you have submitted fully to the drake and become hers, things slowly begin to change. Every time she uses you, which is already a frequent occurrence, your rear grows just a little bit more. By the same token, every time she fucks your growing behind, she gets larger as well. Though you are uncertain about why this happens, you still most certainly enjoy it in action. Eventually your mistress explains that she has perfected her magic, and each time she magnifies your booty, her power gets even stronger, and the stronger her powers get the more she can continue to make you both grow. You simply nod, happy for her breakthrough, before once more servicing her faithfully.";
		say "     Beyond your sight, the drake's influence spreads as her power grows, slowly affecting the world beyond those walls. The more enchanted seed she pumps into your rear, the more the entire city changes to match. Out in the streets, all manner of beings find that their own asses start to get fatter with each passing day, whereas some instead find themselves growing in other areas. The already lewd environment grows lustier, and in many ways less dangerous. The world is bending, things steadily changing to better fit the drake's image, her desires and wants becoming manifest—and whether you know the details or not, you're the one who made it all possible.";
		say "     By now, the formerly lawless city has started to become an orderly civilization once again, the ever-increasing lusts of the well endowed city-dwellers and their big bootied companions shifting them away from competing for scarce resources, and instead gravitating into smaller harem units. Things like that had existed before of course, but now were so much better, with each person with a virile cock becoming the proud owner of several willing sluts, unconsciously falling into the pattern set by your mistress and you. With each stud so well taken care of by their bottom-heavy submissives, there's almost no reason for conflict, not when that time can be spent in ways that are so much more fun for everyone involved.";
		WaitLineBreak;
		say "     In your tower home, you've seen the entire process in action, as the drake becomes larger, more powerful, more majestic with each passing day. Eventually you reach a point where you can't move under your own power, weighed down too heavily by your magically enhanced ass—but the drake is easily able to use her magic to adjust you when she decides it's necessary. Not long after, the day comes when it seems the drake has reached the pinnacle of her strength, and even then you can see no limit to what she can do. Her powers and influence are so great that she has become a goddess, unmatched by any other. The brief glimpses of the outside world you catch in the midst of your constant fuck-sessions with her show you that she is every bit the benevolent goddess you know her to be, letting everyone in the city experience just a fraction of the pleasure you and your mistress feel every day.";
		say "     She later celebrates her status as the newest deity of the city by encouraging her growing ranks of disciples within it to build a massive temple. Through the aid of your mistress, the work of decades becomes an effort of mere months, and the center of her power is graced with a proper homage to her splendor. When it is finally complete, the magic drake then moves you from your former tower home into the decorated halls of her new temple, to be the symbol of her strength and generosity for all her followers. As a further gift in return for their loyalty, she allows all of them to ravish you in your new place of honor. You have no objection, happy to serve more cocks if that's what your mistress wants—besides, what they lack in size compared to her, they can almost make up for in sheer numbers.";
		say "     Your time as the drake's idol is satisfying in any number of ways. Each load her followers deposit in you adds more power to your mistress, and that knowledge brings you more joy than being fucked by itself does. Still, the act of having your rear stuffed by so many people is still worthwhile on its own—even if they aren't as satisfying as your goddess, pleasuring her devotees is still a great way to spend the time when you aren't being railed by her. The best occasions are the ones when your goddess herself graces the temple with her presence, and rails you in front of all her disciples, showing off her sheer size, power, and virility.";
		say "     Fortunately for you, no matter how powerful of a goddess your mistress becomes, no matter how unbelievably huge and hung she is, she always has time for her perfect slutty familiar. In between the times when you're servicing her, all you can think about is the next time she'll fuck you, and she never keeps you waiting for very long. You're in your own personal heaven every time your booty is wrapped around your goddess' divine cock, the only thing that can truly fill you at your incredible size. The warmth she brings inside you is equal parts love and lust, something you're perfectly happy to be drowning in for the rest of your days. Your mistress, your goddess, your queen, and everything else besides—she's the only thing you'll ever need.";
		[I was thinking that would be the submit option, the pc then ending up in the drakes temple as her concubine and species idol. The entire city having turned into magic drakes thanks to the magic she can get the pc to build up from butt stuffin. The bigger the pcs butt, the more magic she gets. That's sorta what I wanted. Submit and she makes a perfect society of lust, size and plenty thanks to the rampant amount of magic around. Everyone gets to live lives of pleasure without need or want with her as their goddess ( all the magic flowing to her will certainly let her achieve that.)]
		decrease score by 25;
		now humanity of Player is 0;
		trigger ending "Magic Dragoness's Servant";
		end the story saying "In the end, the city becomes a paradise for all within it. From the sheer power of your goddess' magic, there is more than enough of everything to go around, letting everyone pursue their own desires and passions, usually involving quite a lot of fucking one way or another. All the stuffing and swallowing and more, all in the magic drake's name, feeds her powers with just as much fervor as the fucking itself. Your mistress has created a flawless utopia, a perfect society of lust and massive sizes—and you can't wait to see that utopia be shared with the rest of the world.";
		now battleground is "void";
		follow the turnpass rule;
	else: [resist path]
		say "     Barely mustering the willpower, you shake your head to her question. As much as you want to submit to her every desire, something is keeping you from giving up on your other tasks. Behind you, you hear a huff from the drake, and can imagine the look of disappointment she must be wearing clearly. 'Well, I suppose you can't be as wise as me, little familiar. But even if you aren't ready yet, that isn't going to stop me from taking what's mine, and you are mine. Don't worry, I'll show you just how wonderful it will be.' You hardly have time to process her words before you feel a titanic slap on your ass, the resting weight leaving you with no doubt that it's the drake's member, magically enhanced to match your massive booty.";
		say "     She slowly pulls herself further back, the tip of her member dragging across your skin, leaving a small trail of her pre as a taste of what's to come. Soon her rod is in place, poised to enter your passageway at her command. You steel yourself, ready to resist the pleasures she's sure to inflict on you, but nothing happens. Not willing to give her any satisfaction, you stay perfectly still, eyes closed, not giving her any acknowledgment. Eventually you hear a hearty chuckle. 'So brave, familiar, but so foolish. No matter how hard you resist, you'll give in to me.' Almost the second she finishes speaking, she thrusts forward, driving her massive shaft deeply into you in a single powerful stroke, driving the breath out of you and breaking your silence with an involuntary moan.";
		WaitLineBreak;
		say "     Wasting no time, the drake starts to drive in and out of you, pounding with more ferocity than you've ever seen from her before. The sense of being filled by her incredible cock is something you can't ignore, no matter how much you try. Even as you resist, holding on to your conviction, the pleasure rises unbidden. Rather than let it overwhelm you completely, you grit your teeth and do the best you can to stay focused on anything other than the ravaging you're getting in your rear. Your current partner makes this difficult, giving several insults as she continues to fuck you unceasingly, her titanic balls slapping against your equally sized cheeks with each slam, each time feeling fuller and larger than before.";
		say "     Individual moments of the encounter start to blur together as the drake keeps going, long after you would have expected her to climax. Minutes go by, drawing closer to hours, until you lose track of time as she goes in and out like a machine. Despite your attempts to avoid it, you come several times, each time being railed right through your own orgasm and wearing your resistance down further with each one. Finally her magically enhanced stamina beings to outlast you, and your eyes start to drift closed from sheer exhaustion. In the brief time before you fall unconscious, you finally feel a change in the motions behind you. The drake pulls out of you all the way, and flips you over. From your new prone position you see her bring her hands to her twitching member, which somehow seems even larger than before, just in time for it to unleash the largest load you have ever seen all over you. The last thing you see as you pass out is nothing but the off-white of her release completely covering your vision.";
		WaitLineBreak; [ball]
		say "     You have no idea how much time passes before you awaken, and your new surroundings don't help the confusion you feel. You're sure the last thing that happened was you being assaulted by the drake, but now you find yourself in some sort of exceptionally grandiose room, full of people. After a moment of looking around in more detail, you realize that everyone there is dressed to the nines, elegant suits and dresses on all their frames. Combined with the fancy decoration of the room itself, the whole place would look right at home in an old romantic movie, if not for the transformed state of the people dancing. However, even more shock comes when you look down, finding your own draconic form enshrouded in the most ostentatious dress of them all, and you blush in embarrassment at what you're wearing. Before you even have a chance to vocalize your surprise, a voice calls out behind you, 'May I have this dance?'";
		say "     When you turn around to respond, you're treated to the latest in the long line of confusing sights. You recognize the drake, outfitted in a fashionable tuxedo, the picture of high society, apart from the incredible bulge in the suit pants. The moment you see her, she extends her hand to you. You try to open your mouth to say no, but find yourself unable to do so. Instead, your hand reaches out of its own accord to take her hand. With a smile far kinder than you've seen on her face before, she begins to lead your body through the steps of an unfamiliar dance, in no time at all becoming the stars of the show. Unused to being treated as the belle of the ball, you are unable to properly formulate any sort of idea of what's going on, instead being overcome with embarrassment, mixed with perhaps a tinge of joy.";
		say "     Drawing you close, and leaning in, the drake whispers into your ear.'And now, onto the main event, my love.' Suddenly, you find yourself being lowered to the floor. Your elegant clothing is no help in getting back up, instead leaving you entangled where you lay. You also see that your outfit gives the drake no pause in pushing your undergarments out of the way, leaving your huge ass exposed completely. Still in total shock, you see her unzip her fancy pants, leaving you once more at the mercy of her huge dragon cock. All around you, the other dancers have stopped what they're doing, and lined up to watch the show, with you as the main entertainment. Your control of your body seems to return, but only when it's too late, as before you can take any action she starts to slowly slide the head of her shaft into you.";
		WaitLineBreak;
		say "     Despite your resistance, barely a moment passes before you're already speared completely on her gargantuan cock. With your colossal ass spread wide over her shaft, you find your face growing hot. Even as the drake starts to thrust back and forth, the knowledge that all these people are watching you get fucked completely and utterly is humiliating, and you close your eyes as tightly as you can in an attempt to shut it all out. No matter how you try and ignore it all, however, the incessant pounding in your rear prevents you from forgetting where you are, each ripple of flesh as her massive orbs collide with your cheeks filling you with more shame.";
		say "     Against your will, you find a glow of pleasure starting to build up within you, slowly growing with each thrust of the draconic dick. You find yourself panting and moaning involuntarily from the sensations and feelings rushing through you, becoming more intense with the sweet nothings the drake starts to whisper into your ear, her soft words a sharp contrast to her energetic pumping. Eventually the whole event starts to come to a head, with your own oncoming climax reaching higher and higher despite your situation. At the same time, from the changing pace of the drake above you, you're almost certain she's about to come as well. Finally, she delivers one single slam, deeper than she's gone into you so far, and you open your eyes as the shock sends you over the edge.";
		say "     Just as she starts to pour her release into you, you finally see what's around you clearly once more. All the other dancers are watching intently, many stroking themselves to the sight of you serving as nothing more than a slut for the drake. Something about that same sight, paired with being filled so thoroughly by her, sets you off as well. Laying helplessly on your back, you climax like the buttslut they think you are. Somehow this climax never seems to end, and you just keep going and going, the drake doing the same, until everything starts to fade away, the final sight being of the drake above you, grinning down.";
		WaitLineBreak; [dinner]
		say "     When your vision returns, you find yourself sitting down. Directly in front of you is a table, that seems to be set for a meal, and is lit by candlelight. It takes a moment to start registering what else is around you after noticing that, and you see a dimly lit interior, littered with other tables just like the one you're at, each host to a couple eating together. It seems you're in some sort of restaurant, almost certainly a fancy and romantic one. As you wonder what you're doing here, you look back to your own table, only to see that the seat opposite you is no longer empty. Instead, the magic drake is seated there, dressed much more casually, but nicely, than her usual wear. She grins when she notices you looking at her. 'Excited for our dinner, my dear?'";
		say "     Uncertain of what exactly is going on at this point, you simply nod your head and watch to see what happens. Almost the moment you do so, a reptilian waitress is at the side of your table, setting down glasses of what you assume is wine, before quickly leaving again without a word. The drake smiles at you again, a bit more gently, and raises her glass towards you. 'And here's to a lovely night, hmm?' Nodding along again, you cautiously return the gesture. From there, the drake spends a time regaling you with stories and tidbits, sometimes dragging a short response from you, as you wait for food to arrive, still somewhat trying to discover why things are so unclear. Despite yourself, you find you're having a good time with the drake, the first occasion you've really spent time with her outside of your brief encounters in the city.";
		say "     As you ponder your scenario, a final story from the drake is interrupted by the waitress returning, bearing only a single plate that she places in front of the drake. You look back up at her face, confused—if this is supposed to be a romantic dinner, why do you not have food? Clearly understanding your question, the drake giggles. 'Oh, don't worry. You'll have plenty to eat, but you might have to work for it just a bit.' Your heart sinks, knowing what she seems to be implying. As if to directly confirm your suspicions, the drake waves a hand, and you find yourself climbing out of the chair, and crawling under the table against your will. Sure enough, the drake's titanic shaft is in the open and on display, your entree for the evening.";
		WaitLineBreak;
		say "     Reluctantly you comply with her wishes, not wanting to face whatever worse punishment she might have in store if you refused. You lean inward, close enough to feel the heat radiating off her fat cock, and start to gently work. You lick up and down near the head, occasionally peppering other oral attentions along the member as you go, progressing further down the entire endowment as you go. Once you reach the bottom, you reverse course, tracing intricate patterns back up towards the tip, before finally getting going completely, and sinking the tip into your mouth. Things grow somewhat hazy as you lavish her huge dick with care, sliding it deep into your throat with skill you're not sure you used to posses, until she eventually unloads an incredible amount of cream into your stomach, seemingly far more easily than before. As you pull off her and work to catch your breath, you suddenly find yourself flipping around and on your hands and knees, with your own oversized booty facing her. You hear her voice from up above the table calling down to you. 'Oh, I hope you enjoyed your dinner, but now it's time for my dessert!'";
		say "     In an instant you have the same shaft you were worshiping placed against your rear entrance, expecting a sudden and forceful penetration. Instead, she simply rests outside your hole, as if waiting for something. A flash of comprehension dawns, as you realize that she wants you to make the first move, and give her a treat. Grumbling internally, you nonetheless start to gently push yourself backwards onto her cock, slowly and carefully welcoming her inside. Bit by bit she stretches you out, under the power of your own limbs, until you are at last resting most of the way down her dick, as far as you can push yourself at this angle. When you reach that point you simply savor the sensation, against your better judgment, while trying not to think about the fact that the only thing hiding you from the room is a thin tablecloth.";
		say "     After that moment of contemplation, you start to rock back and forth, slowly working her in and out of you. Each time she's fully sheathed in you, you shiver in a mix of unwelcome pleasure and humiliation, for just how easily you're letting yourself be controlled by this sorceress. Despite your shame, however, your slams become more and more energetic, unable to help yourself when you have such a huge rod to fill you. Your ever more eager attempts extract the seed from her titanic sack eventually become a success, marked by the drake finally taking action herself and making one final thrust into you, deeper than you reached on your own. Once she hilts into your ass, balls clapping against your cheeks, she releases a torrent of enchanted cum deep into you, and slowly your world fades into a haze of pleasure, the only clear thought as you go under being about how satisfied the drake sounds.";
		WaitLineBreak; [tower]
		say "     This time your return to consciousness is far swifter, as you sit directly upright from where you were apparently laying down. A far cry from the restaurant you were just in, you instead are in a somewhat Spartan room of drab colors, with no doors to be seen and merely a single window, with the only comfortable item in sight being the rather large and fluffy bed you find yourself on. In sharp contrast to the rest of the room, the bed is also primarily a bright and eye catching pink, with the occasional trim or throw pillow in clean whites or softer pinks. Where the room around you looks like a dungeon, if a well furnished one, the bed looks fit for a princess. A look down at yourself once again, and you find yourself dressed in a regal nightgown, a perfect match to the bed. Rather than let that distract you, you look around further, expecting the drake to appear from anywhere.";
		say "     Unlike the previous strange situations you've been in, quite some time passes before the slightest interesting thing happens. You end up passing the time exploring every corner of your prison, learning that you seem to be in the upper room of some sort of tower, and eventually changing out of the sleepwear you had into an ornate dress, because surely it's better than nothing, right? Eventually however, the tedium is broken by a loud roaring sound, strong enough to shake even the stone room you're trapped in. You immediately rush to the window to see what might have caused it, and true to form find the magic drake outside the window. Or in this case, the magic dragon. The sorceress seems to have grown far larger than before, and has taken a much more feral dragon form. The second thing you notice, however, is the endowment on this dragon, a truly massive shaft that manages to somehow be larger still than that of the drake's normal self. The sight of that cock leaves your ass feeling suddenly empty, and you quickly shake your head to try and dismiss thoughts of how it would feel inside you.";
		say "     When you return to looking forward, the dragon grins. The expression is completely different on the more bestial face, but is still perfectly recognizable as the self satisfied grin of the magic drake. With no more warning than what her smile always promises, she dives forward, and grabs you in one huge claw, lifting you into the air. For a moment you flail wildly, your first reaction to try and escape her grasp, but a glance at the ground far below you dissuades you from that course of action. Instead you are left to simply wait for the sorceress to do something, preferably land. Some time later, your silent wish is granted, as she glides downward, finally coming to a rest within a mountainside cave. She carefully drops you onto the floor with her claw, or more specifically a strange bowl-shaped depression in that floor, before looking down at you with clear hunger in her draconic eyes.";
		WaitLineBreak;
		say "     You're frozen in place, unable to even think of resisting something so terrifying, and so impressive. All the same, acting like a deer in the headlights doesn't change the situation, the dragon stalking closer to you, until she looms completely above you. With one claw she gestures for you to turn around, and you feel you have no choice but to comply. Once you're in the position, you feel a familiar tingle in your rear, something you'd almost missed, as it begins to grow. In mere moments you realize that there is far more of this feeling than before, as your jiggly rear rapidly reaches sizes that the drake had never pushed you to before. With a sudden clarity you know exactly why she's taken the form of a massive dragon—to properly break in your equally massive new ass.";
		say "     Soon enough you feel the tip of her huge dragon cock starting to press against your magnified rosebud, slowly spreading you open. Even though this insertion is far larger than before, your huge rear is built to take it in more ways than one, and all you feel is pleasure. Before she gets even halfway in, she pulls back, only to reverse direction again, moving into a series of shorter thrusts in and out, your flesh repeatedly being slapped by her dragon sized orbs. A part of you still resists the sensations, and what they're making you into—but that part is small now, and growing smaller with each thrust. Replacing it are more thoughts of how good this feels, and how much you want her to go even deeper, to fill you completely.";
		say "     Almost the moment you realize that desire, the massive dragon above you starts to fulfill it, changing her pace and thrusting further each time, with longer and faster strokes. Waves of pleasure build as she slams repeatedly into you, rising towards a climax. You start to moan involuntarily, unable to resist vocalizing the sensations you're feeling from the incredible pounding the drake is delivering directly into your huge booty. At the apex of each motion, her hips colliding with your jiggly rear, only adding to your building orgasm. Before you reach that mountain, however, the dragon beats you to it, as one thrust suddenly is interrupted by a veritable flood of her release, pouring into you and radiating a pleasant warmth.";
		WaitLineBreak;
		say "     The feeling of being filled like that is overwhelming, causing you to loose your own load onto the cave floor, something distinctly less impressive than what's being done to you. At the same time, you brace yourself, expecting everything to fade to black again, but nothing seems to change at all. Instead, as the drake finishes completely, she instead starts to thrust once more, clearly ready to work you over even further, and perhaps break you down completely. Somehow, that thought seems far less concerning than it did when this all started, and you almost find yourself anticipating becoming what she wants you to be.";
		say "     From there, she continues to simply rut you over and over, each time dumping more of her enchanted dragon jizz inside you, and making you helplessly lose yourself in the pleasure. The amount she fills you with becomes too much for you to hold, despite your best efforts, and just as much ends up outside of you as inside. This shows you just another way she was prepared for this, as the excess semen starts to build up in the basin you're being fucked in, becoming a pool of her goo, just for you. Though it may have once been something you would have objected to, now you are simply grateful for the gift she has given you, and you savor the sensation of the bath rising up around you as you continue to get railed.";
		say "     Your thoughts are barely coherent at this point, but you know somehow that her experiment with granting you a bigger ass than ever is a resounding success, and you can no longer deny how happy that makes you. You give in to the pleasure of having the draconic sorceress rail you completely and utterly, time fading into a blur of orgasms one after another as she continues to plow you into the ever-growing cum bath in the floor of the cave. Finally, after what seems like an eternity, you pass out, still impaled on her perfect shaft, and soaking in her equally perfect release. Even as you lose consciousness, you know there's a smile on your face.";
		WaitLineBreak; [ball, again]
		say "     Once more you wake up confused and unaware of your location. However, unlike before, the sight is a rather more familiar one. All around you is the fancy ballroom that you were in earlier, though you can't say whether that was moments ago or months ago, with how fuzzy your sense of time has been. Just as before, you stand alone in clothing that is the peak of elegance, paired couples dancing all around you on the floor. Knowing what comes next, you turn around to see the drake smiling and waiting for you, a suit perfectly fitting to show off her assets—particularly the massive bulge in the pants.";
		say "     Rather than wait for the drake, however, you decide to make the first move. You step closer, and instead of starting to dance with her, you get down on your knees and free her oversized member from her clothing, and look at it in awe. Only letting her magnificent shaft distract you from your task for a moment, you start worshiping it with your mouth, preparing for the inevitable assault on your rear that you're already anticipating. As you work, the drake above you grins and sighs in satisfaction. 'I'm glad you've finally learned your place, my familiar. Now that you've accepted that you're my perfect little butt slut, we can really get started.' You shiver in delight at her words, happy to hear your mistress praising you.";
		say "     It only takes a few more moments for you to bring her to her first climax, and you are rewarded with a faceful of her magic spunk, with more to spare. You're totally soaked in the stuff, your clothes ruined, as you're kneeling in complete sight of the whole room. Not long ago you would have been mortified by the attention and position, but now while you still feel some shame, it only makes you happier and more excited for what comes next. Without any prompting from your mistress, you quickly turn around and hike up your dress, white stains and all, giving her free access to your opening. You even shake it enticingly, unable to sit still while you await your reward.";
		WaitLineBreak;
		say "     You have no warning this time before the drake starts to thrust in and rail you with her huge shaft, but you didn't really need it anyway. There's no pain at all, only steadily growing pleasure. This is what you've been waiting for, deep down, and finally getting it feels like an affirmation of everything you've dreamed. With each thrust in, with each forceful slap of her balls against your cushy cheeks, you grow more certain that this is your purpose. Your whole being is to be a perfect receptacle for the drake to use, for her lusts and her magic and anything else she could ever need. In no time at all your swirling thoughts bring you to your own peak much faster than usual, but rather than clear your pent up energy, your need only grows.";
		say "     As her cock hammers into you repeatedly, the forceful thrusts sending waves across your juicy behind, you lose track of your surroundings completely. All you can think about is your ass, and your mistress. Nothing else matters except the feeling she's giving you of being spread around a monstrously large cock, like you were always meant to be. Again, you come from the incredible pleasure, and focus your attention once again on your mistress. Above you she whispers encouragements and praises to you, about how well you're taking her cock, how perfect you've become, and more besides. From the barrage of feelings, you start to lose what little focus you have left, your world dissolving into bliss, and your vision going dark again.";
		WaitLineBreak; [reality]
		say "     This time when you awaken you're somehow sure that what you're seeing is real. Around you is the interior of what you somehow know is a tower room, filled with various magical items, clearly belonging to the drake. And as for you, you're already exactly where you belong, impaled on the magic drake's shaft, held completely in the air as she thrusts upwards into you. From your position in her arms, you can see out the window the city below, knowing instinctively that it belongs to your mistress, just as you do. You moan and writhe with each of her thrusts, already facing overwhelming sensations, magnified further by a growing tingle of magic along your entire body.";
		say "     Anyone looking at you at the moment would see that both you and the drake are covered in a crackling aura of magic, slowly increasing the both of you in size—with your ass and her entire package both growing far more than the rest. The endless reaming at the hands of the drake continues to increase the pleasure you feel in each moment, as her power grows to match her size. Soon you can barely think, so powerful is the pleasure she continues to gift you with via her ever larger cock. Finally she reaches her climax and paints your insides with a truly incredible amount of cum, courtesy of her equally large balls. Both of you cry out in pleasure at the same time, the magic swirling and rushing around the pair of you all being drawn into your mistress, giving her an even greater boost. With her newfound power, few things are beyond her reach, but you are satisfied with being exactly where you are, forever.";
		decrease score by 25;
		now humanity of Player is 0;
		trigger ending "Magic Dragoness's Familiar";
		end the story saying "The city has changed, now a feudal land full of strife. Massively endowed draconic warlords, formed in the drake's image, each have seized their own territory, ruling as they see fit. For most of them, that involves taking what they want, when they want. Usually this means that those living under the control of one of these warlords serve as toys for them to fuck at their leisure. Even if they were to escape, they'd simply end up servicing a different draconic ruler instead, leading to a tenuous sort of piece. Those outside the city feel safe for now, but it's only a matter of time before the drake ventures out and converts them as well, conquering more and more of the world with her size and magic power. As for you, you spend all of eternity as the drake's familiar and toy, exactly as you wish.";
		now battleground is "void";
		follow the turnpass rule;

Section 4 - Events and Quest

[Gilded Staff is used to open dialogue with magic drake, access a quest, and unlock the vixen kunoichi]
Table of Game Objects (continued)
name	desc	weight	object
"gilded staff"	"A very large and very golden replica cock that bears a striking resemblance to one belonging to the magic drake."	3	gilded staff

gilded staff is a grab object. It is not temporary.

instead of sniffing gilded staff:
	say "Despite the metallic appearance, the item only has faint traces of a mysterious enchanting scent.";

Usedesc of gilded staff is "[mdrakecontact]";

Table of WalkInEvents (continued)
Priority	Name	EventObject	EventConditions	EventRoom	LastEncounterTurn	CoolDownTurns	EncounterPercentage
1	"Drake Visit"	Drake Visit	"[EventConditions_DrakeVisit]"	Grey Abbey Library	2500	2	100

to say EventConditions_DrakeVisit:
	if (mdasslevel > 3 and gilded staff is not owned):
		now CurrentWalkinEvent_ConditionsMet is true;

Table of GameEventIDs (continued)
Object	Name
Drake Visit	"Drake Visit"

Drake Visit is a situation.
ResolveFunction of Drake Visit is "[ResolveEvent Drake Visit]".
The level of Drake Visit is 0.
Sarea of Drake Visit is "Nowhere".

[Drake Visit - gain gilded staff and leads to more content]
to say ResolveEvent Drake Visit:
	say "     It all began as an otherwise normal day at the Grey Abbey Library. You had been minding your own business for the most part, taking a break from the hectic adventures of the city around you, and simply relaxing in your own body. Suddenly, however, this peace is disrupted when a loud crackling sound echoes from somewhere near the front entrance. Startled, you turn to face the entrance, your not-insignificant rear armament swinging wide enough to smack the side of a shelf and knock several items loose. You find more important things occupy your attention than cleaning up after your momentary distract, however, as you see the likely source of the unusual sound – the magic drake herself, at your own front door.";
	say "     Seeing the one responsible for a specific part of your own transformation right here in the library, so far away from her usual haunts, is enough to make you speechless. Though you can't see it yourself, you suspect your own expression is similarly in a state of disbelief. The drake however is seemingly unbothered, or perhaps even somewhat pleased, by your reaction to her presence. Her relatively calm face shifts into a wide grin, rife with the smug aura you so associate with her, and she strides towards you. 'Oh, so this is where my familiar has been living, hmm? Not a bad little home, really, a fine place for my toy to stay when away from me.' Before you have time to truly process that, she reaches your position and throws a scaled arm around your shoulder, giving you a slight squeeze. 'Well, aren't you going to give me a tour?' Still slightly in a state of emotional disarray, and further distracted by the closeness of the overpowering figure, you nod dumbly, and start walking.";
	WaitLineBreak;
	say "     You've barely started to show off the area, still in the main hall of the library, when the drake shifts her stance significantly. She releases her grip on your shoulder, and instead drops her hand much lower, grasping one of your emphatically large cheeks in her hand, and squeezing slightly. You give out a sound halfway between a moan and a yelp at the sudden sensation, but unwilling to give her the satisfaction of stopping completely. Instead you try your best to soldier on with your impromptu walkabout, and attempt to ignore the sultry hand on your rear.";
	say "     The subtle battle of wills between you seems to escalate as you go, with lustful words whispered in your ear even as her hand claws suggestively at your supple flesh, slowly feeding the flames of arousal within you. Soon enough the sorceress tires of the surface level acts, and instead starts to delve deeper – specifically, deeper into you. Her hand slides just a bit further over, and the tip of a finger presses against your rear entrance for a short moment, a pause that contains more tension than the entire conversation so far.";
	say "     It seems that the drake is waiting for some sort of cue from you, and intentionally or not you end up giving it to her as you let out an involuntary moan of anticipation. With that, she applies just the faintest hint of pressure, and your well trained hole accepts her easily. You let out a pleasured gasp, and in response the sorceress practically purrs into your ear. 'I see you still know how to respond to your mistress, hmm? Good, very good. You're doing so well that I think I'll have to give you a little gift when we're done here.'";
	WaitLineBreak;
	say "     With your defenses breached, you find yourself unable to do more than simply melt into her grasp, showing her around less than being paraded around by the drake, your submission plain to see. Soon enough the thin veneer of a tour starts to fall apart, and the sorceress pulls you towards a corner to finish what she started, and works you even harder with her fingers. She pushes you firmly against a wall with one hand as she takes control of you, intensifying her ministrations until finally you hit your peak, a seemingly infinite stream of moans and groans flowing out of you. With a satisfied smile on her face, the sorceress pulls back just enough to give you breathing room, and looks you over appraisingly.";
	say "     'Well, that certainly was an enjoyable visit, hmm? We'll have to do this again sometime.' Pausing, she reaches into her dress and pulls out a glittering phallic object that could never have fit underneath. She extends her hand, holding the item towards you, and you can see it looks rather like a dildo, a particularly large one with a striking resemblance to the drake's own endowment. 'A gift for my familiar as promised.' You put out a hand in return, still trembling from the experience you just went through, and take it as offered.";
	say "     'The next time you're ready to have a visit from your mistress, or even just wish to speak with me further, just use it.' She smirks at your still slightly bewildered expression. 'Something tells me you won't have any trouble understanding how it's used, isn't that right familiar?' With a loud chuckle, she steps away from you completely, and strolls purposefully back out of the library, leaving you still dazed and very aroused – something you're familiar with when it comes to the sorceress.";
	CreatureSexAftermath "Player" receives "AssDildoFuck" from "Magic Drake";
	ItemGain gilded staff by 1;
	now Drake Visit is resolved;

to say mdrakecontact:
	if mdrakequest is 0: [first time scene]
		say "     You eagerly take hold of the gift that the magic drake left with you, committed to getting in touch with the sorceress again, though you're so far uncertain how exactly the two things are supposed to relate. All the same, as she intimated when she left this with you, you're fairly certain you know exactly how it's intended to be used, and you're equally certain you can handle it. The faux member may be of an exceptionally large size, but it's still less fearsome than the drake's own real shaft. You were able to fit that into your equally large backside in previous dealings with her, so you're not expecting any trouble when it comes to this replica.";
		say "     It doesn't take you long to brace the large item on the ground, in preparation for proper use. It has enough heft to stand on its own, which will make your own efforts significantly easier. You decide not to beat around the figurative bush with yourself any longer than necessary, and spend a few moments getting yourself prepared for some personal attention. Once you've done so, you get into position above the metallic shaft, your massive ass hanging above it in a way that would be menacing for a living thing, and mentally brace yourself. Finally, with a satisfying thwack you descend, taking the counterfeit cock with ease.";
		WaitLineBreak;
		say "     The experience is very different from being matched with a living lover, but the two activities are still clearly close cousins, and the feeling of your ass being speared on a sizable shaft is deeply fulfilling regardless. Your practiced skill lets you quickly start working yourself up and down the gilded staff, energetically riding it with a fervor that only can arise from a deep seated enjoyment. Without a partner to truly please, however, you find your tactics quickly shifting to match, putting more effort into lining yourself just right to hit your own buttons and focus towards climbing your own peak. Soon enough your efforts rise to a growing climax, and you slam yourself down more forcefully, triggering the orgasm yourself. You barely have a moment to bask in the afterglow when you're reminded of the original purpose to this exercise, and you find a hazy image of the magic drake appearing before you.";
		say "     'So nice to see you again, my familiar. I can see that you're enjoying the little gift I left for you, hmm?' She chuckles good-naturedly at you, before focusing her gaze once again. 'It's also very nice to know you're willing to be so cooperative with me. I think you'll find that we both have much more fun with our arrangement when you have a positive attitude, and work with me. In fact, I have the perfect way to prove just how wonderful it can be to play along, you can think of it as another little gift. There's another... associate of mine that you haven't met before, and I think you'll enjoy meeting them. Of course, whether the gift is for you, or for her, well that will be up to you my familiar. Do have fun, won't you?' A sharp reptilian grin that combines sheer joy with just a hint of a commanding aura crosses her face. 'Still, don't hesitate to stay in touch, I'd be happy to answer a few questions for you now that you're being such a willing familiar. Perhaps we can even work on some more advanced training!' A familiar laugh echoes from the image of the drake, her voice as clear as if she were standing in front of you in person, and then the image fades out, leaving you alone with the gilded gift.";
		now mdrakequest is 1;
		repeat with y running from 1 to number of filled rows in Table of Random Critters:
			choose row y in Table of Random Critters;
			if Name entry is "Vixen Kunoichi":
				now MonsterID is y;
				break;
		now area entry is "Outside"; [enables vixen kunoichi enemy]
		now Dreamy Twins is active;
		now Big Ass Library is active;
		now Wallstuck is active;
	else: [normal conversation menu]
		say "What do you want to ask the magic drake about?";
		now sextablerun is 0;
		blank out the whole of table of fucking options;
		[]
		choose a blank row in table of fucking options;
		now title entry is "Chitchat";
		now sortorder entry is 1;
		now description entry is "Engage in some casual conversation.";
		[]
		choose a blank row in table of fucking options;
		now title entry is "Minions";
		now sortorder entry is 2;
		now description entry is "";
		[]
		if mdrakequest is 1:
			choose a blank row in table of fucking options;
			now title entry is "Plans";
			now sortorder entry is 3;
			now description entry is "Talk about what comes to mind";
		[]
		sort the table of fucking options in sortorder order;
		repeat with y running from 1 to number of filled rows in table of fucking options:
			choose row y from the table of fucking options;
			say "[link][y] - [title entry][as][y][end link][line break]";
		say "[link]0 - Nevermind[as]0[end link][line break]";
		while sextablerun is 0:
			say "Pick the corresponding number> [run paragraph on]";
			get a number;
			if calcnumber > 0 and calcnumber <= the number of filled rows in table of fucking options:
				now current menu selection is calcnumber;
				choose row calcnumber in table of fucking options;
				say "[title entry]: [description entry]?";
				if Player consents:
					let nam be title entry;
					now sextablerun is 1;
					if (nam is "Chitchat"):
						say "[MagicDrakeTalk1]";
					else if (nam is "Minions"):
						say "[MagicDrakeTalk2]";
					else if (nam is "Plans"):
						say "[MagicDrakeTalk3]";
					wait for any key;
			else if calcnumber is 0:
				now sextablerun is 1;
				say "     You step back from the anthro coyote, shaking your head slightly as [SubjectPro of Diego] gives a questioning look.";
				wait for any key;
			else:
				say "Invalid Option. Pick between 1 and [the number of filled rows in the table of fucking options].";
		clear the screen and hyperlink list;

to say MagicDrakeTalk1: [casual conversation]
	say "     You decide to speak to the magic drake about whatever comes to mind, and simply get to know her a bit better. When you ask her about herself, she looks somewhat surprised by the question. 'Well I think by now you've learned some of the most important things about me already, or else we wouldn't have made it this far, my familiar. I am a firm believer that bigger is better in all things, for one, and that much I know you've seen first hand.' A small smirk accompanies that statement, as she looks at your rear. 'Beyond that, however, I am particularly interested in personal enjoyment, and have long been a student of mystic arts for that very reason. Oh, and of course I am quite the fan of playing around with a lovely thing like my perfect familiar.' A final smile directed towards you seems to mark the end of this particular line of conversation, at least for now.";

to say MagicDrakeTalk2: [ask about her minions and associates]
	say "     'Ah, so you're wondering about the various creatures that I work with in the city, hmm? Well, there are rather a few of them by now, so I suppose it would be worthwhile to keep this rather brief. For now, I'll simply go over a single one, and you can ask again another time for more information, my familiar. Don't worry, I don't bite unless you ask.' The drake smiles, before her expression turns somewhat more ponderous for a moment, perhaps collecting her thoughts before responding further.";
	if (a random chance of 1 in 3 succeeds): [koballoons]
		say "     'Well, I must say that the koballoons were a particularly interesting occurrence. Before I was quite as skilled as I am now, I went through many phases of practice and experimentation to truly understand power, and one such instance led to them. They were originally a far more tame variety of creature, but they were affected by chance, which gave them some considerable changes to their sizes and skills alike. We aren't exactly close companions, but they acknowledge that I've helped them in some way, and are willing to come if I ask, though I do so rarely.'";
	else if (a random chance of 1 in 2 succeeds): [dino pack]
		say "     'In their own way, that dinosaur pack is fairly straightforward. They used to be more normal, at least as much as that really means, but they were very ambitious. They dreamed big, and one thing I happen to like is big. They made a deal with me, and I was able to give them the physical features they so dearly wanted, and in exchange they would work for me when I had need of them. I still leave them to their own devices often enough, let them hunt what prey they choose, but when I see an opportunity best solved by some well endowed hunters, I can simply call in one of many favors.'";
	else: [vixen kunoichi - add variance based on lust level]
		say "     'Ah, now that is a fascinating one. She was already a powerful warrior when I first discovered her, but it was such a shame how sheltered and innocent she was. I decided that she could be having so much more fun, and took the liberty of giving her a magnificent shaft to let her truly experience the potential of a little lusty fun. After that, it seemed only fair to bring her here, so that she'd really have a chance to be in a place fitting her new urges. The fact that she can double as a reward for my trusty familiar is just another bonus, really, so enjoy yourself.";
		repeat with y running from 1 to number of filled rows in Table of Random Critters:
			choose row y in Table of Random Critters;
			if Name entry is "Vixen Kunoichi":
				now MonsterID is y;
				break;
		if area entry is "Nowhere":
			now area entry is "Outside"; [catches version conflicts for Vixen activation]

to say MagicDrakeTalk3: [ask about the drake's plans - leads to quest eventually]
	say "     'So you're curious about what it is I'm doing here, then. Well, that's a fair enough concern coming from my familiar. I have no particular ill will towards the people here, of course, and in fact I think this place is also marvelously interesting. This city is full of so much potential, and somebody might as well make use of it, hmm? Better me than someone else, I say. That's why I've been planning ways to combine my favorite activities, getting more powerful and having fun with sexy things like you. You certainly seem inquisitive enough that I'm sure you'll stumble into one of my projects or another, if I don't make you a project yourself, wouldn't that be fun?' She looks at you appraisingly, but carries on with only a moment's delay. 'Perhaps I'll even come up with a special task just for you, if you're interested in helping me out.'";

Table of GameEventIDs (continued)
Object	Name
Dreamy Twins	"Dreamy Twins"

Dreamy Twins is a dreamevent.
ResolveFunction of Dreamy Twins is "[DreamEvent Dreamy Twins]".
Sarea of Dreamy Twins is "Dreamland".
Dreamy Twins is inactive.

to say DreamEvent Dreamy Twins:
	say "     The events that follow are almost incomprehensible, a strange mishmash of previous encounters with the sorceress and the strange logic of a dream. Speaking in some sort of unknown language, the drake makes a demand of you, and when you fail to respond she springs into an attack on you, and a pitched battle begins. For a moment you hold the advantage over the figment drake, but you are instead surprised by a second drake behind you grabbing a hold of your impressive rear with both hands, and giving a squeeze. The shock is enough to distract you, and the first drake rushes forward, and smothers you with her cleavage. Surrounded by the pair, your own dream-addled mind concludes that you've lost fair and square, and gives in.";
	say "     Things become even less clear following the phantasmal battle, and you lose yourself in a flurry of affection from both directions. Each side of you is suffering the sensations provided by the sorceress as she gropes, tweaks, teases, and generally causes a sense of building tension. Soon you realize that it's not only your own pleasure that's about to matter, as you find yourself sandwiched between a pair of mighty shafts, one resting between your cheeks and up against your back, while the other is pressed against your front, the tip going nearly up to your chest. No worry passes through your mind in the dream, and instead all you feel is desire.";
	WaitLineBreak;
	say "     You squirm and writhe between the two, caught up in the simmering miasma of lust from the three of you. Taking control of the situation, the magic drake before you gently grasps your chin before giving you a passionate kiss. You melt into the embrace, and cease your own struggling entirely, enjoying the closeness. Before the duplicate has a chance to feel left out, the drake pulls back and uses her grip on you to pull you down to your hands and knees, before bringing her oversized member directly in front of your face, with the intimidating head mere inches from your nose. Not to be outdone, the one behind you takes advantage of the new position to step back and carefully line her own throbbing member up with your passage. Something about these events seems slightly strange, but your mind is too distracted to process anything other than your own burning lust.";
	say "     The twin drakes seem to have decided in unison what to do next, as mere moments later they both thrust forward at once, their twin mammoth sized cocks driving deeply into both your mouth and ass at the same instant. The raw force of being hammered from both sides starts all your nerves firing at once, a storm of pleasure unfurling inside you that seems impossible to withstand. The sheer size sawing in and out of you is enough to press all your buttons at once, in ways both figurative and literal, and all you can do is simply endure being used as a cocksleeve by the pair of well hung sorceresses. Your mind is so lost in the sensations that you almost don't notice when they start to speed up, only managing to focus outside yourself when their thrusts gain enough force that their heavy balls start colliding with you on the apex of each thrust, adding another dose of tantalizing sensation to the heady mix assaulting you.";
	WaitLineBreak;
	say "     The pleasure overwhelming you is clearly not limited only to yourself, as the twin drakes thrust into you even more deeply, and without warning unleash a torrent of enchanted seed into you, filling you from both ends. It seems to go on for an eternity, rushing into you and making you feel both full and fulfilled. Each massive spurt sending another jolt of pleasure down your spine, until you struggle to process the events as anything more than a blur. At some point it comes to a stop, and the pair pull out of you, somehow with only faint splatters and traces of their release leaking out of you – the rest is still stuffed deep inside, leaving you bloated enough to look even more like a toy than before.";
	say "     Despite the magnitude of the release on all sides, however, it seems that the two aren't quite finished with you yet. With a strength that seems surprising on her voluptuous frame, one of the two picks you up completely, and holds you off the ground with ease. Her twin moves into position on the opposite side. Though still sluggish from the overwhelming orgasms, your brain moves just enough for the position you're in to click – they're holding you up over their still hard shafts, but this time both massive cocks are aimed at a single hole.";
	WaitLineBreak;
	say "     Before you even have time to worry, they bring you down with what seems like an unimaginable level of force. Your well trained passage seems to stretch to meet them with almost no difficulty at all, the fantasy too much for your mind to realize why, and in an instant your ass is filled with more meat than a steakhouse. You let out a breathless gasp, and time seems almost frozen for a moment, an endless limbo between the act and the sensation to follow. Then, all at once it hits you. You start wailing and moaning, unable to avoid vocalizing your overwhelming pleasure as the two start to hammer into you in an irregular rhythm that makes it impossible to get used to.";
	say "     They seem able to hit every sensitive spot inside you with more force than you've ever experienced, skewering you with ease repeatedly. The two are grunting and moaning in pleasure of their own as they continue to rail you beyond belief, but even that is drowned out by the sheer wellspring of lust arising from your core. A thick miasma of pleasure suffuses your every experience, until it reaches an unimaginable peak in response. You cry out in such pleasure that you would worry about the state of your throat, were your mind in better position to consider any form of consequence. A  pair of twinned voices howl out in matching pleasure alongside you, and in that single instant the dam breaks. Everything goes white both inside and out, a tide of magical seed so intense that for a single brief moment you felt like you could see all of reality – and then you wake up. The dream starts to fade in the light of day, leaving you with only a pleasant memory and an intense arousal as mementos.";
	now Resolution of Dreamy Twins is 1;
	now Dreamy Twins is resolved;

Table of GameEventIDs (continued)
Object	Name
Dreamy Twinning	"Dreamy Twinning"

Dreamy Twinning is a dreamevent.
ResolveFunction of Dreamy Twinning is "[DreamEvent Dreamy Twinning]".
Sarea of Dreamy Twinning is "Dreamland".
Prereq1 of Dreamy Twinning is Dreamy Twins.
Prereq1Resolution of Dreamy Twinning is {1}.

to say DreamEvent Dreamy Twinning:
	say "     As you descend into slumber once again, you find yourself entering a somewhat familiar situation, a previously forgotten dream rising into your unconscious mind. The area around you is indistinct and hazy, but in stark contrast the pair of nigh identical sorceresses before you are as clear as day. Each one is already visibly awaiting you, evidenced by their enchanted endowments standing at full attention. Without even moving, you suddenly find yourself on your knees, and within close range of the twins. Unconcerned, you lean forward and prepare to serve. You initiate events by going for the drake on your left, and start warming her up with a series of well placed kisses to her mighty sack, breaking up the chain by occasionally running your tongue along the barely scaled flesh. Eagerly, you continue the oral affection for a short time, until you finally pull your focus back with just enough presence of mind to switch your focus back to the drake on your right, giving her a repeat performance as you start to lose yourself completely in the highly charged foreplay.";
	say "     Several minutes seem to pass like this, though you yourself are incapable of truly telling how much time you spend so carefully scrutinizing their balls with your mouth. Eventually, it seems they're ready to move on to another stage, as the pair grab you and gently adjust your focus upwards, and without the slightest objection you refocus your vigorous attentions on the twin pillars before you. The massive shafts are equally as enthralling as the rest of the twins, keeping you eager and on task with no urging from the mysterious pair. Soon enough, however, your appetites grow beyond the simple foreplay of the moment.";
	WaitLineBreak;
	say "     Mere moments later, you use your hands to firmly grab hold of each shaft, and bring the appealing tips down to your own level, until you're staring them both head on at once. Your hands can't get more than a fraction of the way around, but that doesn't stop you from slowly stroking along the surface of both members as you consider which to use for practicing your sword swallowing skills first. To your surprise, however, it seems that the pair have another plan for you, as they gently remove your grasp, leaving you surprised. Instead, once they've made a bit more room each of the twin drakes turns away from you entirely.";
	say "     In that single instant, everything seems to shift significantly. Before, you were unaware of your surroundings, everything out of focus and unimportant in comparison to the twin visions of the sorceress before you. Now however your environment seems to snap into place, the exact nature of the place uncertain, but the one thing you do know with surety is that this is some manner of temple, a place of worship – and you know with equal certainty what it is you are here to worship. While you were distracted with the changing scenario around you, the twins have pressed in closely once again, this time not to keep you near their shafts, but instead you are presented with a spectacularly close up view of their own wobbling back ends.";
	say "     You're only given a moment to process the magnificent sight in front of you before the twins back up further, pressing your face up against their cheeks and surrounding you with endless ass flesh. Resolutely, you prepare to fulfill your new duty, and use every tool at your disposal to bring pleasure to those drake twins from this new direction. You put all your energy into a flurry of kissing, licking, groping, and stroking, all leading to the same goal. At the same time that you project that pleasure outwards to the drakes, you can feel a powerful sensation welling up inside of you, something more than simple pleasure, though you aren't certain what it is yet.";
	WaitLineBreak;
	say "     As you're worshiping the pair, the strange feeling seems to migrate throughout your body, pulsing in time with your actions. It feels as if it's concentrating, at least for the moment, in your limbs, leaving them overcome with the mysterious tingling sensation. You return your focus to the all important task you're accomplishing, and lavish a kiss directly on one of the rear passages before you, relishing the pleasured exclamations from the sorceress above. At the same time the feeling in your body seems to reach a momentary fever pitch, and involuntarily you look down towards your own lower body.";
	say "     Rather than the look they had one sported, your extremities have taken on a scaled appearance that you have seen in exactly two other places, each one of those places perched below the callipygian rears you're currently offering service to. You find yourself unconcerned with the sudden transformation, and instead return the entirety of your focus to the feast before you. Predictably, the strange process seems to continue onward, your continued worship constantly being reflected back in your own body, the pulsing energy building further alongside growing lust in your changing form.";
	say "     Eventually, it all comes to a final point. The waves of change have progressed until it seems that the only thing left of your own body is your head. Even that, you feel is on the cusp of changing, but you do not allow this to distract you from your task, and you dive further into the plush rears that are your entire world at the moment. Suddenly an ultimate sensation shoots through your body, and even as your head twists into it's new form, you push forward for the final end goal of your actions. Your oral worship of the drake twins comes to an ultimate conclusion, and your transformed tongue is able to cross the final barrier, finally bringing each one to a climax with a resounding moan. Your last thought is of the fact that now this strange temple is the home to three magic drakes rather than two, before you slowly start to slip away from the land of dreams, and once more return to wakefulness.";

Table of GameEventIDs (continued)
Object	Name
Big Ass Library	"Big Ass Library"

Big Ass Library is a dreamevent.
ResolveFunction of Big Ass Library is "[DreamEvent Big Ass Library]".
Sarea of Big Ass Library is "Dreamland".
Big Ass Library is inactive.

to say DreamEvent Big Ass Library:
	say "     As you tumble gently into sleep, your thoughts drift into lands far beyond reality, softly enveloped in the fog of dream. As lucidity slips away, you find yourself in the almost-familiar halls of the library, though it all seems larger than life in some way, with rows of books stretching on towards forever. Though your mind is clouded, you have a certainty that you're looking for something amidst the shelves, and so without prompting you start to walk. As you travel, you note that something seems just slightly off, though you can't put your finger on it – not with your surroundings, but with yourself. The act of walking itself seems somehow more difficult, and perhaps you're moving in a different way, but there's just no easy way for you to figure it out without a way to examine yourself from afar.";
	say "     You're soon given a hint, however, when you turn a corner in the endless maze of books. Somehow you've managed to bump into a shelf, setting it rocking dangerously from the force of the accidental collision. In and of itself, this would not be strange, but you were so sure you were nowhere near the piece of furniture. An uneasy certainty strikes you, and you feel as if this is undoubtedly tied to the strange feeling you head. You're self aware enough to seek answers yourself when mystified, however, and you decide to head to the bathroom and take advantage of the mirrors.";
	WaitLineBreak;
	say "     A sneaking suspicion starts to worm its way into your thoughts as you traverse the labyrinthine library, as you seem to be unable to stop yourself from causing chaos at each turn. Navigating a simple corner leads to sending a whole stack of books plummeting to the floor, while slipping between shelves is as liable to rattle them as it is to help you find a shortcut. Eventually you're able to find the way to your destination, and even before you get a good look in the mirror, more evidence comes to light – namely in the form of you finding yourself stuck in the doorway, unable to pass through effectively. Fortunately, even from this angle you can see clearly now what the issue is, supported by the sheer size of the problem. The problem, in this instance, being your own rear end.";
	say "     You strain yourself to try and escape your predicament, and while it keeps you contained for a moment, you're able to just barely force yourself backwards, free from the confines of the door frame. Now, however, you have to face the reality that the reason you were a walking source of collateral damage is because somehow your ass has graduated past any reasonable measure of size. Rather than a mere butt, you are instead equipped with a truly mighty ass, badonkadonk, or perhaps caboose. Regardless of how you think of it, you need to deal with the practical concerns such an endowment leaves you with, particularly how you're going to get any further with the size involved.";
	WaitLineBreak;
	say "     A tingling sensation interrupts your thought process, and your half baked plans are also rendered moot, as a wave sensation sweeps through you, and your already formidable ass grows alongside it. Before it was large enough to make doorways difficult, but now you suspect that open hallways may be a new challenge. Even trying to turn around and examine the change is enough to cause a collision with the wall next to you, revealing yet another facet of your growing issues: the sensitivity. Whatever the reason for your inexplicable growth, your tender flesh feels pleasures even more strongly than before, even bumping into a wall now carrying the erotic charge of a well executed slap on the rear. You bite your lip in a mix of anticipation and dread, preparing face the sensations that await as you move.";
	say "     Those predictions prove rather accurate, as each step you take causes your rear to wobble precipitously, and no matter how carefully you try and avoid your surroundings, the energetic motions of your flesh cause no end of physical contact. A step slightly too far to the left is all it takes to accidentally crash your huge bottom into a table, sending its contents crashing further into you. This sends a jolt of pleasure through you that you can only barely withstand, as you resolve to go even more slowly to avoid a repeat incident. This, however, proves to be a mistake as well. The instances of accidental collision are rarer at these speeds, to be certain, but what you didn't anticipate was the building lust already within you. The long, careful strides leave you waiting idly for an agonizing amount of relative time, quickly reaching a limit to your own ability to concentrate and endure the distractions.";
	WaitLineBreak;
	say "     Finally, you reach a point where it becomes simply too much. You can't ignore the siren song of your own booty any longer, and rather than trek through the building, you plant yourself firmly on the ground, the mere act of sitting bringing enough force to send another shockwave of pleasure through your body. Whimpering in true anticipation, you can't help but start to claw at the huge target hooked to you, the sensitive cheeks well on their way to providing more pleasure than you can experience through any other part of yourself. This further inflames your own lusts, and to your equal elation, and the terror of a small voice you're steadily ignoring, your rear starts to grow even further alongside your treatment. It's too late for you know, and you're ensnared in your own trap, unable to escape the whirling pool of sensation, falling further into the depravity of simply worshiping your own rear in isolation, bringing yourself to a peak over and over again.";
	say "     With a gasp, you find yourself once more where you were before you entered what you now realize was simply a very vivid dream. Your own true rear may be rather prodigious, but you are far from the depraved heights of your dream self, at least at the moment. Still, there's something strangely compelling about the fantasy, and you can't quite bring yourself to dismiss it out of hand. Surprisingly well rested, you prepare to get back on with your day – but the visions of yourself enslaved to your own titanic ass remain.";

Table of GameEventIDs (continued)
Object	Name
Wallstuck	"Wallstuck"

Wallstuck is a situation.
ResolveFunction of Wallstuck is "[ResolveEvent Wallstuck]".
The level of Wallstuck is 5.
Sarea of Wallstuck is "Outside".
Wallstuck is inactive.

to say ResolveEvent Wallstuck:
	say "     As you are exploring the run down city streets, you take passing note of a hole that's been smashed through the side of a nearby building, at first mere idle curiosity. As your walking leads you closer, however, you catch a glimpse of the room beyond, and while the exact contents are unclear, there seems to be a great many containers stacked inside. Your attention officially grabbed, you examine the building more closely and notice the faded sign above the door you had almost missed, marking this as a small corner market, and meaning that there could be valuable supplies inside the room.";
	say "[bold type]Do you try and squeeze through the hole and investigate the interior?[roman type][line break]";
	if Player consents:
		say "     You decide that going for the supplies is worth the chance that there may be something or someone unpleasant on the other side of the wall. Assured of your own choice, you examine the wall far more closely. The gap is not quite at the ground level, but is low enough that attempting to wiggle through will bring you fairly low to the ground as well. You get on your hands and knees in front of the gap, and stick your head through to glimpse the far side. You scan from side to side, and find you were fully correct that there were a large number of containers on the far side. Several are clearly already opened, or even visibly empty, but there are others that still seem like they may hold secrets within.";
		say "     Satisfied, you start to clamber in through the hole, going after the hidden resources. However, you find yourself running into a snag in a very literal sense, and seem to catch partially in the hole. You grimace, suspecting that your rather large derriere may be to blame, but surely you're only barely too large – you'll fit through just fine with a bit of effort to squeeze through. You grip the inside edge of the wall and heave, attempting to pass entirely through the wall, and for a moment you make progress, sliding further forward, but then the resistance grows too much. For a few more moments you try your best to pull yourself forward, but can't seem to advance another inch, until you eventually give it up as a bad job. You find yourself once more at a standstill, your well endowed ass clearly too much for the gap you tried to use.";
		say "     The truly chilling realization, however, only comes when you attempt to reverse course. With all the force you can muster you push yourself the opposite direction, but find yourself coming up short – in your efforts to push forward, you've managed to wedge your ass securely in the gap, and the combined strength of your body seems insufficient to move you in either direction. For a while longer you struggle and rage against your new predicament, but eventually exhaustion gets the better of you, leaving you simply stuck halfway through the wall, a prisoner of the both the stone around you and your own fate. Temporarily finished struggling, you instead stew listlessly in a parade of thoughts, each another way your situation could be worse if things don't change.";
		WaitLineBreak;
		say "     An unseen slap of your jiggly backside wakens you from your reverie, and alerts you to the fact that you are no longer as alone as you were before. Another followup act, equally forceful and equally sensual alike, sends ripples across your soft flesh. Instead of being stranded alone in this wall, it seems that at least one being has decided that your colossal ass being stuck in the wall constitutes an invitation to use you freely. In this situation, your own opinion on who gets to use your rear is irrelevant, as you can't even see what's going on behind you, let alone affect it. The thought of that sends a slight shiver down your spine as the hands shift from light sensual slaps to kneading and groping of your massive cheeks.";
		say "     Only seconds later, the tip of the unknown shaft settles into place directly against your rear opening, the light touch enough to make you unconsciously shiver in concern for what's to follow. In mere moments things progress to the point of no return, and your mysterious partner thrusts forward, driving the shaft into you, making you gasp. Though you're unable to see anything, now that you're in contact properly you can tell that whoever happens to be fucking you is at least mercifully average in size, and with a member that seems close enough to human for you to be unable to determine anything else. This internal analysis passes in the split second of entry, before shattering with the impact of the repeated thrusting that quickly ensues. Your own captivity keeps you from moving in concert, whether towards or away from the action, but there is no such restriction on your partner, who uses their relative freedom to the fullest.";
		WaitLineBreak;
		say "     Fortunately, while no slouch, your impromptu companion seems to not be particularly blessed in the department of stamina. You're uncertain of the exact time, trapped as you are, but you're sure that only a short while passes before they reach their peak, shooting several jets of release into you, your own pleasure spiking in response, though not enough for an orgasm of your own. Instead, you simply sigh in relief as they seem to move away from you, leaving your passage now empty, if not exactly unmolested. The taste of freedom turns to ash in your mouth, however, as you realize that despite that relative improvement, you're still no closer to actually escaping your predicament then you were before – and now there's a fresh splash of white paint showing anyone on the other side that you're there and waiting.";
		say "     After some further time passes, you feel a gust of air flowing across your exposed ass, surely a sign of movement behind you, and in all likelihood a new visitor. Your prediction is vindicated in almost no time as you soon feel the weight of an unknown shaft slapping against one of your cheeks, a prelude to what follows. Instead of simply moving to action, you find another surprise on the way as another shaft, as near as you can tell from your limited perspective almost identical to the first, plops into place on the opposite side. Mentally you try and brace yourself for what might follow from having two separate individuals to deal with, knowing that without more information you're unlikely to be as ready as you'd hope.";
		WaitLineBreak;
		say "     The newcomer to your left moves into action first, starting off by giving you a few repeated slaps from their shaft, which seems perhaps similar in size to the prior, before moving over into place centrally behind you and lining up a substantially narrower tip with your passage. Before you can contemplate what that might indicate, your questions are answered by force as they slam forward, the tapered point allowing a smooth entry. In a moment, you are filled to the hilt with what you're almost certain is something distinctly canine, and no time is wasted in turning into a particularly energetic jackhammer. The size of the shaft itself is perfectly manageable, and though in a normal situation the knot at the base would be a concern, here it seems to be relatively narrow, enough at least to simply leave each thrust feeling far thicker than the rest implies. Despite your unwilling participation in the event, you can tell that the embers of arousal are starting to grow within you.";
		say "     The rhythm is broken when the shaft suddenly pulls back, leaving you momentarily empty. The unasked question is quickly answered as you feel a shifting behind you, and suddenly find yourself impaled once more, this time on a very similar, but not quite the same, shaft. The other of the two behind you has decided to take a turn, the jarring transition enough to bring your lust down to a mere simmer – something the new participant seems determined to rectify. Much like the owner of the other cock, this particular guest seems inclined to use raw energy to overcome any limited size, hammering into you with a pace your own stamina can barely keep up with. For another minute, that seems all there is to it, but as the pair tag out once again, the genius of their approach crystallizes. Even as they swap back and forth, their energy seems to barely diminish, the momentary rests allowing them to last far longer than either could individually, and build to an even more powerful climax.";
		WaitLineBreak;
		say "     Soon their tag team effort bears fruit, and you find your own pleasure ramping up to unsustainable levels, despite the frequent interruptions. Electric arcs of pleasure shoot up your spine, letting you feel pure bliss for a single moment. Even separated by this wall, you're certain that the pair can tell you've hit that mountaintop from their efforts, if only by the way you can feel yourself shaking, and reflexively tighten your grip on whichever shaft is currently plundering your booty. This acts almost like a signal for the two, as they pick up the pace significantly, battering your already weary behind faster and faster, chasing their own climaxes. Finally it seems to work, and this time when one pulls out, the other doesn't replace it, instead you feel a weighty splash across your massive backside, as the two simultaneously give you a fresh coat.";
		say "     The pair seem content to leave it at that, and similarly you're left to stew in your own arousal, no further attention from the others. This time, however, the wait is far shorter before you can hear muffled sounds from the other side of the wall, giving you hope that something will happen – though your concern is purely with your own isolation, and certainly not out of any enjoyment of the sensation, your thoughts echoing in your mind with less than stellar convictions. To your own unacknowledged heat, however, the mysterious new arrival hasn't the faintest idea of your opinion on the matter.";
		WaitLineBreak;
		say "     Rather than jumping straight into penetration, it seems somebody has decided to explore everything available to them first, as a pair of soft hands carefully grasp each of your cheeks, and start to gently trace an arbitrary path across their surface. Periodically this fanciful handiwork is replaced with a somewhat needier grope before they return to their slow teasing, building up more tension in you as surely as the stone you're stuck in. Eventually, however, their ministrations seem to reach a satisfying conclusion for them, and though you're stewing in your own lusts, they pull back. Mentally, you brace for the impaling that seems almost certain to follow based on the prior record.";
		say "     Your suspicions are proven correct almost immediately, though to a greater extent than you ever foresaw. With no further time to acclimate the stranger presses a head against your passage, and without waiting even a breath they impale you in one swift stroke. You find yourself split wide open on an excessively large flared shaft, the sheer might of the member leaving an impression both physical and mental sufficient for you to have absolutely no doubts about the shape and dimensions of the equine tool being used on you like a jackhammer. The force slamming in and out of your rear entry is enough that you can feel your whole body shaking, despite your firm placement in the wall holding you, and the echoing reverberations seem to rattle you to your very core. There can be no deception in the face of such a bone deep force, and you can do nothing but enjoy every ounce of it.";
		WaitLineBreak;
		say "     Unlike the prior guests you were dealing with, this particular one seems to have no concept of moderation or pacing. Their cock has only a single command velocity, and proves it by staying at a flawless ramming speed continuously. Fortunately for you, your body seems very receptive to that specific speed input, and as a result you find your own internal enjoyment growing constantly in the face of this onslaught. The same cannot be said for the wall against you, as in sharp contrast to your own uncontrollable moans, you can hear an ominous creaking sound start to build. Nonetheless, you commit yourself to basking in the pleasure, without the attention to spare to any minor details.";
		say "     Eventually it seems that the powerful rutting finally achieves its goal, and with a thrust somehow more powerful than those that came before it, the horsecock is buried seemingly to the hilt in your ass, finally enough to bring you to a howling climax of your own. In tandem, the shaft that so generously aided you is itself throbbing tremendously, and starting to unleash a torrent of seed that seems beyond belief. Your mind is too hazed with lust to realize the effects this combined climax has on the third component of this engagement, namely the wall itself. As the mighty being behind you thrust true, it seems the force was enough to severely decrease the integrity of the stone prison around you, causing several chunks to fall on either side of you. You're too dazed from the sensory overload of the entire situation to even fully comprehend when your partner extracts themselves from their entanglement with you, but when your mind finally clears, you notice the change of the structure around you. While it takes a great effort, the energetic sex shook things loose enough that you're able to finally wiggle through, your fat behind no longer a perfect impediment to your progress. Now freed, you vow that you'll be far more careful to avoid such a predicament in the future. Probably.";
		CreatureSexAftermath "Player" receives "AssFuck" from "Latex Fox";
		CreatureSexAftermath "Player" receives "AssFuck" from "Valkyrie";
	else:
		say "     Decidng it's not worth wasting your time on the chance, you return to your explorations.";
	now Wallstuck is resolved;

instead of going north from Bunker while (mdasslevel > 4 and library computer is powered and a random chance of 1 in 10 succeeds): [shower scene]
	move player to Communal Shower;
	say "     As you pass near the library showers, perhaps on a whim, you decide that it's a worthwhile idea to clean up a little. A little bit of soap and water never really hurt anyone, and all that besides you've been very busy lately, making the thought of a chance to relax under the water rather appealing. It doesn't take you long to strip down and turn the water on, idly passing a few moments as you wait for the hot water to kick in. In particular, you glance at your own reflection in the mirror, eyes passing over your form appraisingly. This leads to you giving a slight twist for a better angle of view on your rear in particular, as the size makes it somewhat impossible to ignore. Satisfied with your reflection, you once more step to the showers, this time greeted by the warm embrace of the heated water.";
	say "     Under the flowing water, your mind has the chance to drift to thoughts of faraway things, and to simply let your body run on autopilot as you relax in the water. Your idle thoughts lead to more than just a wash, however, and without fully realizing your hands have migrated further down towards your unmatched caboose. Your fingers idly trace across the surface in unknown arcs, combining with the sensations of the droplets running down your body to create hints of something deeper. The feelings arising from the unintentional fondling are enough to start bringing your own thoughts back to reality, but the hot water leaves you still relaxed enough to not fully comprehend your actions. As your hands continue their work, your sensitive cheeks start to become a source of pleasure, radiating a warm glow of sensation outwards through your body.";
	WaitLineBreak;
	say "     Finally the creeping shadow of lust becomes sufficient to catch your full attention, and you finally realize the state you're in: standing amidst the steam and flowing water with your hands each holding a generous handful of ass, with your own look of pleasure clear on your face in the mirror. There's a voice within you that cries out that you should be ashamed, but the beauty of the scene in the mirror is enough to drown out its objections. Instead, you simply embrace it, falling further into your own depravity willingly, knowing that only further pleasure awaits you. Unlike the leisurely pace you took while not aware, you now shift into a higher gear, and start far more actively pawing and kneading the flesh of your oversized bubble butt. The slick surface is plush beneath your fingers, and even this action is enough that you can feel the faintest sensations heralding a building climax.";
	say "     You brace yourself as you stand in the growing mist of steam, and take it one step further. With some effort you reach past the sizable curve of your rear, and trace a finger past your opening. A shiver of intense sensation shoots up your spine, and you dive in further, prodding and teasing with several fingers this time. Leaning into the chaotic action, your roaming hands once more seem to almost have a life of their own as they give you a more intense pleasure than many of your encounters in the city. Soon you're unable to resist the siren song of your own peak, and your actions bring you to a shuddering orgasm, with shocks of pleasure shooting through your system, and all from simply focused anal attention. Finally you let yourself relax fully again, letting the heat drain out of you as the shower washes away your stress and shame at once, leaving you completely refreshed—and completely satisfied.";



Magic Drake ends here.
