Version 1 of Valkyrie by Qazarar begins here.

Section 1 - Monster Responses

ValkyrieScore is a number that varies.[@Tag:NotSaved]
ValkyrieScore is usually 0.
ValkyrieBadEnd is a number that varies.[@Tag:NotSaved]
ValkyrieBadEnd is usually 0.

to say ValkyrieLoss:
	if inasituation is true: [special event]
		say ""; [dealt with in the file where the event is described]
	else:
		[say "[FindValkyrieScore]";]
		if ValkyrieScore is 0: [Steed transforms player, no direct action]
			say "     You fall to your knees, [if hp of Player > 0]submitting to the power of[else]defeated by[end if] the warrior and her steed, accepting anything they're willing to do to you. After several moments of nothing happening, however, you look up to see the pair staring down at you with disappointment, before the stallion speaks. 'This one will make an excellent offering, but they are not ready.' The valkyrie shakes her head, and you can see a devious gleam in her eyes. 'I suppose we'll just have to fix that, won't we?' She then reaches into a pouch on her belt and pulls out a small bottle, before popping the lid off and pouring it over you. 'Try coming back when you're more suitable, and then you can help relieve my wonderful battering ram of his tensions.' Following her declaration, her mount lets out a snort and trots away, leaving you alone.";
			infect "Valkyrie Boi";
			increase ValkyrieScore by 1;
		else if ((ValkyrieScore < 3) or (a random chance of 1 in 4 succeeds)): [player gives handjob]
			[submission handjob]
			say "     In the face of the overwhelming power of the horse before you, and to a lesser extent the skill of the rider, you can only submit. The steed above you smiles when you do so, and looks at you appraisingly. 'It seems that you're starting to understand what you're truly here for[if ValkyrieScore < 3], even if your body doesn't know it yet[end if].' The valkyrie seems to be weighing her words for a moment before she speaks as well. 'Perhaps now you can be of use in relieving my lovely steed here, to help him get ready for the battles ahead. While it may not be quite as much as you can offer, why don't you go ahead and touch it for him?' Somewhat uncertainly you begin to comply with her not so gentle request, dropping to your knees before the huge horse, bringing your face to the height of his equally large member.";[update this whole scene for the new visual and stallion changes]
			say "     Hesitantly, you reach out and place one hand against the massive rod, a welcoming heat radiating outward from the equine flesh. The sheer size easily dwarfs your hand, but even with that complication you begin attempting to offer him the relief you've been asked to provide. For a moment you simply rub back and forth with the hand resting there, but quickly realize that with something this large that would be woefully inadequate, and so your other hand joins it. Your effectiveness doubled, you start to stroke up and down the thick shaft, feeling just the slightest give as you continue the slow and methodical act. As gentle as your touch is, you can tell it is still having the desired effect, as over time the stallion above you begins to shift slightly side to side and breath more heavily, clearly pleased with your efforts.";
			WaitLineBreak;
			say "     For a time things continue simply, with you continuing your manual ministrations, albeit with some variation to the length and angle of your strokes to ensure greater sensations. When the beast you are servicing begins to react more energetically to your efforts you realize he must be getting closer to his climax, a fact only cemented by the murmuring encouragement of the valkyrie riding him growing more fervent. Trying to enhance the pleasure he feels, you move almost without thinking and pull closer, starting to tease his colossal member far more vigorously as you reach further with each motion. Finally he hits the peak you have been working him towards, and his majestic organ starts to jerk violently in your hands, the powerful balls behind it visibly preparing his load. In an instant, he unleashes a torrent of seed onto your waiting face, the volume so great that in seemingly no time at all the virile essence starts to be affected by its own weight and drip down the rest of your body.";
			say "     The sounds from the steed above you leave no doubt with his satisfaction, even as the cum all over your front offers physical proof of your success. You sputter and gasp through the thick coating on your face, but despite that you feel oddly peaceful with the outcome. From atop the well endowed horse, the valkyrie you had almost forgotten completely speaks down to you. 'As I suspected, you were adequate at helping my mighty steed, and you are free to go, for the moment. The next time we see you, if you are more fitting, you will be allowed to service him far more thoroughly.' With that surprisingly tantalizing declaration made, the pair leave you as you are, drenched in seed and with a lingering desire for more.";
			infect "Valkyrie Boi";
			increase ValkyrieScore by 1;
			[else: [forced handjob]:
				say "     A";]
		[else if ((ValkyrieScore < 5) or (a random chance of 1 in 3 succeeds)): [player gives oral]
			if hp of Player > 0: [submissive oral]
				say "     A";
			else: [forced oral in stocks]
				say "     A";]
		else if ((ValkyrieScore < 7) or (a random chance of 1 in 2 succeeds)): [player gets railed]
			[if hp of Player > 0: [voluntarily put into stocks]
				say "     A";]
			[forced anal in stocks]
			say "     Your defeat at the hands of the powerful pair brings you to your knees, barely able to move, and your thoughts trapped in a daze. Through the reverie you hear the resounding voice of the stallion that overpowered you as he discusses you with his rider. 'This one is so very close to what I'm looking for, the perfect toy. Just a few lessons left for them.' A murmured agreement from the valkyrie is the last clear thought you have before you're lifted off the ground and taken somewhere else, too confused and aroused to be fully aware of your surroundings. Eventually you are shaken to wakefulness to find that you are now leaning forward, suspended by a set of incredibly sturdy-looking wooden stocks. The area in front of you seems empty, but judging by the last thing you remember, you think you have a very clear idea of who is behind you, and what's about to happen.";
			say "     That premonition very quickly starts to come true, as you can feel something exceptionally large and heavy coming to a rest on top of your cushioned rear, sizable enough that even your wide cheeks don't engulf it. 'You've become quite the catch, and now that you're almost perfect I'll show you what you're really meant for.' The voice of the stallion behind you rings out with a seemingly unquestionable authority, demanding you submit to his will. For a moment you almost falter, but instead you manage to resist and attempt to struggle against your bindings, though that you soon discover how futile your attempts at escaping are. Even as you still struggle, the log sized endowment pulls backwards until the massive flared head rests against your passage, simply awaiting the moment he decides to force you wide open.";
			WaitLineBreak;
			say "     The brief moment of silence is proven to be the calm before the storm as the demonic horse behind you thrusts forward. With an endowment so large you would expect at the very least some discomfort, but perhaps because of his corrupted nature the feeling of your ass being spread open for his cock is nothing but pleasurable. Regardless of your resistance, the flared head starts to drive further inward, easily bypassing your defenses. You let out an involuntary moan at the sensations starting to emanate outwards from your rear, only to hear it echoed back. When you look to your right, you can just barely see that the valkyrie has come down to get a better view of the action, and is furiously pleasuring herself at the sight of you being impaled on the massive horsecock.";
			say "     When the stallion starts to move again, determined to get his satisfaction out of you, any thoughts of what the valkyrie is doing are driven from your mind by the force of the thrusts. Instead, the only thing filling your mind is the same thing filling your entire body—his cock. Even as you struggle to hold on to your resentment and anger at losing to this smug pair, the pleasure suffusing you distracts you from your former rage. Each motion he makes seems to somehow stretch you even further than before, his imposing member showing you that he was absolutely correct when he said this is what you're meant for, as only a true slut could even dream of taking his overwhelming endowment.";
			WaitLineBreak;
			say "     Even as your will is straining under the unrelenting sensations you're being bombarded with, the steed above you starts to push you even further. His thrusts get more powerful, driving more deeply into you even as you're being bumped repeatedly against the stocks holding you. The selfsame position making it so easy for him to penetrate you also makes it impossible for you to look down at yourself, but you know with a deep certainty that if you could you would clearly see how fully his length is sheathed in you. Even with the depth he has reached however, you have not felt the telltale slap of flesh on flesh that you know would be impossible to miss if he had managed to hilt in you, and you cannot help but marvel at the size of him knowing there is still more to go.";
			say "     Time seems to go on forever as you're pounded repeatedly by the stallion, and though your pleasure is so great that you aren't certain, you think you've already peaked several times just from the powerful fucking you're receiving. On the other hand, the steed giving you so much ecstasy has yet to release at all. Your battered mind manages to dredge together enough focus to realize how unfair it is that he hasn't been able to feel as good as you do right now. As if reacting to your thoughts, you can feel his pace increase, and the valkyrie's unending moans reaching a fever pitch. 'You've been an excellent toy, so how about I give you a gift!' He makes on more mighty thrust, and you can feel the difference as his shaft throbs urgently, preparing to make a deposit.";
			WaitLineBreak;
			say "     Finally the moment itself arrives, and the incredible shaft impaling you begins to jerk and twitch far more than before, releasing its payload and filling you with a deep warmth. The force of the shots combined with the knowledge that you're the one who brought him this feeling are enough to make you climax again, helplessly moaning as loudly as the valkyrie. Even after that, the flow of seed continues further, combining with the member to fill you even further, the sheer weight trapped within your rear enough to bring you to the ground if you weren't already locked into this contraption. Eventually the sensation starts to slow, and you can feel the stallion dismounting, his oversized equine shaft leaving your passage even as a parting gift is left inside you. You can hear some shuffling behind you as the valkyrie moves around, and suddenly the shackles holding you in the stocks are released, though you lack the strength to move at the moment. 'Your services were appreciated, toy. I'll be waiting eagerly for the next time I see you.' With that final statement you can hear the sounds of the pair leaving, until finally the only thing left is you and the bloated bellyful the stallion left for you. Your thoughts start to return even as your energy does, and you're able to drag yourself back to your feet. Despite everything however, you can't silence the little voice in your mind that's urging you to return.";
			increase ValkyrieScore by 1;
		else if (ValkyrieBadEnd < 5): [belly riding]
			[increase ValkyrieBadEnd by 1;]
			[volunteering]
			say "     Unable to resist, you submit to the powerful steed and his busty rider. The treatment you have already faced at their hands has shown you what sort of thing is in store, and you find that you're surprisingly willing to let them do what they will with you. The stallion looks at your submissive form, and tilts his head as he thinks for a moment, before speaking to the valkyrie. 'I think that this one would make an excellent addition to my saddle, don't you?' The valkyrie nods in agreement, and gets down from her position. In a flurry of action you find yourself being set upon a nearby bench, your ass out in preparation for something, though your lust-addled mind can't quite fathom what.";
			say "     The pair don't leave you questioning for long, however, as soon the stallion pulls up into a familiar position above you with his massive member right behind. With a simple pressure that carries the weight of his equine strength, he starts to thrust forward. The mighty flare offers some resistance at first with a moment of tension, but soon your passage yields allowing it to enter fully. The rest of the motion follows smoothly from there, until soon your all too welcoming rear contains almost the full length of his shaft, with only a slight amount remaining beyond. You initially expect that more fervent thrusting will follow, but instead you remain in place as the valkyrie gets closer than usual, and you can hear her fiddling with something just out of your sight.";
			WaitLineBreak;
			say "     This following mystery is solved just as quickly as the last when she begins to grab hold of your arms and lift them up, binding them into what you now realize are not decorative additions to the saddle, but rather the perfect place tie something to the saddle—in this case, you. The valkyrie is doing far more than just preparing you to be ridden by the stallion once, and is instead making sure he can wear you on his saddle and ride you all day long, or perhaps even longer. The mere thought is enough to give you a shiver of pleasure, your resistance to the idea of being a mere outlet for his pleasure becoming fainter with each passing moment, and your growing enjoyment only enhanced by the way the mighty cock you're adorning shifts inside you.";
			say "     With the final strap cinched, the entire experience is taken out of your control. You're going to be stuck right under his barrel regardless of your own opinions on the matter, a perverse compliment to the saddle on his back. The sound of the valkyrie's voice from above alerts you to the fact that she is set upon that same saddle. 'Your new toy is prepared for you, my steed. Do with them as you will.' Almost before she's done speaking, you can feel through your entire body the sensation of the stallion starting to move away from your former resting point, and leaving you fully suspended from above. The ground below you is the only thing you can see, leaving you no idea where it is you're going—or rather, where the stallion you're at the mercy of is going. Almost as if sensing your uncertainty, the tainted voice of the equine rings out.'I believe this toy is going to very much enjoy their time serving me, one way or another.'";
			WaitLineBreak;
			say "     Soon the prediction made by the stallion becomes fact, as every step he takes with you attached causes you to bob back and forth along his member, helpless to do anything but take a log of horse meat repeatedly. Even if you were to try and resist the sensations it causes, the constant pleasure barraging you as you're paraded around like a prized possession would be far beyond your ability to ignore. It's so much that with each minute that passes, with each stroke of the shaft in and out without a thought for your desires, each drip of pre seed filling you, only serve to make you fall deeper into the spiraling depths of depravity that you find yourself in. In the act of being treated like a mere sleeve to attach to a saddle, you almost find your own thoughts reduced to that of a toy, with no desires but those that its wearer pours into it.";
			say "     You barely notice as the valkyrie and her steed travel for what must be hours, the stares of the various beings and creatures they pass simply not registering as important to your insensate mind. Your binding to the saddle is put to the test when the pair ride into battle, the forceful jockeying causing you to futilely climax several times without being paid the slightest amount of attention. Following this, they end up fighting several more battles where they emerge victorious to the best of your knowledge, since it's difficult to tell exactly what the outcome was—after all, your only contribution to the effort is as an accessory. Every action they take seems to drive you further than the last, until it all becomes a blur of pleasure and submission that you can't escape from.";
			WaitLineBreak;
			say "     The endless reverie you were in is eventually broken as you find yourself sliding off the cock you've spend a seemingly eternal amount of time impaled on. You feel a flash of panic, expecting to hit the ground, but are instead caught in a pair of strong arms. You blink through bleary eyes to see what just happened, and find the face of the valkyrie looking back at you. She brings you away from where the stallion still stands, and gently lowers you to the ground in a sitting position, and starts unbinding you. 'You're almost ready, you know. My steed provides me aid in exchange for toys just like you, but he's decided not to take you quite yet. I suppose sometimes he's in the mood for a toy that has given in completely, rather than simply breaking them himself. So for now, you're free to go, with a warning that next time he may not be so generous.' For a moment, she simply looks you over, before continuing. 'Somehow though, I think we'll be seeing you again anyway.' The steed in question laughs darkly, completely assured of his eventual claiming of you, as the valkyrie climbs back on and the pair ride off. Deep down, you think that he may be right.";
			[else: [forced]
				say "     A";]
		[else: [bad end]
			say "     A";]

to say ValkyrieVictory:
	if inasituation is true: [special event]
		say ""; [dealt with in the file where the event is described]
	else:
		[say "[FindValkyrieScore]";]
		say "     What do you want to do with your defeated opponents?";
		now sextablerun is 0;
		blank out the whole of table of fucking options;
		[]
		choose a blank row in table of fucking options;
		now title entry is "Use your hands";
		now sortorder entry is 1;
		now description entry is "Give some manual stimulation to the steed";
		[]
		choose a blank row in table of fucking options;
		now title entry is "Have a taste";
		now sortorder entry is 2;
		now description entry is "Use your mouth on the mount's member";
		[]
		[if ValkyrieScore > 4:
			choose a blank row in table of fucking options;
			now title entry is "Ride the horse";
			now sortorder entry is 3;
			now description entry is "Use your ass to enjoy that horsecock";
		if Player is male:
			choose a blank row in table of fucking options;
			now title entry is "Enjoy the valkyrie";
			now sortorder entry is 2;
			now description entry is "Take the valkyrie's ass";]
		repeat with y running from 1 to number of filled rows in table of fucking options:
			choose row y from the table of fucking options;
			say "[link][y] - [title entry][as][y][end link][line break]";
		say "[link]0 - Nevermind[as]0[end link][line break]";
		while sextablerun is 0:
			say "Pick the corresponding number> [run paragraph on]";
			get a number;
			if calcnumber > 0 and calcnumber <= the number of filled rows in table of fucking options:
				now current menu selection is calcnumber;
				choose row calcnumber in table of fucking options;
				say "[title entry]: [description entry]?";
				if Player consents:
					let nam be title entry;
					now sextablerun is 1;
					if (nam is "Use your hands"):
						say "[ValkyrieWin1]";
					if (nam is "Have a taste"):
						say "[ValkyrieWin2]";
					if (nam is "Ride the horse"):
						say "[ValkyrieWin3]";
					if (nam is "Enjoy the valkyrie"):
						say "[ValkyrieWin4]";
					wait for any key;
			else if calcnumber is 0:
				now sextablerun is 1;
				say "     You decide against taking advantage of the defeated pair, and leave.";
				wait for any key;
			else:
				say "Invalid Option. Pick between 1 and [the number of filled rows in the table of fucking options] or 0 to exit.";
		clear the screen and hyperlink list;

to say ValkyrieWin1:[handjob]
	say "     As you finally defeat the valkyrie and her mighty steed, you can't help but rest your eyes on the particularly enticing masculine endowment that belongs to him. The exhausted equine has collapsed onto his side, with the equally defeated warrior leaning against his back. In this position, his throbbing horse member is clearly both visible and at attention, it's shape and sheer size making it impossible to ignore. For several moments you simply stare at, tempted by the thought of how it would feel in your hands, before you eventually decide to give in to your curiosity. You kneel down alongside the stallion, already noting that the very air seems warmer near him, as if radiating from his flesh. Slowly you extend your hand, and rest your palm on the side of his powerful rod.";
	say "     Even this simple act is enough to bring up several sensations at once. The warmth you felt before is even more intense with direct contact, teetering right on the edge of being too much, without ever quite reaching that point. Beneath your hand you can feel the constant thrumming of his arounsal, pulsing through the shaft, a clear sign of the sheer virility. Combined with those is the powerful scent that becomes obvious with your proximity, an overwhelming bestial masculinity. Without even thinking, you realize you have already begun to stroke your hand softly back and forth along the side of the shaft. There is a moment of conflict in the back of your mind, but it is easily dismissed as you bring your other hand up to match the first.";
	WaitLineBreak;
	say "     With both hands in place, you start to gradually increase your speed, the repetitive motion you use becoming smoother with each stroke. It's easy to fall into a rhythm without thinking about what you're doing—in fact you barely think at all. The only thing your focus is on is the mighty meat directly in front of you, how it looks throbbing between your hands, and how it's about to look once it starts spurting its load. The time you spend starts to blur, and in what seems like no time at all your unspoken question is answered as you can feel the shaft start to jerk and pulse, clearly about to reach a peak. Rather than your previous steady pace, you break your tempo and shift to just stroking furiously, your eagerness to bring him to his climax overcoming you.";
	say "     Finally the moment you were waiting for happens, heralded by an even more powerful throbbing in his shaft. At the same time, the stallion lets out a powerful grunt of pleasure, clearly appreciative of your efforts. His release is as mighty as you expect from such a huge member, spewing huge torrents of warm seed onto you. Each spurt reaches far from its source, streak after streak of cum landing across your body. In no time at all he has almost covered every visible surface, yourself included. Everything has a sticky coating, and is equally drenched in the scent of his release, which is just as virile as the rest. You shudder slightly in pleasure from the sensations, before climbing back up to your feet. You've seen the admittedly impressive example of what he can do, and that's enough for you, at least for now.";

to say ValkyrieWin2:[oral]
	say "     As you finally defeat the valkyrie and her mighty steed, you can't help but rest your eyes on the particularly enticing masculine endowment that belongs to him. The exhausted equine has collapsed onto his side, with the equally defeated warrior leaning against his back. In this position, his throbbing horse member is clearly both visible and at attention, it's shape and sheer size making it impossible to ignore. The sight of it is enough to make your mouth water, wondering exactly how that shaft would taste if you were to use your mouth on it, and how full it would make you feel. You can only fantasize so much before it crystallizes into action, however, and so you you kneel down and gently move the steed so that he is fully on his back, legs splayed apart to grant you much easier access to his cock. He allows himself to be moved into the new position with little effort, and why wouldn't he? You're already going to give him exactly what he wants.";
	say "     It takes several moments to work yourself up to starting properly, due to the sheer intimidating size of the member, but your curiosity eventually overcomes your nerves. You start with small experimental licks along the head, gently teasing the surface with your tongue. Even just this basic taste is a heady mix of sensations you can't get enough of, causing your mouth to water and enticing you to dive deeper into your victory. With that motivation drawing you in, you start to move on to trailing kisses down the shaft, enjoying every moment of the process. This path leads you down to where his package meets his equally sizable balls, and you take a moment to switch your attention to them. You lavish them with a similar oral treatment to what you gave the rest of his masculinity, earning an appreciative moan for your efforts.";
	WaitLinebreak;
	say "     You spend what feels like an eternity smothering yourself in his sack, working over every bit of the surface, until the stallion starts to plead with you. 'That's enough of that, isn't it time to move on to the main course?' His voice sounds confident, but there is an undertone of need to it that lets you know just how much he wants what you can offer. You would smile if your mouth wasn't so occupied, because despite all his power and virility, you're the one in control right now. You take your efforts at your own pace, which eventually do lead you back up towards the tip of his member, and you prepare to enjoy it even more thoroughly. The girth you're about to deal with is substantial, but you have an inkling that with this particular steed you'll be able to take it despite the prodigious size.";
	say "     This time when you bring your mouth to the head, it's to take the entire package. You start the task by sucking at the tip, slowly and gently going further and further, pushing your oral skill to the limits. Very quickly you find your suspicions were correct, as you're able to continue until even the flared head is wholly inside you, something you're certain would normally be beyond you. The feeling of having something so large in your mouth is one that's difficult to describe, but undeniably both satisfying and exhilarating. You don't waste any time in pushing on further, determined to get as much of the meaty rod as you can buried in your throat. To make it easier, you close your eyes to shut out any distractions, so that you can focus purely on swallowing the cock in front of you.";
	WaitLineBreak;
	say "     Your new approach pays off, as you can feel the wide flare slipping further down your throat, stretching you out to be able to take the huge horse cock that you've set your sights on. Each additional inch you swallow brings you more pleasure than the last, both from the physical sensation and the thought of what you're doing to the equine splayed out on the ground. Even as you become more and more of a sleeve for his member, you know that ultimately this is for your own enjoyment as much as his, and revel in it. Eventually you reach down as far as possible, your lips meeting the base of his shaft, and you hum in satisfaction. You could simply rest there, but instead you start to move back and forth slightly, increasing the pace each time until soon you're vigorously massaging his length with your throat.";
	say "     It seems that the attentions you're bestowing upon him have started to become more than he can handle, as you can feel his cock throbbing inside you, a prelude to the inevitable explosion. You mentally brace yourself just in time, as he finally hits the peak he has been working towards the whole time, and his shaft erupts inside of you. The resulting torrent of seed is vast, enough to feel like it fills your body to the brim, and sure enough it certainly pushes you to your physical limits. The flood easily fills your stomach beyond capacity, leaving you fairly bloated with cum in a way that you can't help but enjoy. When it finally stops completely, you gingerly pull yourself back off his member, gasping slightly as your mouth empties. The now significantly less fearsome dick flops back onto the stallion's belly, leaving a final spurt of equine jizz drooling out onto the surface.";
	say "     You feel completely satisfied, with only minor discomfort from how over full you are with his release. No longer so completely occupied with your sexual endeavors, you see that the valkyrie herself had roused herself from her daze at some point, and clearly enjoyed what she saw, if how furiously she is rubbing herself is an indication. Having had more than your fill, you start gathering yourself in preparation to leave, only to be distracted for a moment by the stallion's voice, somewhat weaker than before. 'Truly, you possess a natural talent for this. You may have bested us this time, but if you ever desire to know what we can offer you, we can see once more who is the victor.' Though his offer catches your interest, it's a worry for another day. Instead, you finally begin to walk away, leaving a pleasure-stricken valkyrie and her well satisfied mount behind.";

to say ValkyrieWin3:[anal]
	say "     A";

to say ValkyrieWin4:[fucking the valkyrie]
	say "     A";

to say ValkyrieDesc:
	say "     Before your eyes is the largest horse you have ever seen, [if ScaleValue of Player < 4]easily towering over you and giving you a perfect line of sight to what is undoubtedly the most attention grabbing feature: his massive erect horsecock[else]even with your large stature, though even from this angle the massive equine member hanging erect under him is visible[end if]. It almost takes you a moment to realize that the steed is not alone, and atop his back is a figure that would stand larger than an average woman, but still tiny in comparison to the hulking beast below her. She is wearing elegant armor, reminiscent of a valkyrie, with a very deadly-looking spear in hand. Unlike most depictions of valkyries however, the woman wearing this armor is an incredibly busty lizard girl with distinctive pink scales. When she spots you, a smile breaks out on her face. 'My battering ram has been in need of a new plaything, and you'll do the trick!'";

[ Because of issues with checking infections this is commented out until a later update.
to say FindValkyrieScore:
	now ValkyrieScore is 0;
	if BodyName of Player is "Valkyrie Boi":
		increase ValkyrieScore by 2;
	if FaceName of Player is "Valkyrie Boi":
		increase ValkyrieScore by 1;
	if TailName of Player is "Valkyrie Boi":
		increase ValkyrieScore by 2;
	if SkinName of Player is "Valkyrie Boi":
		increase ValkyrieScore by 1;
	if CockName of Player is "Valkyrie Boi":
		increase ValkyrieScore by 1;
	if mdasslevel > 3:
		increase ValkyrieScore by 2;
	if Cock Length of Player > 10:
		increase ValkyrieScore by 1;
	if Player is twistcapped:
		increase ValkyrieScore by 1;]

Section 2 - Monster Insertion

Table of Random Critters (continued)
NewTypeInfection (truth state)	Species Name	Name	Enemy Title	Enemy Name	Enemy Type	Attack	Defeated	Victory	Desc	Face	Body	Skin	Tail	Cock	Face Change	Body Change	Skin Change	Ass Change	Cock Change	str	dex	sta	per	int	cha	sex	HP	lev	wdam	area	Cock Count	Cock Length	Ball Size	Nipple Count	Breast Size	Male Breast Size	Cunt Count	Cunt Depth	Cunt Tightness	SeductionImmune	Libido	Loot	Lootchance	TrophyFunction	MilkItem	CumItem	Scale (number)	Body Descriptor (text)	Type (text)	Magic (truth state)	Resbypass (truth state)	non-infectious (truth state)	Cross-Infection (text)	DayCycle	Altcombat (text)	BannedStatus (truth state)
--	--	--	--	--	--	--	--	--	--	--	--	--	--	--	--	--	--	--	--	--	--	--	--	--	--	--	--	--	--	--	--	--	--	--	--	--	--	--	--	--	--	--	--	--	--	--	--	--	--	--	--	--	--	--	--	--;

When Play begins:
	Choose a blank row from Table of Random Critters;
	now NewTypeInfection entry is false;
	now Species Name entry is "Valkyrie Boi";
	add "Valkyrie Boi" to infections of MaleList;
	add "Valkyrie Boi" to infections of BipedalList;
	add "Valkyrie Boi" to infections of HumanList;
	add "Valkyrie Boi" to infections of MythologicalList;
	now Name entry is "Valkyrie";
	now enemy title entry is "Valkyrie and her Steed"; [name of the encountered creature at combat start - Example: "You run into a giant collie." instead of using "Smooth Collie Shemale" infection name]
	now enemy Name entry is ""; [specific name of unique enemy]
	now enemy type entry is 1; [0 = non unique enemy; 1 = unique (unknown name); 2 = unique (known name) | Used to disqualify unique enemies from Vore/UB and showing the enemy name in encounters]
	now attack entry is "[one of]The valkyrie jabs at you with her spear.[or]The steed slams its hooves down towards you, battering you.[or]The steed charges you, knocking you aside.[at random]";
	now defeated entry is "[ValkyrieVictory]";
	now victory entry is "[ValkyrieLoss]";
	now desc entry is "[ValkyrieDesc]";
	now face entry is "notably reptilian, with impossibly [one of]beatiful[or]pretty[or]gorgeous[at random] feminine features"; [ Face. Format as Your face is [Face of Player]. ]
	now body entry is "as enticing as any model, with curves in all the right places"; [ Body. Format as "Your body is [Body of Player]." ]
	now skin entry is "[one of]softly scaled[or]bright pink scaled[or]scaly pink[at random]"; [ Skin. Format as "Looking at yourself, your body is covered in [Skin of Player] skin." ]
	now tail entry is "Your rear end is [one of]huge[or]massive[or]incredibly large[at random] and wobbles with the slightest movement, while a thick spaded tail hangs down behind you."; [ Ass/Tail. Write as a full sentence (with period) or leave blank for none. ]
	now cock entry is "throbbing and demonic [one of]equine[or]stallion[or]horse[at random]"; [ Cock. Format as "You have a 'size' [Cock of Player] cock." ]
	now face change entry is "it elongates slightly, leaving you with a lizardlike face, but one that is undeniably feminine"; [ Face TF text. Format as "Your face tingles as [face change entry]." ]
	now body change entry is "it shifts, leaving you very reptilian and even more feminine"; [ Body TF text, format as "Your body tingles as [body change entry]. ]
	now skin change entry is "it becomes coated in very fine pink scales, almost soft to the touch"; [ Skin TF text, format as "Your skin tingles as [skin change entry]. ]
	now ass change entry is "it expands outward, becoming extremely large and round, with an inviting tail to match"; [ Ass/Tail TF text, format as "Your ass tingles as [tail change entry]." ]
	now cock change entry is "your shaft swells with sudden arousal and twists into a powerful equine member, tinged with demonic corruption"; [ Cock TF text, format as "Your groin tingles as [cock change entry]." ]
	now str entry is 20;
	now dex entry is 12;
	now sta entry is 18;
	now per entry is 12;
	now int entry is 12;
	now cha entry is 22;
	now sex entry is "Male"; [ Defines which sex the infection will try and make you. current options are 'Male' 'Female' 'Both']
	now HP entry is 115;
	now lev entry is 12; [ Level of the Monster, you get this much HP if you win, or this much HP halved if you loose ]
	now wdam entry is 14; [Amount of Damage monster Does when attacking.]
	now area entry is "Avalon"; [ Current options are 'Outside' and 'Mall'. Case sensitive]
	now Cock Count entry is 1; [ Number of cocks the infection will try to cause if sex entry is 'Male' or 'Both'. ]
	now Cock Length entry is 20; [ Length infection will make cock grow to if cocks. ]
	now Ball Size entry is 5; [ Cock width, more commonly used for ball size. ]
	now Nipple Count entry is 2; [ Number of nipples the infection will give a player. ]
	now Breast Size entry is 2; [ Size of breasts the infection will try to attain. ]
	now Male Breast Size entry is 0; [ Breast size for if Sex="Male", usually zero. ]
	now Cunt Count entry is 0; [ The number of cunts the infection will try to cause if sex entry is 'Female' or 'Both'. ]
	now Cunt Depth entry is 0; [penetratable length in inches; some minor stretching allowed, or more with Twisted Capacity]
	now Cunt Tightness entry is 0; [size 1-5, generates adjectives of extremely tight/tight/receptive/open/gaping]
	now SeductionImmune entry is true;
	now libido entry is 35; [ Target libido the infection will rise towards. ]
	now loot entry is ""; [ Dropped item, blank for none. Case sensitive. ]
	now lootchance entry is 0; [ Percentage chance of dropping loot, from 0-100. ]
	now MilkItem entry is "";
	now CumItem entry is "";
	now TrophyFunction entry is "-";
	now scale entry is 3; [ Number 1-5, approx size/height of infected PC body: 1=tiny, 3=avg, 5=huge ]
	now body descriptor entry is "[one of]feminine[or]thick[or]angelic[at random]";
	now type entry is "reptilian"; [ one-word creature type. Ex: feline, canine, lupine, robotic, human... Use [one of] to vary ]
	now magic entry is true;
	now resbypass entry is false;
	now non-infectious entry is false;
	now Cross-Infection entry is ""; [infection that this infection will give the player when they lose; can be left empty if they infect with the monster's own]
	now DayCycle entry is 0; [ 0 = Up at all times; 1 = Diurnal (day encounters only); 2 = Nocturnal (night encounters only);]
	now altcombat entry is "default"; [ Row used to designate any special combat features, "default" for standard combat. ]
	now BannedStatus entry is false;

[
Table of New Infection Parts (continued)
Species Name	Name	Body Weight	Body Definition	Androginity	Head Change	Head Description	Head Adjective	Head Skin Adjective	Head Color	Head Adornments	Hair Length	Hair Shape	Hair Color	Hair Style	Beard Style	Body Hair Length	Eye Color	Eye Adjective	Mouth Length	Mouth Circumference	Tongue Adjective	Tongue Color	Tongue Length	Torso Change	Torso Description	Torso Adjective	Torso Skin Adjective	Torso Adornments	Torso Color	Torso Pattern	Breast Adjective	Breast Size	Male Breast Size	Nipple Count	Nipple Color	Nipple Shape	Back Change	Back Adornments	Back Skin Adjective	Back Color	Arms Change	Arms Description	Arms Skin Adjective	Arms Color	Locomotion	Legs Change	Legs Description	Legs Skin Adjective	Legs Color	Ass Change	Ass Description	Ass Skin Adjective	Ass Color	Ass Width	Tail Change	Tail Description	tail skin adjective	Tail Color	Asshole Depth	Asshole Tightness	Asshole Color	Cock Change	Cock Description	Cock Adjective	Cock Color	Cock Count	Cock Girth	Cock Length	Ball Description	Ball Count	Ball Size	Cunt Change	Cunt Description	Cunt Adjective	Cunt Color	Cunt Count	Cunt Depth	Cunt Tightness	Clit Size
--	--	--	--	--	--	--	--	--	--	--	--	--	--	--	--	--	--	--	--	--	--	--	--	--	--	--	--	--	--	--	--	--	--	--	--	--	--	--	--	--	--	--	--	--	--	--	--	--	--	--	--	--	--	--	--	--	--	--	--	--	--	--	--	--	--	--	--	--	--	--	--	--	--	--	--	--	--	--	--;

When Play begins:
	Choose a blank row from Table of New Infection Parts;
	now Species Name entry is ""; [name of the overall species of the infection, used for children, ...]
	now Name entry is ""; [matching infection name to Table of Random Critters]
	now Body Weight entry is 5; [scale of 1-9 for body weight, grouped into low weight (1-3), mid weight (4-6) and high weight (7-9)]
	now Body Definition entry is 5; [scale of 1-9 for body definition, grouped into low muscle (1-3), mid muscle (4-6), high muscle (7-9)]
	[Body Adjective is generated out of the body weight and body definition and can be used in scenes - one word descriptive adjective depending on weight and definition groups: low weight group: skinny/slender/lithe; mid weight group: average/fit/muscled; high weight group: pudgy/husky/jacked]
	now Androginity entry is 5; [1-9 scale of hypermasculine to hyperfeminine]
	[Gender Adjective is generated out of androginity 1-9: hypermasculine/masculine/effeminate/somewhat effeminate/androgynous/feminine butch/tomboyish/feminine/hyperfeminine]
	now Head Change entry is ""; [partial sentence that fits in: "Your head and face [one of]tingle[or]go flush[or]vibrate with odd pleasure[or]go cold[or]feel oily[at random] as [head change entry]."]
	now Head Description entry is ""; [partial sentence that fits in "Your face and head resemble that of [Head Description of Player]. You have [Eye Adjective of Player], [Eye Color of Player] eyes and an overall [Gender Adjective of Player] appearance."]
	now Head Adjective entry is ""; [one word descriptive adjective (avian/canine/...)]
	now Head Skin Adjective entry is ""; [one word descriptive adjective]
	now Head Color entry is ""; [single word color adjective for the dominant color of the skin/fur/feathers/scales]
	now Head Adornments entry is "";[partial sentence that fits in "Before moving on from your head, you give your [head adornments of Player] a proud glance followed by a light caress."]
	now Hair Length entry is 2; [hair length in inches]
	now Hair Shape entry is ""; [one word shape descriptor (curly/straight/...)]
	now Hair Color entry is ""; [one word color descriptor]
	now Hair Style entry is ""; [one word style descriptor (ponytail/mohawk/buzzcut/...) to fit "On top of your head you have [Hair Length of Player] inch long, [Hair Shape of Player] [Hair Color of Player] hair in the [Hair Style of Player] style."]
	now Beard Style entry is ""; [short beard style (goatee/3-day stubble beard/porn stache/mutton chops beard/...) to go into "You have a [Hair Color of Player] [Beard Style of Player]."]
	now Body Hair Length entry is 0; [numerical value, 0-4 (no body hair/light/moderate/heavy/furry) - only set to > 0 if the infection does not have fur/scales/etc. !]
	now Eye Color entry is ""; [one word color descriptor]
	now Eye Adjective entry is ""; [one word descriptive adjective (slitted/round/...)]
	now Mouth Length entry is 3; [inches deep for face fucking; maximum possible will be double this number (when deep throating)]
	[Mouth Length Adjective is generated by a function and can be used in scenes too - "petite, shallow, average, deep, bottomless"]
	now Mouth Circumference entry is 3; [mouth circumference 1-5, see Mouth Circumference Adjective]
	[Mouth Circumference Adjective is generated by a function and can be used in scenes too - "tiny, small, normal, wide, gaping"]
	now Tongue Adjective entry is ""; [one word descriptive adjective (wide/slobbery/...)]
	now Tongue Color entry is ""; [one word color descriptor]
	now Tongue Length entry is 3; [length in inches]
	now Torso Change entry is ""; [partial sentence that fits in: "Your torso [one of]tingles[or]goes flush[or]vibrates with odd pleasure[or]goes cold[or]feels oily[at random] as [Torso Change entry]."]
	now Torso Description entry is ""; [partial sentence, fitting in "Looking down at yourself, you appear [Gender Adjective of Player] with a [Body Adjective of Player] build. Your torso is [Torso Description of Player][if Body Hair Length of Player > 1], covered in [Torso Color of Player] skin and [Body Hair Description of Player][else if Body Hair Length of Player is 1], covered in smooth, [Torso Color of Player] skin[end if]."]
	now Torso Adjective entry is ""; [one word descriptive adjective (avian/canine/...)]
	now Torso Adornments entry is ""; [(pouch/udders/...); partial sentence to fit: "You take a moment to feel your [torso adornments of Player]."]
	now Torso Skin Adjective entry is ""; [one word adjective (feathered/furred/scaly/...); EMPTY "" for creatures with just skin]
	now Torso Color entry is ""; [single word color adjective for the dominant color of the skin/fur/feathers/scales]
	now Torso Pattern entry is ""; [single word color adjective for the dominant pattern of the skin/fur/feathers/scales]
	now Breast Adjective entry is ""; [adjective(s) example: round, pointy, perky, saggy, bouncy. This would serve as either a general appearance of a infections breasts or possibly something that may be effected by a item or NPC.]
	now Breast Size entry is 0; [cup size as number, counting Flat Pecs = 0, A = 1, B = 2, ...]
	now Male Breast Size entry is 0; [cup size as number, counting Flat Pecs = 0, A = 1, B = 2, ...]
	now Nipple Count entry is 2; [count of nipples]
	now Nipple Color entry is ""; [one word color descriptor]
	now Nipple Shape entry is ""; [shape example: any shape will do as long as it has a baseline with a current infection or item]
	now Back Change entry is ""; [partial sentence that fits in: "Your back [one of]tingles[or]goes flush[or]vibrates with odd pleasure[or]goes cold[or]feels oily[at random] as [Back Change entry]."]
	now Back Adornments entry is ""; [partial sentence to fit: "Your back tickles with the feeling of movement caused by [back adornments of Player]."]
	now Back Skin Adjective entry is ""; [one word adjective (feathered/furred/scaly/...); EMPTY "" for creatures with just skin]
	now Back Color entry is ""; [single word color adjective for the dominant color of the skin/fur/feathers/scales]
	[Limbs Adjective is generated by a function and can be used in scenes too - "rail-thin, slender, sinewy, average, firm, muscular, flabby, meaty, rippling"]
	now Arms Change entry is ""; [partial sentence that fits in: "Your arms [one of]tingle[or]go flush[or]vibrate with odd pleasure[or]go cold[or]feel oily[at random] as [Arms Change entry]."]
	now Arms Description entry is ""; [partial sentence to fit: "Your [Limbs Adjective of Player] arms are [Arms Description of Player]."]
	now Arms Skin Adjective entry is ""; [one word adjective (feathered/furred/scaly/...); EMPTY "" for creatures with just skin]
	now Arms Color entry is ""; [single word color adjective for the dominant color of the skin/fur/feathers/scales]
	now Locomotion entry is ""; [one word adjective: (bipedal/quadrupedal/octapedal/serpentine/sliding)]
	now Legs Change entry is ""; [partial sentence that fits in: "Your legs [one of]tingle[or]go flush[or]vibrate with odd pleasure[or]go cold[or]feel oily[at random] as [Legs Change entry]."]
	now Legs Description entry is ""; [partial sentence to fit: "As your inspection goes even lower, you come to the two [Body Adjective of Player] legs supporting you. They are [legs description of Player]."]
	now Legs Skin Adjective entry is ""; [one word adjective (feathered/furred/scaly/...); EMPTY "" for creatures with just skin]
	now Legs Color entry is ""; [single word color adjective for the dominant color of the skin/fur/feathers/scales]
	now Ass Change entry is ""; [partial sentence that fits in: "Your ass [one of]tingles[or]goes flush[or]vibrates with odd pleasure[or]goes cold[or]feels oily[at random] as [Ass Change entry]."]
	now Ass Description entry is ""; [partial sentence to fit: "Using your hands you feel your behind enjoying the sensation of your [Ass Width Adjective of Player], [Ass Shape Adjective of Player] [Ass Description of Player]." (For players with skin, instead of the period: ", covered in [Ass Color of Player] skin and [Body Hair Description of Player]"]
	now Ass Skin Adjective entry is "";  [one word adjective (feathered/furred/scaly/...); EMPTY "" for creatures with just skin]
	now Ass Color entry is ""; [single word color adjective for the dominant color of the skin/fur/feathers/scales]
	now Ass Width entry is 3; [ass width from 1-5]
	[Ass Width Adjective generated by function out of ass width: dainty/small/round/huge/enormous]
	[Ass Adjective generated by function out of body definition and ass width]
	now Tail Change entry is ""; [partial sentence that fits in: "Your rear [one of]tingles[or]goes flush[or]vibrates with odd pleasure[or]goes cold[or]feels oily[at random] as [if HasTail of Player is true]your existing tail is changed into a [Tail Description entry][else][Tail Change entry][end if]."]
	now Tail Description entry is ""; [partial sentence to fit: "Just below your lower back sprouts a [tail description of Player], which you move back and forth with glee."]
	now Tail Skin Adjective entry is ""; [one word adjective (feathered/furred/scaly/...); EMPTY "" for creatures with just skin]
	now Tail Color entry is ""; [single word color adjective for the dominant color of the skin/fur/feathers/scales]
	now Asshole Depth entry is 7; [inches deep for anal fucking]
	[Asshole Depth Adjective is generated by a function and can be used in scenes too - "petite (< 3), shallow (< 5), average (< 9), deep (< 15), bottomless (15+)"]
	now Asshole Tightness entry is 3; [asshole tightness 1-5, "extremely tight, tight, receptive, open, gaping"]
	[Asshole Tightness Adjective is generated by a function and can be used in scenes too - "extremely tight, tight, receptive, open, gaping"]
	now Asshole Color entry is ""; [one word color descriptor]
	now Cock Count entry is 0;
	now Cock Girth entry is 0; [thickness 1-5, generates the Cock Girth Adjective]
	[Cock Girth Adjective is generated by a function and can be used in scenes too: thin/slender/average/thick/monstrous]
	now Cock Length entry is 0; [length in inches]
	now Cock Adjective entry is ""; [one word adjective: avian/canine/...]
	now Cock Change entry is ""; [partial sentence that fits in: "Your cock [one of]tingles[or]goes flush[or]vibrates with odd pleasure[or]goes cold[or]feels oily[at random] as [Cock Change entry]."]
	now Cock Description entry is ""; [partial sentence to fit: "You have a [Cock Girth Adjective of Player], [Cock Length of Player]-inch-long [cock adjective of Player] [one of]cock[or]penis[or]shaft[or]maleness[at random] that [cock description of Player]."]
	now Cock Color entry is ""; [one word color descriptor]
	now Ball Count entry is 0; [allowed numbers: 1 (uniball), 2 or 4]
	now Ball Size entry is 0; [size of balls 1-7: "acorn-sized", "dove egg-sized", "chicken egg-sized" "goose-egg sized", "ostrich-egg sized", "basketball-sized", "beachball-sized"]
	[Ball Size Adjective is generated by a function and can be used in scenes too]
	now Ball Description entry is ""; [partial sentence to fit: "Underneath it hangs a pair of [Ball Size Adjective of Player] [ball description of Player]."]
	now Cunt Count entry is 0;
	now Cunt Depth entry is 0; [penetratable length in inches; some minor stretching allowed, or more with Twisted Capacity]
	now Cunt Tightness entry is 0; [size 1-5, generates adjectives of extremely tight/tight/receptive/open/gaping]
	[Cunt Tightness Adjective is generated by a function and can be used in scenes too: extremely tight/tight/well-used/open/gaping]
	now Cunt Adjective entry is ""; [one word adjective: avian/canine/...]
	now Cunt Change entry is ""; [partial sentence that fits in: "Your pussy [one of]tingles[or]goes flush[or]vibrates with odd pleasure[or]goes cold[or]feels oily[at random] as [Cunt change entry]."]
	now Cunt Description entry is ""; [partial sentence to fit: "You have a [Cunt Tightness Adjective of Player] [one of]cunt[or]pussy[or]vagina[or]cleft[at random] that [cunt description of Player]."]
	now Cunt Color entry is ""; [one word color descriptor]
	now Clit Size entry is 0; [size 1-5, see Clit Size Adjective]
	[Clit Size Adjective is generated by a function and can be used in scenes: very small/small/average/large/very large]
]

Section 3 - Endings

[
Table of GameEndings (continued)
Name (text)	Type (text)	Subtype (text)	Ending (rule)	Priority (number)	Triggered (truth state)
"Valkyrie Boi Infection"	"Infection"	""	Valkyrie Boi Infection rule	1000	false

This is the Valkyrie Boi Infection rule:
	if Player has a body of "Valkyrie Boi":
		trigger ending "Valkyrie Boi Infection"; [Here it states, that the ending has been played.]
		if humanity of Player < 10:
			say "     ...";
		else:
			say "     ...";
]

Valkyrie ends here.
