Anthro Shaft Beast For FS by Guest Writers begins here.
[- Originally Authored By:  DragonFlayer -]

"Adds an Anthro Shaft Beast to Flexible Survival's Sewer Monsters table"

Section 1 - Monster Responses


when play begins:
	add { "Anthro Shaft Beast" } to infections of hermaphrodite;

to say shaft beast attack:
	if cunts of player is greater than 0:
		say "     The beast grins at you lustfully as you fall on your rear after the last strike lands on you. 'No more games...' says a voice coming from nowhere, but by the way the creature smiles, it has to be her. An unseen force suddenly pushes you down to lay on your back and spreads your legs wide apart. Your clothes are pulled away carefully by the same invisible hands, uncovering your [bodytype of player] form. She then kneels down, taking your legs and spreading them wider apart with her large and powerful hands, rubbing the gigantic equipment between your legs as she looks over your [bodydesc of player] body.";
		say "     She presses her oversized cock against your [cunt size desc of player] slit. Her spire throbs hard and adjusts in size to better please you, to make it fit tightly and slightly stretch you wider than your current limits. She gives no second thoughts and thrusts in to the hilt after the adjustment, making you cry out in bliss as her spire seems to rub against all the right places. After the initial thrust she lowers her face to yours, pressing her snout against your face. She begins to lick all around, kissing and suckling over your neck and chest as she pumps her spire back and forth with such a gentle pace that you can't help but relax and enjoy yourself at the hands of the now loving beast...";
		say "     You swear you hear a song in the distance... but among the bliss this creature gives, it doesn't matter. Her pace increases randomly, but at the perfect moments, as if this monster has been your life long companion and knew all the tricks of your body. She makes you moan and shake in lust, soon suckling on her tongue all on your own, your arms and legs wrapped and tightly squeezing the beast against you willingly as you move along with her thrusts in perfect union. After several blissful moments, your release and the creature's own mix and join in a wonderful tide of bliss that makes you lose all grasp on reality...";
		say "     You wake up later with a wide smile and a deep blush, your clothes neatly folded at your side and your body covered from head to toe in the creature's juices. She is nowhere to be seen, but you feel like you would see her again. Your belly is quite rounder than before and you feel things moving and tickling inside it. You hope it's just your imagination or the savage good time you had not so long ago.[line break][impregchance]";
		sharethebliss;
	else:
		if libido of player is greater than 50:
			say "     The beast grins at you lustfully as you fall on your rear after the last strike lands on you. 'No more games...' says a voice coming from nowhere, but by the way the creature smiles, it has to be her. An unseen force suddenly pushes you down to lay on your back and spreads your legs wide apart. Your clothes are pulled away carefully by the same invisible hands, uncovering your [bodytype of player] form. She then kneels down, taking your legs and spreading them wider apart with her large and powerful hands, rubbing the gigantic equipment between your legs as she looks over your [bodydesc of player] body. She then presses her oversized cock against your pucker...";
			say "     Her spire throbs hard and then shoots a thick glob of her pre against your rear, probing in to fill you with it a bit. You felt weird, tickles spreading in your lower body as she gives no second thoughts and thrusts in to the hilt with her gigantic spire, making you cry out in bliss as her spire seems to rub against all the right places. You are surprised that you can take it all, you were worried that she would split you in half... But instead, you're in a world of bliss. There isn't even a single bit of pain, your stomach bulging out profusely, the shape of the monster's spire showing even the smallest veins. After the initial thrust she lowers her face to yours, pressing her snout against your face.";
			say "     She begins to lick all around, kissing and suckling over your neck and chest as she begins to pump her spire back and forth with such a gentle pace that you can't help but relax and enjoy yourself at the hands of the now loving beast. You swear you heard a song in the distance, but among the bliss this creature gave, it doesn't matter. Her pace increases randomly, but at the perfect moments, as if this monster has been your life long companion and knew all the tricks of your body. She makes you moan and shake in lust. You are soon suckling on her tongue all on your own, your arms and legs wrapped and tightly squeezing the beast against you willingly as you move along with her thrusts in perfect union. After several blissful moments, your release and the creature's own mix and join in a wonderful tide of bliss that makes you lose all grasp on reality...";
			say "     You wake up later with a wide smile and a deep blush, your clothes neatly folded at your side and your body covered from head to toe in the creature's juices. She is nowhere to be seen, but you feel like you would see her again...[line break]";
			sharethebliss;
		else:
			say "     The beast giggles at your brave attempt to resist. She approaches and smiles widely as you lay on your back, exhausted and pinned down by some unseen force. She kneels between your legs, spreading them apart. Using her throbbing fingers, she rubs and caresses over your belly and chest, your clothes evaporated before your eyes as the bizarre monster explores your [bodytype of player] body with those thick dripping fingers. Her massive prehensile cock tongue and those six tentacles feel every part of you, though avoiding your groin as she explores...";
			say "     Then she pulls away and smiles, turning around to reveal her massive, swollen, drooling cunt. She sits down on your face, pushing your whole head inside it, bathing your [bodydesc of player] form in her juices and overwhelming you with a powerful female musk that burns your lungs and drills into your mind. It is too much for you and eventually you lose your consciousness. By the time you wake up, the creature is gone and you find yourself covered from head to toe in the creature's female musk. Your clothes neatly have been folded to a side as if they had never disintegrated and... Feel a bit... Different...[line break]";
			sharethebliss;

to say shaft beast defeat:
	if libido of player is greater than 60:
		if cocks of player is greater than 0:
			say "     The creature hisses and lands on her rear after your last strike, panting and exhausted. She just lays there, exposing her features to you submissively. The powerful scents and the sight proves too much for your own need. The creature smiles as you approach, the skin of her head growing darker. She is blushing and she just spreads her legs wider for you. Undressing and immediately taking hold of her legs, she presents her massive slit to you, and then the swollen opening changes, adjusting to become a tight fit for you. You grin widely at the sight; this creature wants you to ravage and fuck it mindless alright.";
			say "     In a blink, your [bodytype of player] form is atop her and thrusting your spire deep into the willing monster without any inhibitions, pumping roughly and spanking her rear with your groin every powerful thrust. The beast moans out for you, every throbbing spire on her body drooling heavily, as does every nipple, your pace increasing, her scent driving you mad with lust and at the climax of it all, you release your seed deep within the beast, who roars in pure bliss as her own body is shaken by blissful orgasm, making a huge mess like no other, your body being covered from head to toe with her many juices. Once you are done, you pull out and kiss the creature's horns and face lustfully, and she kisses your neck and lets you go. For some reason, the beast must have allowed you to walk away unchanged; you are certain that they could infect with just a touch, but it seems they have control over to whom and when infection happens. You just go on your way, satisfied.[line break]";
			decrease humanity of player by 5;
		else:
			if cunts of player is greater than 0:
				say "     The creature hisses and lands on her rear after your last strike, panting and exhauste. She just lays there, exposing her features to you submissively. The powerful scents and the sight proves too much for your own need, and the creature smiles as you approach, the skin of her head growing darker. She is blushing and she just spreads her legs wider for you. Undressing and moving over the large pillar of flesh between her legs, you prepare to slip and slide along the gigantic spire. It throbs hard and firsd juices against your slit and thighs, the mess spreading over your crotch...";
				say "     You don't mind a bit as you just lower yourself and gasp out loudly once your female lips kiss the tip of that large spire.. and you stretch around it as if made of rubber, while still feeling very tight against it.. you moan out louder as you lower more of yourself along that huge rod... Sliding smoothly without effort, it even seems to grow bigger inside you, before you noticed how much you had taken, your cunt was kissing the beast's crotch and the shape of it's massive rod could be seen on your belly with every detail, you panted and moaned lustfully as the creature took hold of your hips and together you began to hump and bounce against each other in the best ride you have had in a while, the beast was not an amateur, it knew where and when to touch, as if she had a map of your body, she made you moan like no one else had before, by the time you both were too engulfed in your own pleasure, your [bodydesc of player] body then shakes in the bliss of one of the most powerful orgasms in your life, the creature doesn't hold any longer, blasting your insides with buckets of it's seed... Making your belly swell large and round quickly.";
				say "     The pressure enough to help you pull away from the shooting spire, the creature roared and painted your body with her seeds.. your legs shake as you fall against the creature, you smiled widely.. approaching her face and then you kissed the creature's horns and face lustfully, she kissed your neck and let you go.. for some reason, the beast must have allowed you to walk away unchanged, you were certain that they could infect with just a touch.. but it seems they have control over who and when infection happens... You just went on your way, satisfied and with a large, full, sloshing belly that sometimes wiggled oddly...[line break][impregchance]";
				decrease humanity of player by 5;
	else:
		say "     The creature hisses and steps away from you after your last strike, you felt a strong headache, closing your eyes, you covered your ears as if a hundred harpies were yelling at you.. when the horrible screech was gone, you opened your eyes and the beast was gone, escaping while you were stunned.[line break]";

Section 2 - Monster Insertion

Table of random critters (continued)
name	attack	defeated	victory	desc	face	body	skin	tail	cock	face change	body change	skin change	ass change	cock change	str	dex	sta	per	int	cha	sex	hp	lev	wdam	area	cocks	cock length	cock width	breasts	breast size	male breast size	cunts	cunt length	cunt width	libido	loot	lootchance	scale (number)	body descriptor (text)	type (text)	magic (truth state)	resbypass (truth state)	non-infectious (truth state)	nocturnal (truth state)	altcombat (text)
--	--	--	--	--	--	--	--	--	--	--	--	--	--	--	--	--	--	--	--	--	--	--	--	--	--	--	--	--	-- 	--	--	--	--	--	--	--	--	--	--	--	--	--	--	--	--;

When Play begins:
	Choose a blank row from Table of random critters;
	now name entry is "Anthro Shaft Beast"; [Name of your new Monster]
	now attack entry is "[one of]You feel a powerful kick hit your stomach, but she didn't move, the monster is just standing there, smiling ominously[or]A strong uppercut was delivered to your chin, or so you think, the unmoving creature just grins at you[or]Her heavy tail lashes at you, forcing you to land on your rear, she giggles as you recover from the impact[or]She opens her maw widely, her obscene cock tongue aiming at you and shooting straight at your face with pressure and force of a fire hose[or]A Pair of the monster's rear tendrils swing at you and strike your chest like twin whips[at random]."; [Text used when the monster makes an Attack]
	now defeated entry is "[shaft beast defeat]"; [ Text or say command used when Monster is defeated.]
	now victory entry is "[shaft beast attack]"; [ Text used when monster wins, can be directly entered like combat text or description. or if more complex it can be linked to a 'To Say' block as the demonstration text shows.]
	now desc entry is "[mongendernum 5]     You see someone approach, a fellow survivor? in a place like this? you were already filling with joy as you saw it was a normal human [one of]male[or]female[at random] completely nude. However, your joy doesn't last long as the fellow survivor grins at you and an odd feeling invades you, one of lust and fear, along with other alien sensations you had never felt before, when you snapped out of it, there is a powerful musk in the air that filled your lungs and immediately made your body tingle with arousal, you no longer saw a survivor, but a monster that took a few minutes to understand, the strange, bizarre creature chuckled and posed for you, showing her obscene and exaggerated features. Before you is an abomination of Purple Flesh, standing on large feet with 5 throbbing cocks instead of toes, the same could be said of her hands, the Creature had an impressive breeding tool standing proud at 3 feet, with several ridges and a barbed tip, along the underside of said cock, hang 8 golf ball sized [']tits['] that drip eagerly with a thick almost cum-like white goo that made you wonder if that was actually milk, hanging heavily under the massive medieval torture device is a ball sack that you swear must be packing 4 watermelon sized testicles, her chest and belly were swollen with six G cup sized breasts, each with an orange sized nipple, the monster's neck and the base of every breast had rings of large round nubs that you could only recognize as clitorises the size of a grape, the breasts only had one ring, but her neck had 4 evenly spread along it. Her head was also alarming, a combination of a pointy cock and the snout of a dragon. There were no eyes, nose or ears... Just the wide maw of the creature over the smooth surface of a cock-like head with a pair of long cock shaped [']horns['] that dripped and spurted constantly with her musk. Behind her you see 6 tentacles with pointy cock heads at the tips, thicker than a baseball and 5 feet long each, her tail also is an obscene show, thick as one as her legs and heavy, the underside covered from base to the large, fat cocktip at the end with rows of heavy dripping tits, you couldn't bear to see more, but you knew that behind that gigantic testicles there must be a massive cunt, swollen and dripping, the female musk she spread around, along with the male one were drilling into your mind. This creature must certainly be draconian in nature, or was, all male genitalia on her body is generally shaped after dragon genitals. The highly sexual creature pulsed and throbbed from everywhere, dripping and shining with a thick layer of her own juices.... She approaches quickly, ready to give you a rather blissful fate.[line break]";[ Description of the creature when you encounter it.]
	now face entry is "mix of cock and dragon head, your head was smooth and faceless, half of it shaped like a dragon cock, but the front had more snout-like proportions, you still had lips and the insides of your maw and throat feel a lot like female genitalia, your [']fangs['] are a bunch of clitoris actually, just brushing your massive 2 feet long prehensile tentacle-like cock-tongue around the insides make you moan sluttily and make a blissful face";[ Face description, format as the text "You have a (your text) face."]
	now body entry is "a blissful symphony, it pulses and constantly throbs at any stimulation, there were six cunts along the sides of your spine arranged in parallel like the breasts in front of you, each wide cunt drooling heavily as your six thick cock tentacles push and wiggle out from each cunt at 5 feet from base to tip and thicker than a baseball, highly prehensile and moving on their own as if they had minds of their own, your hands and feet were quite large, each finger and toe were replaced with prehensile foot-long cocks, your belly tingles constantly, you feel things moving inside, living things";[ Body Description, format as the text "Your Body is (your text)"]
	now skin entry is "purple, veiny and slick cock-like";[ skin Description, format as the text "You have (your text) skin"]
	now tail entry is "Your tail is heavy and thick as one of your legs, slightly longer than one as well. The tip is a large swollen pointy cock head which is almost the size of your own penile head. The underside of the tail is covered with rows of breasts from its base to the glans of the cock tip, the breasts being larger at the base and smaller around the tip.";[ Tail description, write a whole Sentence or leave blank. ]
	now cock entry is "[if looknow is 1]draconian shaped cock tip, as well as 8 small breasts along its underside, proportional to the size of your tool, your manhood is also ridged along the sides and barbed all over the glans and edges, quite an interesting[else]draconian and breasted[end if]";[ Cock Description, format as you have a 'size' (your text) cock]
	now face change entry is "it pops and swells, pushing forward, your eyes close and cease to exist, along with your nose and ears, all facial features gone except for your lips which spread wider, your face pushing into a draconian snout, while the back of your head takes a penile approach with small barbs around the edges, a pair of foot-long cock shaped horns grow at the back of your head, each dripping heavily with male musk, just as your lips drooled with female juices, your tongue swells and pushes out like a powerful tendril, 2 feet long and thick as a golf ball, drooling from the now swollen cock head at the tip, your neck swells and pulses as 4 rings of round bumps swell evenly along it, each bump taking the shape of grape sized clitorides"; [ face change text. format as "Your face feels funny as (your text)" ]
	now body change entry is "it swells and pulse all over, moans escaping your lips as you rub your body in corrupted lust, your hands and feet swelling large, each finger and toe extending, pulsing and then growing into foot-long sized cocks, six cunts swell and split open along your spine, your back dripping as they drooled heavily and then spread wide open to allow six 5 feet long tentacles to slide out and wiggle around out of control, each thick as a baseball"; [ body change text. format as "Your body feels funny as (your text)" ]
	now skin change entry is "it tingles and pulses as purple shades spread all over it, veins showing here and there and then you feel unbearable heat spread all over, your body releasing a thick layer of musky sweat that coats you from head to toe, making your skin glisten and drip"; [ skin change text. format as "Your skin feels funny as (your text)" ]
	now ass change entry is "it trembles and tickles, as you grow a massive cock tail and it curls up proudly, flopping down shortly after with the weight of the many rows of breasts spreading over it's underside, the cocktip swelling till it almost matches the size of your head and it's slit drools heavily immediately"; [ ass/tail change text. format as "Your ass feels funny as (your text)" ]
	now cock change entry is "it swells and throbs, the pulse made change spread from base to tip, first the ridges along the sides, followed by 8 small dripping tits swelling along it's underside, then the tip becomes point and drools heavily, barbs spreading over the glans and edges"; [ cock change text. format as "Your cock feels funny as (your text)" ]
	now str entry is 20;
	now dex entry is 12;
	now sta entry is 19;
	now per entry is 22;
	now int entry is 32;
	now cha entry is 10;
	now sex entry is "Both"; 	[ Defines which sex the infection will try and make you. current options are 'Male' 'Female' 'Both']
	now hp entry is 60;
	now lev entry is 8; [ Level of the Monster, you get this much hp if you win, or this much hp halved if you loose ]
	now wdam entry is 12; [Amount of Damage monster Does when attacking.]
	now area entry is "Mall"; [ Current options are 'Outside' and 'Mall' Case sensitive]
	now cocks entry is 1; [ How many cocks will the infection try and cause if sex is 'Male' or 'Both']
	now cock length entry is 36; [ Length infection will make cock grow to if cocks]
	now cock width entry is 24; [ Size of balls apparently ;) sneaky Nuku]
	now breasts entry is 6; [ Number of Breasts infection will give you. ]
	now breast size entry is 10; [Size of breasts infection will try to attain ]
	now male breast size entry is 0; [ Breast size for if Sex="Male", usually zero. ]
	now cunts entry is 1; [ if sex = "Female or both", indicates the number of female sexes infection will grant you.]
	now cunt length entry is 36; [ Length of female sex infection will attempt to give you. ]
	now cunt width entry is 24; [ Width of female sex infection will try and give you ]
	now libido entry is 80; [ Amount player Libido will go up if defeated ]
	now loot entry is "psionic egg";
	now lootchance entry is 50; [ Chance of loot dropping 0-100 ]
	now scale entry is 3; [ Number 1-5, approx size/height of infected PC body: 1=tiny, 3=avg, 5=huge ]
	now body descriptor entry is "[one of]hyper-sexualized[or]twisted[or]genital-covered[as decreasingly likely outcomes]";
	now type entry is "mutant"; [ one-word creature type. Ex: feline, canine, lupine, robotic, human... Use [one of] to vary ]
	now magic entry is false;
	now resbypass entry is false; [ Bypasses Researcher bonus? true/false (almost invariably false) ]
	now non-infectious entry is false; [ Is this a non-infectious, non-sheftable creature? True/False (usually false) ]
	blank out the nocturnal entry; [ True=Nocturnal (night encounters only), False=Diurnal (day encounters only), blank for both. ]
	now altcombat entry is "default"; [ Row used to designate any special combat features, "default" for standard combat. ]

to sharethebliss:
	infect "Anthro Shaft Beast";
	increase libido of player by 25;
	if "Horny Bastard" is listed in feats of player, increase libido of player by 4;
	if "Cold Fish" is listed in feats of player, decrease libido of player by 4;
	decrease humanity of player by a random number between 0 and 1;
	if "Strong Psyche" is listed in feats of player, increase humanity of player by a random number between 0 and 1;
	if "Weak Psyche" is listed in feats of player, decrease humanity of player by a random number between 0 and 1;


an everyturn rule:
	if bodyname of player is "Anthro Shaft Beast" or bodyname of player is "Feral Shaft Beast":
		say "[broodmother call]";

to say broodmother call:
	if humanity of player is greater than 90:
		say "You hear a beautiful song in the distance.";
		increase libido of player by 4;
		decrease humanity of player by 1;
		if "Strong Psyche" is listed in feats of player, increase humanity of player by a random number between 0 and 1;
		if "Weak Psyche" is listed in feats of player, decrease humanity of player by a random number between 0 and 1;
	else if humanity of player is greater than 70:
		say "Your legs feel weak, a soft tender voice speaks to you, the beautiful sound caresses your body, the back of your mind pulsing with joy, you smile.. enraptured by the strong entity speaking to you in unknown tongues.. then you snap out of it with a loud gasp, looking around with worry.. you had never felt such thing, you felt as if you were being watched from every corner.. and moved quickly to another spot, the feeling of being stared at never going away...[line break]";
		increase libido of player by 6;
		if "Horny Bastard" is listed in feats of player, increase libido of player by 1;
		if "Cold Fish" is listed in feats of player, decrease libido of player by 1;
		decrease humanity of player by 2;
		if "Strong Psyche" is listed in feats of player, increase humanity of player by a random number between 0 and 1;
		if "Weak Psyche" is listed in feats of player, decrease humanity of player by a random number between 0 and 1;
	else if humanity of player is greater than 50:
		say "The voice continues drilling slowly into your mind, you feel helpless, unable to ignore it, but why would you?... it was so beautiful.. so powerful and it felt as if it was speaking to you and only you.. as if this entity from nowhere had eyes only for you, you couldn't help but lay down and smile, caressing your wonderful, sexy, strong body.. stroking your tendrils, making them coil and rub all over yourself.. it took hours for you to regain your control and leave.. you were dripping with arousal, part of you just wanted to give in and follow the voice's instructions.. you could understand the voice sometimes...[line break]";
		increase libido of player by 8;
		if "Horny Bastard" is listed in feats of player, increase libido of player by 2;
		if "Cold Fish" is listed in feats of player, decrease libido of player by 2;
		decrease humanity of player by 3;
		if "Strong Psyche" is listed in feats of player, increase humanity of player by a random number between 0 and 2;
		if "Weak Psyche" is listed in feats of player, decrease humanity of player by a random number between 0 and 2;
	else if humanity of player is greater than 20:
		say "You cannot help but hissss in delight as you feel a tender caress run across your spine, the voice is at it again, but now.. you feel hands.. and kisses spreading all over your body.. invisible lips pressing against your most sensitive parts. invisible.. tender fingers caressing every inch of your body, your arousal burning like the sun, your body so warm, you feel those fingers dig into you.. caressing your insides.. touching.. your mind, then bliss, endless bliss lighting every fiber of your body, by the time you wake up, you let a silent cry escape your lips, you had hoped it would never end... your head hurts badly, you want more.. The Broodmother's call.. you cannot wait for the next one...[line break]";
		increase libido of player by 10;
		if "Horny Bastard" is listed in feats of player, increase libido of player by 3;
		if "Cold Fish" is listed in feats of player, decrease libido of player by 3;
		decrease humanity of player by 5;
		if "Strong Psyche" is listed in feats of player, increase humanity of player by a random number between 1 and 3;
		if "Weak Psyche" is listed in feats of player, decrease humanity of player by a random number between 1 and 2;
	else:
		say "[one of]'Come to me, my beautiful child.. we await for your offering...'[or]'Join usssssss...'[or]'Resssssist no further...'[or]'We are waiting for you...'[at random] said the Broodmother from her hive, reaching out at you with waves of lust, places.. experiences from the past.. and the present flash before your eyes, the Broodmother giving you a mental map, preparing you for the long trip and your joining to her blissful Hive...[line break]";
		if bodyname of player is "Anthro Shaft Beast":
			sharethebliss;
		else if bodyname of player is "Feral Shaft Beast":
			sharethelust;

when play ends:
	if bodyname of player is "Anthro Shaft Beast":
		if humanity of player is less than 10:
			say "     Day by day the Broodmother's voice grows stronger, her tempting, enthralling voice soothes your troubled mind, she makes you forget of your worries and your old self, you give in at last, the Broodmother's joy at your own willing bliss made the most beautiful song you had ever heard, the neural network lighting up, every node calling and pulling on you, the song driving you into the underground, towards the Shaft Beast Hive, to meet a new blissful fate, serving under the beautiful and terrible Broodmother.. eventually she makes of you her favorite child, her second in command as you take care of your Mother's constantly growing family, at her side...";
		else:
			say "     Somehow you manage to resist the powerful voice of the Broodmother till rescue arrived, you feel your body pulse madly, demanding that you join the other abominations like yourself, your obscene body makes it hard for you to move on and the Broodmother's constant demands drive you mad day by day, but you hold yourself together, you were not going to submit to it or anyone else, the Military find you to be extremely infectious after you made dozens of them change with only your musk! They found no way to contain you or your infectious nature, instead, they decided to [']put you out of your misery['], but you would have none of that, with a soft swing of your fingers you fried minds, took down Choppers and sent Tanks flying away, escaping the military you find a nice, warm cave to hide and lie down, deciding to live in there you just accept your new self... After a few months of your lonely existence, you find out that you were not like other Shaft Beast.. you were different, stronger and after a few weeks, you couldn't hear the Broodmother's voice anymore. Something had changed, you did... your lips twisting into a wicked grin as you could feel it, YOU were the Broodmother now, the children of the old one now listening to your call, feeling your lust and bliss. This world just waits for the endless sea of bliss you shall bring to it now...";

Table of Game Objects(continued)
name	desc	weight	object
"psionic egg"	"An strange purple fleshy egg constantly [']sweating['] with a clear musky goo, you feel odd while holding it and you swear you heard someone whisper nearby"	1	psionic egg

psionic egg is a grab object.
psionic egg is infectious. The strain of psionic egg is "Anthro Shaft Beast".
the usedesc of psionic egg is "You hold the egg tightly in your hands, and as you look at it you hear a beautiful enthralling voice calling out at you. When you come to your senses, the egg has melted and it's now being absorbed by your skin...[line break]";

the scent of psionic egg is "The purple, fleshy egg has the musky scent of sex lingering over it.".


Anthro Shaft Beast For FS ends here.
