Anthro Shaft Beast by Guest Writers begins here.
[- Originally Authored By: DragonFlayer -]

"Adds an Anthro Shaft Beast to Flexible Survival's Sewer Monsters table"

Section 1 - Creature Responses

to say shaft beast victory:
	if Player is female:
		say "     The beast grins at you lustfully as you fall on your rear after her last strike lands. 'No more games...' says a voice coming from nowhere, but by the way the creature smiles, it has to be her. An unseen force suddenly pushes you down to lay on your back and spreads your legs. Your clothes are pulled away carefully by the same invisible hands, uncovering your [bodytype of Player] form. She then kneels down, taking your legs and spreading them wider apart with her large and powerful hands, rubbing her gigantic equipment between your legs as she looks over your [bodydesc of Player] body.";
		say "     She presses her oversized cock against your [cunt size desc of Player] slit. Her spire throbs hard and adjusts in size to better please you, to make it fit tightly and slightly stretch you wider than your current limits. She gives no second thoughts and thrusts to the hilt after the adjustment, making you cry out in bliss as her spire rubs against all the right places. After the initial thrust, she lowers her face to yours, pressing her snout against your face. She begins to lick all around, kissing and suckling over your neck and chest as she pumps her spire back and forth with such a gentle pace that you can't help but relax and enjoy yourself at the hands of the now loving beast.";
		say "     You swear you hear a song in the distance, but among the pleasure this creature gives you, it doesn't matter. Her pace increases randomly, but at the perfect moments, as if this monster has been your lifelong companion and knew all the tricks of your body. She makes you moan and shake in lust. You are soon suckling on her tongue on your own volition, your arms and legs wrapped around her tightly and squeezing the beast against you as you move along with her thrusts in perfect union. After several long minutes of this, your release and the creature's own mix and join in a wonderful tide of bliss that makes you lose all grasp on reality.";
		say "     You wake up later sometime later, your clothes neatly folded at your side and your body covered from head to toe in the creature's juices. She is nowhere to be seen, but you feel like you will see her again. Your belly is noticeably rounder than before, and you feel things moving and tickling inside it. You hope it's just your imagination or the savagely enjoyable sex you had not so long ago.[line break][impregchance]";
		sharethebliss;
	else if Libido of Player > 49:
		say "     The beast grins at you lustfully as you fall on your rear after her last strike lands. 'No more games...' says a voice coming from nowhere, but by the way the creature smiles, it has to be her. An unseen force suddenly pushes you down to lay on your back and spreads your legs. Your clothes are pulled away carefully by the same invisible hands, uncovering your [bodytype of Player] form. She then kneels down, taking your legs and spreading them wider apart with her large and powerful hands, rubbing her gigantic equipment between your legs as she looks over your [bodydesc of Player] body. She then presses her oversized cock against your pucker.";
		say "     Her spire throbs hard and then spurts a thick glob of her pre against your rear, the tip probing your rim to smear it along your inner walls. You feel strange, a rush of warm tingles spreading through your lower body. After adjusting herself, she gives no second thoughts and thrusts to the hilt, making you cry out in bliss as her gigantic spire rubs against all the right places. You are surprised that you can take it all, initially worried that she would split you in half... but instead, you're in a world of bliss. There isn't even a single bit of pain, your stomach bulging out profusely, the shape of the monster's spire showing even the smallest veins. After the initial thrust, she lowers her face to yours, pressing her snout against your face.";
		say "     She begins to lick all around, kissing and suckling over your neck and chest as she begins to pump her spire back and forth with such a gentle pace that you can't help but relax and enjoy yourself at the hands of the now loving beast. You swear you hear a song in the distance, but among the pleasure this creature gives you, it doesn't matter. Her pace increases randomly, but at the perfect moments, as if this monster has been your lifelong companion and knew all the tricks of your body. She makes you moan and shake in lust. You are soon suckling on her tongue on your own volition, your arms and legs wrapped her tightly and squeezing the beast against you as you move along with her thrusts in perfect union. After several long minutes of this, your release and the creature's own mix and join in a wonderful tide of bliss that makes you lose all grasp on reality.";
		say "     You wake up sometime later, your clothes neatly folded at your side and your body covered from head to toe in the creature's juices. She is nowhere to be seen, but you feel like you will see her again...[line break][mimpregchance]";
		sharethebliss;
	else:
		say "     The beast giggles at your brave attempt to resist. She approaches and smiles widely as you lay on your back, exhausted and pinned down by some unseen force. She kneels between your legs, spreading them apart. Using her throbbing fingers, she rubs and caresses over your belly and chest, your clothes evaporating before your eyes as the bizarre monster explores your [bodytype of Player] body with those thick, dripping fingers. Her massive, prehensile cocktongue and those six tentacles feel over every part of you, though avoid your groin as she explores.";
		say "     She then pulls away and smiles, turning around to reveal her massive, swollen, drooling cunt. She sits down on your face, pushing your whole head inside of it, bathing your [bodydesc of Player] form in her juices and overwhelming you with powerful female musk that burns your lungs and drills into your mind. It is too much for you and you eventually lose consciousness. By the time you wake up, the creature is gone and you find yourself covered from head to toe in the creature's female musk. Your clothes have been neatly folded at your side, as if they had never disintegrated, and they feel a bit... different, now.[line break]";
		sharethebliss;

to say shaft beast defeat:
	if Libido of Player > 59:
		if Player is male:
			say "     The creature hisses and lands on her rear after your last strike, panting and exhausted. She just lays there, exposing her features to you submissively. The sight and the powerful scents prove too much for your own need, and the creature smiles as you approach, the skin of her head growing darker as she blushes. Undressing and immediately taking hold of her legs, she spreads her legs wider presents her massive slit to you, and then the swollen opening changes, adjusting to become a tight fit for you. You grin widely at the sight; this creature wants you to ravage and fuck it mindless alright.";
			say "     In a blink, your [bodytype of Player] form is atop her and thrusting your spire deep into the willing monster without any inhibitions, pumping roughly and slamming against her on every powerful thrust. The beast moans out for you, every throbbing spire and nipple on her body drooling heavily, her scent driving you mad with lust. At the climax of it all, you release your seed deep within the beast, who roars in ecstasy as her own body is shaken by a blissful orgasm, making a huge mess like no other, your body splattered from head to toe in her many juices.";
			say "     Once you are done, you pull out and kiss the creature's horns and face lustfully, and she kisses your neck and lets you go. For some reason, the beast must have allowed you to walk away unchanged; you are certain that they could infect with just a touch, but it seems they have control over to whom and when infection happens. You just go on your way, satisfied.[line break]";
		else if Player is female:
			say "     The creature hisses and lands on her rear after your last strike, panting and exhausted. She just lays there, exposing her features to you submissively. The sight and the powerful scents prove too much for your own need, and the creature smiles as you approach, the skin of her head growing darker as she blushes. Undressing and moving over the large pillar of flesh between her legs, you prepare to slide down the beast's gigantic spire. It throbs hard and spurts sticky juices against your slit and thighs, the mess spreading over your crotch.";
			say "     You don't mind a bit as you begin to lower yourself on her flaring glans, moaning out loud as your nethers grind against the drooling cocktip. Generously lubricated by her essence, your folds wrap around her cock like they're made of rubber, yet it still feels like a very tight and enjoyable fit. You lower more of yourself down that huge, pulsing rod, sliding smoothly down her slickened flesh. It seems to grow even bigger inside you, and before you notice how much you've taken, your cunt is kissing the beast's crotch and the veins of her massive rod can be seen through your stretched and bloated belly. You pant and moan lustfully as the creature takes hold of your hips, and together you begin to hump and bounce against each other. The beast is clearly no amateur, knowing precisely when and where to stimulate you best, your tainted lover fucking you like she had a map of every nerve in your body. Soon, the two of you are subsumed in your lusts, and it's not long until your [bodydesc of Player] body shakes in the throes of a powerful orgasm. Wrenching around her throbbing cock, the creature doesn't hold any longer, blasting your insides with buckets of her seed, making your belly swell with her output until it protrudes in a large, round dome.";
			say "     Eventually able to contain no more, the powerful blasts push you off her turgid spire, landing on the ground in a quickly-forming pool of sticky, musky cum. The creature roars as she continues to paint your body with her seed, each successive rope coating you in more of that heady fluid. Once her orgasm begins to taper down, you lean your weight into the creature and kiss her horns and face lustfully, and she kisses your neck and lets you go. For some reason, the beast must have allowed you to walk away unchanged; you are certain that they could infect with just a touch, but it seems they have control over to whom and when infection happens. You just go on your way, satisfied and with a large, full, sloshing belly that sometimes wiggles oddly...[line break][impregchance]";
		SanLoss 5;
	else:
		say "     The creature hisses and steps away from you after your last strike. You're suddenly overwhelmed by a sharp, throbbing headache. Closing your eyes, you cover your ears to block out a sound like a hundred harpies are yelling at you. When the horrible screech is gone, you open your eyes again and the beast is gone, having escaped while you were stunned.[line break]";

Section 2 - Creature Insertion

Table of Random Critters (continued)
NewTypeInfection (truth state)	Species Name	Name	Enemy Title	Enemy Name	Enemy Type	Attack	Defeated	Victory	Desc	Face	Body	Skin	Tail	Cock	Face Change	Body Change	Skin Change	Ass Change	Cock Change	str	dex	sta	per	int	cha	sex	HP	lev	wdam	area	Cock Count	Cock Length	Ball Size	Nipple Count	Breast Size	Male Breast Size	Cunt Count	Cunt Depth	Cunt Tightness	Libido	Loot	Lootchance	Scale (number)	Body Descriptor (text)	Type (text)	Magic (truth state)	Resbypass (truth state)	non-infectious (truth state)	Cross-Infection (text)	DayCycle	Altcombat (text)	BannedStatus (truth state)
--	--	--	--	--	--	--	--	--	--	--	--	--	--	--	--	--	--	--	--	--	--	--	--	--	--	--	--	--	--	--	--	--	--	--	--	--	--	--	--	--	--	--	--	--	--	--	--	--	--	--;

When Play begins:
	Choose a blank row from Table of Random Critters;
	now NewTypeInfection entry is false;
	now Species Name entry is "Anthro Shaft Beast"; [name of the overall species of the infection, used for children, ...]
	add "Anthro Shaft Beast" to infections of BodyHorrorList;
	add "Anthro Shaft Beast" to infections of HermList;
	add "Anthro Shaft Beast" to infections of BipedalList;
	add "Anthro Shaft Beast" to infections of TailList;
	now Name entry is "Anthro Shaft Beast"; [Name of your new Monster]
	now enemy title entry is ""; [name of the encountered creature at combat start - Example: "You run into a giant collie." instead of using "Smooth Collie Shemale" infection name]
	now enemy Name entry is ""; [specific name of unique enemy]
	now enemy type entry is 0; [0 = non unique enemy; 1 = unique (unknown name); 2 = unique (known name) | Used to disqualify unique enemies from Vore/UB and showing the enemy name in encounters]
	now attack entry is "[one of]You feel a powerful kick hit your stomach, but she didn't move. The monster is just standing there, smiling ominously[or]A strong uppercut is delivered to your chin, or so you think, the unmoving creature just grinning at you[or]Her heavy tail lashes at you, forcing you to land on your rear. She giggles as you recover from the impact[or]She opens her maw widely, her obscene cocktongue aiming at you and shooting straight at your face with pressure and force of a fire hose[or]A pair of the monster's rear tendrils swing at you and strike your chest like twin whips[at random]."; [Text used when the monster makes an Attack]
	now defeated entry is "[shaft beast defeat]"; [ Text or say command used when Monster is defeated.]
	now victory entry is "[shaft beast victory]"; [ Text used when monster wins, can be directly entered like combat text or description. or if more complex it can be linked to a 'To Say' block as the demonstration text shows.]
	now desc entry is "[mongendernum 5]     You see someone approach. A fellow survivor in a place like this? You are filled with joy when you see that it's a normal human [one of]male[or]female[at random], completely nude. However, your joy doesn't last long, dispelled when the other survivor grins at you. An odd feeling washes over you, one of lust and fear, along with other alien sensations that you had never felt before. When you snap out of it, there is a powerful musk in the air that fills your lungs and immediately makes your body tingle with arousal. You no longer see a survivor, but a monster that takes a few minutes to understand. The strange, bizarre creature chuckles and poses for you, showing her obscene and exaggerated features.[line break]     Before you is an abomination of purple flesh, standing on large feet with five throbbing cocks instead of toes, which also replace her fingers. The creature has an impressive breeding tool that stands proud at three feet in length, with several ridges and a barbed tip. Along the underside hang eight golf ball-sized [']tits['] that drip eagerly with a thick, white, cum-like goo that made you wonder if it's actually milk. Hanging heavily under that massive medieval torture device is a ballsack that packs four watermelon-sized testicles. Her chest and belly are swollen with six G cup-sized breasts, each with an oversized nipple. The monster's neck and the base of every breast has rings of large, round nubs that you can only recognize as clitorises the size of grapes. The breasts only have one ring, but her neck has four evenly spread along it.[line break]     Her head is also alarming, a combination of a pointy cock and the snout of a dragon. There are no eyes, nose, or ears - just the wide maw of the creature over the smooth surface of a cock-like head with a pair of long, cock-shaped [']horns['] that drip and spurt constantly with her musk. Behind her, you see six tentacles with pointy cock-heads at the tips, thicker than a baseball bat and five feet long each. Her tail also is an obscene show, as thick and heavy as one as her legs, the underside covered from its base to the large, fat cocktip at the end with two rows of heavy, dripping tits. You can't bear to see more, but you know by the female musk in the air that there must be a massive cunt behind those gigantic testicles, swollen and dripping. The dual-sexed musk she spreads around drills into your mind.[line break]     The exotic shape of her male genitalia suggests that this creature is likely draconian in nature, or at least was at one point. The highly sexual creature pulses and throbs from everywhere, dripping and shining with a thick layer of her own juices. She approaches quickly, ready to show you a rather blissful fate."; [ Description of the creature when you encounter it.]
	now face entry is "a mix of a cock and a dragon's head. Your head is smooth and faceless, half of it shaped like a dragon cock, but the front has more snout-like proportions. You still have lips, but the insides of your maw and throat feel a lot like female genitalia, and your [']fangs['] are actually a bunch of clitorises. Just brushing your prehensile, tentacle-like, two foot-long cocktongue around the insides make you moan in ecstasy and yearn for something to fill you"; [ Face description, format as "Your face is (your text)."]
	now body entry is "a blissful symphony. It pulses and throbs constantly at any stimulation. There are six cunts along the sides of your spine, arranged in parallel like the breasts in front of you, each wide cunt drooling heavily. Your six thick cock tentacles push and wiggle out from those cunts, each reaching five feet from base to tip and thicker than a baseball bat, highly prehensile and moving as if they had minds of their own. Your hands and feet are quite large, each finger and toe replaced with prehensile, foot-long cocks. Your belly tingles constantly, and you feel things moving inside of it - living things"; [ Body Description, format as "Your Body is (your text)"]
	now skin entry is "purple, veiny, slick and cock-like"; [ skin Description, format as "You have (your text) skin"]
	now tail entry is "Your tail is as heavy and thick as one of your legs, and it's slightly longer than one as well. The tip is a large, swollen, pointy cock-head which is almost the size of your own length's head. The underside of the tail is covered with rows of breasts from its base to the glans at its tip, the breasts larger near the base and tapering towards the end."; [ Tail description, write a whole Sentence or leave blank. ]
	now cock entry is "[if looknow is 1]draconian-shaped cock tip. There are eight small breasts lining its underside, proportional to the size of your tool. Your manhood is also ridged along the sides and barbed all over the glans and edges, forming quite an interesting[else]draconian and breasted[end if]"; [ Cock Description, format as you have a 'size' (your text) cock]
	now face change entry is "it pops and swells, pushing forward. Your eyes close and cease to exist, along with your nose and ears, all facial features fading except for your lips, which spread wider. Your face pushes into a smooth draconian snout while the back of your head takes a penile approach, small barbs forming around the edges. A pair of foot-long, cock-shaped horns grow at the back of your head, each dripping heavily with male musk, just as your lips drool with female juices. Your tongue then swells and pushes out like a powerful tendril, two feet long and as thick as a golf ball, drooling from the now swollen cock-head at the tip. Your neck swells and pulses as four rings of round bumps sprout evenly along it, each bump taking the shape of a grape-sized clitoris"; [ face change text. format as "Your face feels funny as (your text)." ]
	now body change entry is "it swells and pulses all over, moans escaping your lips as you rub your body in corrupted lust. Your hands and feet swell large, each finger and toe extending, pulsing and then growing into foot-long cocks. Six cunts swell and split open along your spine, your back dripping as they drool heavily and then spread wide open to allow six long tentacles to slide out and wiggle around out of control, each as thick as a baseball bat"; [ body change text. format as "Your body feels funny as (your text)." ]
	now skin change entry is "it tingles and pulses, purple shades spreading all over it with veins showing here and there. You then feel an unbearable heat spread all over, your body releasing a thick layer of musky sweat that coats you from head to toe, making your skin glisten and drip"; [ skin change text. format as "Your skin feels funny as (your text)." ]
	now ass change entry is "it trembles and tickles. You grow a massive cock tail which curls up proudly, flopping down shortly after with the weight of the many rows of breasts spreading over its underside. The cocktip swells until it's nearly size of your head, and the slit at its tip begins to drool thick, heady cum"; [ ass/tail change text. format as "Your ass feels funny as (your text)." ]
	now cock change entry is "it swells and throbs, each pulse spreading changes from base to tip. The sides form subtle ridges, followed by the growth of eight small, dripping tits along its underside. With a wave of lust, the tip tapers to a point and begins to drool heavily, barbs spreading over the glans and edges"; [ cock change text. format as "Your cock feels funny as (your text)." ]
	now str entry is 20;
	now dex entry is 12;
	now sta entry is 19;
	now per entry is 22;
	now int entry is 32;
	now cha entry is 10;
	now sex entry is "Both"; 	[ Defines which sex the infection will try and make you. current options are 'Male' 'Female' 'Both']
	now HP entry is 60;
	now lev entry is 8; [ Level of the Monster, you get this much HP if you win, or this much HP halved if you loose ]
	now wdam entry is 12; [Amount of Damage monster Does when attacking.]
	now area entry is "Mall"; [ Current options are 'Outside' and 'Mall'. Case sensitive]
	now Cock Count entry is 1; [ How many cocks will the infection try and cause if sex is 'Male' or 'Both']
	now Cock Length entry is 36; [ Length infection will make cock grow to if cocks]
	now Ball Size entry is 5; [ Size of balls 1-7: "acorn-sized", "dove egg-sized", "chicken egg-sized" "goose-egg sized", "ostrich-egg sized", "basketball-sized", "beachball-sized"]
	now Nipple Count entry is 6; [ Number of nipples infection will give you (males have nipples too) ]
	now Breast Size entry is 10; [Size of breasts infection will try to attain ]
	now Male Breast Size entry is 0; [ Breast size for if Sex="Male", usually zero. ]
	now Cunt Count entry is 1; [ if sex = "Female or both", indicates the number of female sexes infection will grant you.]
	now Cunt Depth entry is 36; [ Length of female sex infection will attempt to give you. ]
	now Cunt Tightness entry is 24; [ Width of female sex infection will try and give you ]
	now libido entry is 80; [ Amount player Libido will go up if defeated ]
	now loot entry is "psionic egg";
	now lootchance entry is 50; [ Chance of loot dropping 0-100 ]
	now scale entry is 3; [ Number 1-5, approx size/height of infected PC body: 1=tiny, 3=avg, 5=huge ]
	now body descriptor entry is "[one of]hyper-sexualized[or]twisted[or]genital-covered[as decreasingly likely outcomes]";
	now type entry is "mutant"; [ one-word creature type. Ex: feline, canine, lupine, robotic, human... Use [one of] to vary ]
	now magic entry is false;
	now resbypass entry is false; [ Bypasses Researcher bonus? true/false (almost invariably false) ]
	now non-infectious entry is false;
	now Cross-Infection entry is ""; [infection that this infection will give the player when they lose; can be left empty if they infect with the monster's own] [ Is this a non-infectious, non-sheftable creature? True/False (usually false) ]
	now DayCycle entry is 0; [ 0 = Up at all times; 1 = Diurnal (day encounters only); 2 = Nocturnal (night encounters only);]
	now altcombat entry is "default";
	now BannedStatus entry is false;

Table of New Infection Parts (continued)
Species Name	Name	Body Weight	Body Definition	Androginity	Head Change	Head Description	Head Adjective	Head Skin Adjective	Head Color	Head Adornments	Hair Length	Hair Shape	Hair Color	Hair Style	Beard Style	Body Hair Length	Eye Color	Eye Adjective	Mouth Length	Mouth Circumference	Tongue Adjective	Tongue Color	Tongue Length	Torso Change	Torso Description	Torso Adjective	Torso Skin Adjective	Torso Adornments	Torso Color	Torso Pattern	Breast Adjective	Breast Size	Male Breast Size	Nipple Count	Nipple Color	Nipple Shape	Back Change	Back Adornments	Back Skin Adjective	Back Color	Arms Change	Arms Description	Arms Skin Adjective	Arms Color	Locomotion	Legs Change	Legs Description	Legs Skin Adjective	Legs Color	Ass Change	Ass Description	Ass Skin Adjective	Ass Color	Ass Width	Tail Change	Tail Description	tail skin adjective	Tail Color	Asshole Depth	Asshole Tightness	Asshole Color	Cock Change	Cock Description	Cock Adjective	Cock Color	Cock Count	Cock Girth	Cock Length	Ball Description	Ball Count	Ball Size	Cunt Change	Cunt Description	Cunt Adjective	Cunt Color	Cunt Count	Cunt Depth	Cunt Tightness	Clit Size
--	--	--	--	--	--	--	--	--	--	--	--	--	--	--	--	--	--	--	--	--	--	--	--	--	--	--	--	--	--	--	--	--	--	--	--	--	--	--	--	--	--	--	--	--	--	--	--	--	--	--	--	--	--	--	--	--	--	--	--	--	--	--	--	--	--	--	--	--	--	--	--	--	--	--	--	--	--	--;

When Play begins:
	Choose a blank row from Table of New Infection Parts;
	now Species Name entry is ""; [name of the overall species of the infection, used for children, ...]
	now Name entry is ""; [matching infection name to Table of Random Critters]
	now Body Weight entry is 5; [scale of 1-9 for body weight, grouped into low weight (1-3), mid weight (4-6) and high weight (7-9)]
	now Body Definition entry is 5; [scale of 1-9 for body definition, grouped into low muscle (1-3), mid muscle (4-6), high muscle (7-9)]
	[Body Adjective is generated out of the body weight and body definition and can be used in scenes - one word descriptive adjective depending on weight and definition groups: low weight group: skinny/slender/lithe; mid weight group: average/fit/muscled; high weight group: pudgy/husky/jacked]
	now Androginity entry is 5; [1-9 scale of hypermasculine to hyperfeminine]
	[Gender Adjective is generated out of androginity 1-9: hypermasculine/masculine/effeminate/somewhat effeminate/androgynous/feminine butch/tomboyish/feminine/hyperfeminine]
	now Head Change entry is ""; [partial sentence that fits in: "Your head and face [one of]tingle[or]go flush[or]vibrate with odd pleasure[or]go cold[or]feel oily[at random] as [head change entry]."]
	now Head Description entry is ""; [partial sentence that fits in "Your face and head resemble that of [Head Description of Player]. You have [Eye Adjective of Player], [Eye Color of Player] eyes and an overall [Gender Adjective of Player] appearance."]
	now Head Adjective entry is ""; [one word descriptive adjective (avian/canine/...)]
	now Head Skin Adjective entry is ""; [one word descriptive adjective]
	now Head Color entry is ""; [single word color adjective for the dominant color of the skin/fur/feathers/scales]
	now Head Adornments entry is "";[partial sentence that fits in "Before moving on from your head, you give your [head adornments of Player] a proud glance followed by a light caress."]
	now Hair Length entry is 2; [hair length in inches]
	now Hair Shape entry is ""; [one word shape descriptor (curly/straight/...)]
	now Hair Color entry is ""; [one word color descriptor]
	now Hair Style entry is ""; [one word style descriptor (ponytail/mohawk/buzzcut/...) to fit "On top of your head you have [Hair Length of Player] inch long, [Hair Shape of Player] [Hair Color of Player] hair in the [Hair Style of Player] style."]
	now Beard Style entry is ""; [short beard style (goatee/3-day stubble beard/porn stache/mutton chops beard/...) to go into "You have a [Hair Color of Player] [Beard Style of Player]."]
	now Body Hair Length entry is 0; [numerical value, 0-4 (no body hair/light/moderate/heavy/furry) - only set to > 0 if the infection does not have fur/scales/etc. !]
	now Eye Color entry is ""; [one word color descriptor]
	now Eye Adjective entry is ""; [one word descriptive adjective (slitted/round/...)]
	now Mouth Length entry is 3; [inches deep for face fucking; maximum possible will be double this number (when deep throating)]
	[Mouth Length Adjective  is generated by a function and can be used in scenes too - "petite, shallow, average, deep, bottomless"]
	now Mouth Circumference entry is 3; [mouth circumference 1-5, see Mouth Circumference Adjective]
	[Mouth Circumference Adjective is generated by a function and can be used in scenes too - "tiny, small, normal, wide, gaping"]
	now Tongue Adjective entry is ""; [one word descriptive adjective (wide/slobbery/...)]
	now Tongue Color entry is ""; [one word color descriptor]
	now Tongue Length entry is 3; [length in inches]
	now Torso Change entry is ""; [partial sentence that fits in: "Your torso [one of]tingles[or]goes flush[or]vibrates with odd pleasure[or]goes cold[or]feels oily[at random] as [Torso Change entry]."]
	now Torso Description entry is ""; [partial sentence, fitting in "Looking down at yourself, you appear [Gender Adjective of Player] with a [Body Adjective of Player] build. Your torso is [Torso Description of Player][if Body Hair Length of Player > 1], covered in [Torso Color of Player] skin and [Body Hair Description of Player][else if Body Hair Length of Player is 1], covered in smooth, [Torso Color of Player] skin[end if]."]
	now Torso Adjective entry is ""; [one word descriptive adjective (avian/canine/...)]
	now Torso Adornments entry is ""; [(pouch/udders/...); partial sentence to fit: "You take a moment to feel your [torso adornments of Player]."]
	now Torso Skin Adjective entry is ""; [one word adjective (feathered/furred/scaly/...); EMPTY "" for creatures with just skin]
	now Torso Color entry is ""; [single word color adjective for the dominant color of the skin/fur/feathers/scales]
	now Torso Pattern entry is ""; [single word color adjective for the dominant pattern of the skin/fur/feathers/scales]
	now Breast Adjective entry is ""; [adjective(s) example: round, pointy, perky, saggy, bouncy. This would serve as either a general appearance of a infections breasts or possibly something that may be effected by a item or NPC.]
	now Breast Size entry is 0; [cup size as number, counting Flat Pecs = 0, A = 1, B = 2, ...]
	now Male Breast Size entry is 0; [cup size as number, counting Flat Pecs = 0, A = 1, B = 2, ...]
	now Nipple Count entry is 2; [count of nipples]
	now Nipple Color entry is ""; [one word color descriptor]
	now Nipple Shape entry is ""; [shape example: any shape will do as long as it has a baseline with a current infection or item]
	now Back Change entry is ""; [partial sentence that fits in: "Your back [one of]tingles[or]goes flush[or]vibrates with odd pleasure[or]goes cold[or]feels oily[at random] as [Back Change entry]."]
	now Back Adornments entry is ""; [partial sentence to fit: "Your back tickles with the feeling of movement caused by [back adornments of Player]."]
	now Back Skin Adjective entry is ""; [one word adjective (feathered/furred/scaly/...); EMPTY "" for creatures with just skin]
	now Back Color entry is ""; [single word color adjective for the dominant color of the skin/fur/feathers/scales]
	[Limbs Adjective is generated by a function and can be used in scenes too - "rail-thin, slender, sinewy, average, firm, muscular, flabby, meaty, rippling"]
	now Arms Change entry is ""; [partial sentence that fits in: "Your arms [one of]tingle[or]go flush[or]vibrate with odd pleasure[or]go cold[or]feel oily[at random] as [Arms Change entry]."]
	now Arms Description entry is ""; [partial sentence to fit: "Your [Limbs Adjective of Player] arms are [Arms Description of Player]."]
	now Arms Skin Adjective entry is ""; [one word adjective (feathered/furred/scaly/...); EMPTY "" for creatures with just skin]
	now Arms Color entry is ""; [single word color adjective for the dominant color of the skin/fur/feathers/scales]
	now Locomotion entry is ""; [one word adjective: (bipedal/quadrupedal/octapedal/serpentine/sliding)]
	now Legs Change entry is ""; [partial sentence that fits in: "Your legs [one of]tingle[or]go flush[or]vibrate with odd pleasure[or]go cold[or]feel oily[at random] as [Legs Change entry]."]
	now Legs Description entry is ""; [partial sentence to fit: "As your inspection goes even lower, you come to the two [Body Adjective of Player] legs supporting you. They are [legs description of Player]."]
	now Legs Skin Adjective entry is ""; [one word adjective (feathered/furred/scaly/...); EMPTY "" for creatures with just skin]
	now Legs Color entry is ""; [single word color adjective for the dominant color of the skin/fur/feathers/scales]
	now Ass Change entry is ""; [partial sentence that fits in: "Your ass [one of]tingles[or]goes flush[or]vibrates with odd pleasure[or]goes cold[or]feels oily[at random] as [Ass Change entry]."]
	now Ass Description entry is ""; [partial sentence to fit: "Using your hands you feel your behind enjoying the sensation of your [Ass Width Adjective of Player], [Ass Shape Adjective of Player] [Ass Description of Player]." (For players with skin, instead of the period: ", covered in [Ass Color of Player] skin and [Body Hair Description of Player]"]
	now Ass Skin Adjective entry is "";  [one word adjective (feathered/furred/scaly/...); EMPTY "" for creatures with just skin]
	now Ass Color entry is ""; [single word color adjective for the dominant color of the skin/fur/feathers/scales]
	now Ass Width entry is 3; [ass width from 1-5]
	[Ass Width Adjective generated by function out of ass width: dainty/small/round/huge/enormous]
	[Ass Adjective generated by function out of body definition and ass width]
	now Tail Change entry is ""; [partial sentence that fits in: "Your rear [one of]tingles[or]goes flush[or]vibrates with odd pleasure[or]goes cold[or]feels oily[at random] as [if HasTail of Player is true]your existing tail is changed into a [Tail Description entry][else][Tail Change entry][end if]."]
	now Tail Description entry is ""; [partial sentence to fit: "Just below your lower back sprouts a [tail description of Player], which you move back and forth with glee."]
	now Tail Skin Adjective entry is ""; [one word adjective (feathered/furred/scaly/...); EMPTY "" for creatures with just skin]
	now Tail Color entry is ""; [single word color adjective for the dominant color of the skin/fur/feathers/scales]
	now Asshole Depth entry is 7; [inches deep for anal fucking]
	[Asshole Depth Adjective is generated by a function and can be used in scenes too - "petite (< 3), shallow (< 5), average (< 9), deep (< 15), bottomless (15+)"]
	now Asshole Tightness entry is 3; [asshole tightness 1-5, "extremely tight, tight, receptive, open, gaping"]
	[Asshole Tightness Adjective is generated by a function and can be used in scenes too - "extremely tight, tight, receptive, open, gaping"]
	now Asshole Color entry is ""; [one word color descriptor]
	now Cock Count entry is 0;
	now Cock Girth entry is 0; [thickness 1-5, generates the Cock Girth Adjective]
	[Cock Girth Adjective is generated by a function and can be used in scenes too: thin/slender/average/thick/monstrous]
	now Cock Length entry is 0; [length in inches]
	now Cock Adjective entry is ""; [one word adjective: avian/canine/...]
	now Cock Change entry is ""; [partial sentence that fits in: "Your cock [one of]tingles[or]goes flush[or]vibrates with odd pleasure[or]goes cold[or]feels oily[at random] as [Cock Change entry]."]
	now Cock Description entry is ""; [partial sentence to fit: "You have a [Cock Girth Adjective of Player], [Cock Length of Player]-inch-long [cock adjective of Player] [one of]cock[or]penis[or]shaft[or]maleness[at random] that [cock description of Player]."]
	now Cock Color entry is ""; [one word color descriptor]
	now Ball Count entry is 0; [allowed numbers: 1 (uniball), 2 or 4]
	now Ball Size entry is 0; [size of balls 1-7: "acorn-sized", "dove egg-sized", "chicken egg-sized" "goose-egg sized", "ostrich-egg sized", "basketball-sized", "beachball-sized"]
	[Ball Size Adjective is generated by a function and can be used in scenes too]
	now Ball Description entry is ""; [partial sentence to fit: "Underneath it hangs a pair of [Ball Size Adjective of Player] [ball description of Player]."]
	now Cunt Count entry is 0;
	now Cunt Depth entry is 0; [penetratable length in inches; some minor stretching allowed, or more with Twisted Capacity]
	now Cunt Tightness entry is 0; [size 1-5, generates adjectives of extremely tight/tight/receptive/open/gaping]
	[Cunt Tightness Adjective is generated by a function and can be used in scenes too: extremely tight/tight/well-used/open/gaping]
	now Cunt Adjective entry is ""; [one word adjective: avian/canine/...]
	now Cunt Change entry is ""; [partial sentence that fits in: "Your pussy [one of]tingles[or]goes flush[or]vibrates with odd pleasure[or]goes cold[or]feels oily[at random] as [Cunt change entry]."]
	now Cunt Description entry is ""; [partial sentence to fit: "You have a [Cunt Tightness Adjective of Player] [one of]cunt[or]pussy[or]vagina[or]cleft[at random] that [cunt description of Player]."]
	now Cunt Color entry is ""; [one word color descriptor]
	now Clit Size entry is 0; [size 1-5, see Clit Size Adjective]
	[Clit Size Adjective is generated by a function and can be used in scenes: very small/small/average/large/very large]


to sharethebliss:
	infect "Anthro Shaft Beast";
	increase Libido of Player by 25;
	if "Horny Bastard" is listed in feats of Player, increase Libido of Player by 4;
	if "Cold Fish" is listed in feats of Player, decrease Libido of Player by 4;
	decrease humanity of Player by a random number between 0 and 1;
	if "Strong Psyche" is listed in feats of Player, increase humanity of Player by a random number between 0 and 1;
	if "Weak Psyche" is listed in feats of Player, decrease humanity of Player by a random number between 0 and 1;


an everyturn rule:
	if BodyName of Player is "Anthro Shaft Beast" or BodyName of Player is "Feral Shaft Beast":
		say "[broodmother call]";

to say broodmother call:
	if humanity of Player > 89:
		say "     You hear a beautiful song in the distance.";
		increase Libido of Player by 4;
		decrease humanity of Player by 1;
		if "Strong Psyche" is listed in feats of Player, increase humanity of Player by a random number between 0 and 1;
		if "Weak Psyche" is listed in feats of Player, decrease humanity of Player by a random number between 0 and 1;
	else if humanity of Player > 69:
		say "     Your legs feel weak, a soft, tender voice speaking to you. The beautiful sound caresses your body, the back of your mind pulsing with joy. You smile, enraptured by the strong entity speaking to you in unknown tongues... then snap out of it with a loud gasp. You look around with worry, feeling like you are being watched from every corner. No matter where you move, this feeling of paranoia never seems to go away.[line break]";
		increase Libido of Player by 6;
		if "Horny Bastard" is listed in feats of Player, increase Libido of Player by 1;
		if "Cold Fish" is listed in feats of Player, decrease Libido of Player by 1;
		decrease humanity of Player by 2;
		if "Strong Psyche" is listed in feats of Player, increase humanity of Player by a random number between 0 and 1;
		if "Weak Psyche" is listed in feats of Player, decrease humanity of Player by a random number between 0 and 1;
	else if humanity of Player > 49:
		say "     The voice continues slowly drilling into your mind. You feel helpless, unable to ignore it - but why would you? It's so beautiful, so powerful... and it feels as if it is speaking to you and only you, as if this entity from nowhere had eyes only for you. You can't help but lay down and smile, caressing your wonderful, strong, sexy body and stroking your tendrils, making them coil and rub all over yourself. It takes hours for you to regain your control and leave. By then, you are dripping with arousal, part of you just wanting to give in and follow the voice's instructions. You can even understand the voice sometimes...[line break]";
		increase Libido of Player by 8;
		if "Horny Bastard" is listed in feats of Player, increase Libido of Player by 2;
		if "Cold Fish" is listed in feats of Player, decrease Libido of Player by 2;
		decrease humanity of Player by 3;
		if "Strong Psyche" is listed in feats of Player, increase humanity of Player by a random number between 0 and 2;
		if "Weak Psyche" is listed in feats of Player, decrease humanity of Player by a random number between 0 and 2;
	else if humanity of Player > 19:
		say "     You cannot help but hissss in delight as you feel a tender caress run across your spine. The voice is at it again... but now, you feel hands and kisses spreading all over your body, invisible lips pressing against your most sensitive parts. Invisible, tender fingers caress every inch of your body, your arousal burning like the sun, your body so warm. You feel those fingers dig into you, caressing your insides, touching your mind... then bliss, endless bliss lighting every fiber of your body. By the time you wake up, a silent cry escapes your lips. You had hoped it would never end. Your head hurts badly, and you want more. The Broodmother's call... you cannot wait for the next one.[line break]";
		increase Libido of Player by 10;
		if "Horny Bastard" is listed in feats of Player, increase Libido of Player by 3;
		if "Cold Fish" is listed in feats of Player, decrease Libido of Player by 3;
		SanLoss 5;
		if "Strong Psyche" is listed in feats of Player, increase humanity of Player by a random number between 1 and 3;
		if "Weak Psyche" is listed in feats of Player, decrease humanity of Player by a random number between 1 and 2;
	else:
		say "     [one of]'Come to me, my beautiful child. We await for your offering...' [or]'Join usssssss...' [or]'Resissssst no further...' [or]'We are waiting for you...' [at random]says the Broodmother from her hive, reaching out at you with waves of lust. Places and experiences from the past and the present flash before your eyes, the Broodmother giving you a mental map, preparing you for the long trip to her blissful home.[line break]";
		if BodyName of Player is "Anthro Shaft Beast":
			sharethebliss;
		else if BodyName of Player is "Feral Shaft Beast":
			sharethelust;

when play ends:
	if BodyName of Player is "Anthro Shaft Beast":
		if humanity of Player < 10:
			say "     Day by day, the Broodmother's voice grows stronger, her tempting, enthralling voice soothing your troubled mind, making you forget your worries and your old self. You eventually give in, the Broodmother's joy at your willful submission manifesting itself as the most beautiful song you had ever heard. The neural network lights up, every node calling and pulling on you, the song driving you into the underground and towards the Shaft Beast Hive. There, you meet a new, blissful fate, serving under the beautiful and terrible Broodmother. Eventually, she makes of you her favorite child, her second in command as you take care of your Mother's constantly growing family at her side...";
		else:
			say "     You somehow manage to resist the powerful voice of the Broodmother. When rescue arrives, your twisted appearance is met with both curiosity and fear. After performing many tests on your uniquely corrupted body, you are eventually directed to a district of other, more obscene mutants to isolate you from normal society. There, you attempt to live a normal life, but the Mother's constant, distant demands seek to drive you mad with lust. You hold yourself together in spite of them, determined to cling to the remnants of your humanity.";
			say "     Eventually, you do succumb to your desires, but not on the Broodmother's terms. You relieve your lusts on those drawn in by your enthralling scents and twisted appearance, converting them into members of a new, independent hive with you as your leader. Catching wind of the disappearances, you and your flock are forced to find a nice, warm cave to hide and lie down in. Afraid to return to the surface, you decide to live in there and just accept your new urges, slaking your lusts and hunger on each other for sustenance.";
			say "     After a few months of your lonely existence, you find that you can no longer hear Mother's voice anymore. Something has changed. You feel stronger and more virile now, and you find that you can communicate telepathically with your followers, sharing your pleasure with them from afar. Your lips twist into a wicked grin at the realization that YOU are their Broodmother now. Eager to fill your role as their leader, you spend the rest of your days guiding your hive, capturing and transforming those who stray too close to your den. It's a simple existence - but one filled with pure, unending bliss.";

Table of Game Objects (continued)
name	desc	weight	object
"psionic egg"	"A strange, purple, fleshy egg that constantly secretes a clear, musky goo. You feel odd while holding it, and you swear you hear someone whispering nearby"	1	psionic egg

psionic egg is a grab object.
psionic egg is infectious. The strain of psionic egg is "Anthro Shaft Beast".
the usedesc of psionic egg is "You hold the egg tightly in your hands. As you look at it, you hear a beautiful, enthralling voice calling out at you. When you come to your senses, the egg has melted and is now being absorbed by your skin.";

the scent of psionic egg is "The purple, fleshy egg has the musky scent of sex lingering over it.".


Anthro Shaft Beast ends here.
