Feral Shaft Beast by Guest Writers begins here.
[- Originally Authored By: DragonFlayer -]

"Adds an Feral Shaft Beast to Flexible Survival's Sewer Monsters table"

Section 1 - Monster Responses


when play begins:
	add { "Feral Shaft Beast" } to infections of hermaphrodite;


to say feral shaft beast victory:
	if player is female:
		say "     The beast charges and tackles you, knocking you down on your rear. Incapacitated, you're rolled over onto your stomach, shivering as the twisted creature appraises you with a soft, lustful hiss. She caresses your rear with her massive cock head, then slowly moves over your body, her strong paws tugging and ripping away piece by piece of your clothing as she leaks over your body with her thick, heavy, sticky goo. With nothing left in her way, she mounts you and begins to grind against your rear, rubbing her gigantic equipment between your legs, searching for the right angle and then pressing her cock against your [cunt size desc of player] cunt.";
		say "     Her spire throbs hard and adjusts in size to better please you, to make it fit tightly and slightly stretch you wider than your current limits. She gives no second thoughts and thrusts to the hilt after the adjustment, making you cry out in bliss as her spire rubs against all the right places. After the initial thrust, she lowers her cock-like head to yours, pressing it against your face. She begins to lick all around, lapping and drooling over your neck and back as she pumps her spire back and forth with such a gentle pace that you can't help but relax and enjoy yourself at the hands of the now loving beast. You swear you hear a song in the distance, but among the pleasure this creature gives you, it doesn't matter.";
		say "     Her pace increases slowly, fucking you with a deep, steady rhythm that makes you shake and moan for more. Her writhing cocktongues seize the opportunity to press between your parted lips, smearing over your palate and drooling down your throat. Soon you are suckling on those myriad tongues on your own volition, drooling around the phallic tendrils as they push down your throat and fill your lungs with their heady, masculine aroma. Aching for more, you push back against the beast's bucking hips, raising your rear as you move along with her thrusts in perfect union. After several long minutes of this, your release and the creature's own mix and join in a wonderful tide of bliss that makes you lose all grasp on reality.";
		say "     You wake up later sometime later, your clothes neatly folded at your side and your body covered from head to toe in the creature's juices. She is nowhere to be seen, and part of you wishes she were still here. Your belly is noticeably rounder than before, and you feel things moving and tickling inside it. You hope it's just your imagination or the savagely enjoyable sex you had not so long ago.[line break][impregchance]";
		sharethelust;
	else if libido of player > 49:
		say "     The beast charges and tackles you, knocking you down on your rear. Incapacitated, you're rolled over onto your stomach. She caresses your rear with her massive cock-head, then slowly moves over your body, her strong paws tugging and ripping away piece by piece of your clothing as she leaks over your body with her thick, heavy, sticky goo. With nothing left in her way, she mounts you and begins to grind against your rear, rubbing her gigantic equipment between your legs, searching for the right angle and then pressing her cock against your pucker...";
		say "     Her spire throbs hard and then spurts a thick glob of her pre against your rear, the tip probing your rim to smear it along your inner walls. You feel strange, a rush of warm tingles spreading through your lower body. After adjusting herself, she gives no second thoughts and thrusts to the hilt, making you cry out in bliss as her gigantic spire rubs against all the right places. You are surprised that you can take it all, initially worried that she would split you in half... but instead, you're in a world of bliss. There isn't even a single bit of pain, your stomach bulging out profusely, the shape of the monster's spire showing even the smallest veins. After the initial thrust, she lowered her cock-head to yours, pressing that smooth, featureless flesh against your face.";
		say "     She begins to lick all around, lapping and drooling over your neck and back as she begins to pump her spire back and forth with such a gentle pace that you couldn't help but relax and enjoy yourself at the hands of the now loving beast. You swear you hear a song in the distance, but among the pleasure this creature gives you, it doesn't matter. Her pace increases slowly, fucking you with a deep, steady rhythm that makes you shake and moan for more. Her writhing cocktongues seize the opportunity to press between your parted lips, smearing over your palate and drooling down your throat. Soon you are suckling on those myriad tongues on your own volition, drooling around the phallic tendrils as they push down your throat and fill your lungs with their heady, masculine aroma. Aching for more, you push back against the beast's bucking hips, raising your rear as you move along with her thrusts in perfect union. After several long minutes of this, your release and the creature's own mix and join in a wonderful tide of bliss that makes you lose all grasp on reality.";
		say "     You wake up sometime later, your clothes neatly folded at your side and your body covered from head to toe in the creature's juices. She is nowhere to be seen, but part of you wishes she were still there...[line break][mimpregchance]";
		sharethelust;
	else:
		say "     The beast pulses and spurts a thick rope of her seed over your beaten body. She approaches and drips heavily with musk as you lay on your back, exhausted. Pinned down by its heavy paws, she moves between your legs, spreading them apart. Using her toes, she rubs and caresses over your belly and chest, your clothes ripped away from you with strong tugs as the bizarre monster explores your body with those thick, dripping digits. Her massive, prehensile cocktongues and those eight tentacles feel over every part of you, though avoid your groin as she explores.";
		say "     She then pulls away and smiles, turning around to reveal her massive, swollen, drooling cunt. She sits down on your face, pushing your whole head inside of it, bathing you in her juices and overwhelming you with powerful female musk that burns your lungs and drills into your mind. It is too much for you and you eventually lose consciousness. By the time you wake up, the creature is gone and you find yourself covered from head to toe in the creature's female musk. Your clothes have been neatly folded at your side, as if they had never torn, and they feel a bit... different, now.[line break]";
		sharethelust;

to say feral shaft beast defeat:
	if libido of player > 59:
		if player is male:
			say "     The creature hisses and lands on her rear after your last strike, panting and exhausted. She just lays there, exposing her features to you submissively. The sight and the powerful scents prove too much for your own need, and the creature raises her large cockhead as you approach, the skin of her head growing darker as she blushes. Undressing and immediately taking hold of her legs, she spreads her hindlegs wider presents her massive slit to you, and then the swollen opening changes, adjusting to become a tight fit for you. You grin widely at the sight; this creature wants you to ravage and fuck it mindless alright.";
			say "     In a blink, your [bodytype of player] form is atop her and thrusting your spire deep into the willing monster without any inhibitions, pumping roughly and slamming against her on every powerful thrust. The beast throbs and leaks heavily from her head's slit, every throbbing spire and nibble on her body drooling and spurting in excitement, her scent driving you mad with lust. At the climax of it all, you release your seed deep within the beast, who pulses and throbs in ecstasy as her own body is shaken by a blissful orgasm, making a huge mess like no other, your body splattered from head to toe in her many juices.";
			say "     Once you were done, you pull out and kiss the creature's urethral slit lustfully, suckling on some of her cocktongues for a little while. She nuzzles back at your face and lets you go. For some reason, the beast must have allowed you to walk away unchanged; you are certain that they could infect with just a touch, but it seems they have control over to whom and when infection happens. You just go on your way, satisfied.[line break]";
		else if player is female:
			say "     The creature hisses and lands on her rear after your last strike, panting and exhausted. She just lays there, exposing her features to you submissively. The sight and the powerful scents prove too much for your own need, and the creature wiggles softly as you approach, the skin of her head growing darker as she blushes. Undressing and moving over the large pillar of flesh between her legs, you prepare to slide down the beast's gigantic spire. It throbs hard and spurts sticky juices against your slit and thighs, the mess spreading over your crotch.";
			say "     You don't mind a bit as you begin to lower yourself on her flaring glans, moaning out loud as your nethers grind against the drooling cocktip. Generously lubricated by her essence, your folds wrap around her cock like they're made of rubber, yet it still feels like a very tight and enjoyable fit. You lower more of yourself down that huge, pulsing rod, sliding smoothly down her slickened flesh. It seems to grow even bigger inside you, and before you notice how much you've taken, your cunt is kissing the beast's crotch and the veins of her massive rod can be seen through your stretched and bloated belly. You pant and moan lustfully as the creature takes hold of your hips, and together you begin to hump and bounce against each other. Soon, the two of you are subsumed in your lusts, and it's not long until your [bodydesc of player] body shakes in the throes of a powerful orgasm. Wrenching around her throbbing cock, the creature doesn't hold any longer, blasting your insides with buckets of her seed, making your belly swell with her output until it protrudes in a large, round dome.";
			say "     Eventually able to contain no more, the powerful blasts push you off her turgid spire, landing on the ground in a quickly-forming pool of sticky, musky cum. Your legs shake as you fall against the creature, you smiled widely. Once her orgasm begins to taper down, you lean your weight into the creature and kiss her urethral slit, suckling on her cocktongues lustfully. She nuzzles back at your face and lets you go. For some reason, the beast must have allowed you to walk away unchanged; you are certain that they could infect with just a touch, but it seems they have control over to whom and when infection happens. You just go on your way, satisfied and with a large, full, sloshing belly that sometimes wiggles oddly...[line break][impregchance]";
		SanLoss 5;
	else:
		say "     The creature hisses and steps away from you after your last strike. In a last-ditch effort, she spurts her seed and larva everywhere. You're forced to retreat or risk being contaminated, and the beast uses the opening to escape.[line break]";

Section 2 - Monster Insertion

Table of random critters (continued)
name	enemy title	enemy name	enemy type	attack	defeated	victory	desc	face	body	skin	tail	cock	face change	body change	skin change	ass change	cock change	str	dex	sta	per	int	cha	sex	HP	lev	wdam	area	cocks	cock length	cock width	breasts	breast size	male breast size	cunts	cunt length	cunt width	libido	loot	lootchance	scale (number)	body descriptor (text)	type (text)	magic (truth state)	resbypass (truth state)	non-infectious (truth state)	nocturnal (truth state)	altcombat (text)
--	--	--	--	--	--	--	--	--	--	--	--	--	--	--	--	--	--	--	--	--	--	--	--	--	--	--	--	--	--	--	--	--	--	--	--	--	--	--	--	--	--	--	--	--	--	--	--	--;

When Play begins:
	Choose a blank row from Table of random critters;
	now name entry is "Feral Shaft Beast"; [Name of your new Monster]
	now enemy title entry is "";
	now enemy name entry is "";
	now enemy type entry is 0; [non-unique enemy]
	now attack entry is "[one of]The creature turns quickly, hitting you with her heavy tail[or]The beast throbs and shoots a huge glob of seed from her head with the pressure of a fire hose at your face[or]The beast charges towards you and tackles you[or]Her tentacles wiggle around and lash at you like whips[at random]."; [Text used when the monster makes an Attack]
	now defeated entry is "[feral shaft beast defeat]"; [ Text or say command used when Monster is defeated.]
	now victory entry is "[feral shaft beast victory]"; [ Text used when monster wins, can be directly entered like combat text or description. or if more complex it can be linked to a 'To Say' block as the demonstration text shows.]
	now desc entry is "[mongendernum 5]     As you walk, you find a powerful musk filling your lungs. Your skin tingles and a chill run downs your spine as wet sounds resonate behind you, and when you turn to face the source, you lay your eyes on a beast like no other.[line break]     Standing on all fours, the purple-skinned monster is an abomination of breasts and phalluses. Her veiny skin throbs, looking slick and moist with a thin layer of her own liquid musk. Her head is a massive, thick-necked shaft with a glans-like tip that reminds you of a dragon's snout. The toes on her front and rear paws terminate in penis-like protrusions that drool on the ground as she walks. Stretching out from her rear is a massive tail with a dribbling crown that's as large as her head, and the tail's underside is covered from base to tip with two rows of heavy, dripping breasts. Eight massive, cock-like tentacles wriggle around on the monster's back, each as thick as one of your arms and five feet in length. The creature's head is pointed at you, and the urethra stretches open to reveal three massive cocktongues that slide out and wiggle in your direction, just as dexterous the tentacles on her back.[line break]     As the creature moves closer to fight you, you can't help but balk at the eight H cup breasts on her front and the massive, four foot long spire between her legs, the underside of which is lined with twin rows of orange-sized tits. Behind that imposing pillar of flesh rests a huge ballsack with four watermelon-sized testicles. You can't even begin to fathom how such a thing could be created, much less be able to move, but she's clearly eager to play with you as she prepares to take what she wants by force."; [ Description of the creature when you encounter it.]
	now face entry is "smoothed out into a featureless, snout-like glans, with a thick and swollen neck that throbs on every breath. Your urethra frequently drips a sticky, cum-like substance and can be spread to reveal three prehensile cocktongues, each as thick as a human's arm and four feet long from base to drippling tip"; [ Face description, format as "Your face is (your text)."]
	now body entry is "a blissful symphony. It pulses and throbs constantly at any stimulation. There are eight cunts along the sides of your spine, arranged in parallel like the breasts in front of you, each wide cunt drooling heavily. Your eight thick cock tentacles push and wiggle out from those cunts, each reaching five feet from base to tip and as thick as a human's arm, highly prehensile and moving as if they had minds of their own. Your hands and feet have changed to give you a more feral stance, as have your shoulders and rear. Your fingers and toes have been replaced with prehensile, foot-long cocks. Your belly tingles constantly, and you feel things moving inside of it - living things"; [ Body Description, format as "Your Body is (your text)"]
	now skin entry is "purple, veiny, slick and cock-like"; [ skin Description, format as "You have (your text) skin"]
	now tail entry is "Your tail is as heavy and thick as one of your legs, and it's slightly longer than one as well. The tip is a large, swollen, pointy cock-head which is almost the size of your own length's head. The underside of the tail is covered with rows of breasts from its base to the glans at its tip, the breasts larger near the base and tapering towards the end."; [ Tail description, write a whole Sentence or leave blank. ]
	now cock entry is "[if looknow is 1]draconian-shaped cock tip. There are eight small breasts lining its underside, proportional to the size of your tool. Your manhood is also ridged along the sides and barbed all over the glans and edges, forming quite an interesting[else]draconian and breasted[end if]"; [ Cock Description, format as you have a 'size' (your text) cock]
	now face change entry is "it pops and swells, pushing forward. Your eyes close and cease to exist, along with your nose and ears, all facial features fading except for your lips, which spread wider. Your face pushes into a smooth draconian snout while the back of your head takes a penile approach, small barbs forming around the edges. A pair of foot-long, cock-shaped horns grow at the back of your head, each dripping heavily with male musk, just as your lips drool with female juices. Your tongue then swells and pushes out like a powerful tendril, two feet long and as thick as a golf ball, drooling from the now swollen cock-head at the tip. Your neck swells and pulses as four rings of round bumps sprout evenly along it, each bump taking the shape of a grape-sized clitoris"; [ face change text. format as "Your face feels funny as (your text)." ]
	now body change entry is "it swells and pulses all over, moans escaping your lips as you rub your body in corrupted lust. Your hands and feet swell large, each finger and toe extending, pulsing and then growing into foot-long cocks. Eight cunts swell and split open along your spine, your back dripping as they drool heavily and then spread wide open to allow eight long tentacles to slide out and wiggle around out of control, each as thick as a human arm. You fall on all fours as your arms and legs change, followed by your shoulders and rear, their new structure forcing you into a quadrupedal stance"; [ body change text. format as "Your body feels funny as (your text)." ]
	now skin change entry is "it tingles and pulses, purple shades spreading all over it with veins showing here and there. You then feel an unbearable heat spread all over, your body releasing a thick layer of musky sweat that coats you from head to toe, making your skin glisten and drip"; [ skin change text. format as "Your skin feels funny as (your text)." ]
	now ass change entry is "it trembles and tickles. You grow a massive cock tail which curls up proudly, flopping down shortly after with the weight of the many rows of breasts spreading over its underside. The cocktip swells until it's nearly size of your head, and the slit at its tip begins to drool thick, heady cum"; [ ass/tail change text. format as "Your ass feels funny as (your text)." ]
	now cock change entry is "it swells and throbs, each pulse spreading changes from base to tip. The sides form subtle ridges, followed by the growth of eight small, dripping tits along its underside. With a wave of lust, the tip tapers to a point and begins to drool heavily, barbs spreading over the glans and edges"; [ cock change text. format as "Your cock feels funny as (your text)." ]
	now str entry is 30;
	now dex entry is 5;
	now sta entry is 28;
	now per entry is 25;
	now int entry is 10;
	now cha entry is 10;
	now sex entry is "Both"; 	[ Defines which sex the infection will try and make you. current options are 'Male' 'Female' 'Both']
	now HP entry is 80;
	now lev entry is 12; [ Level of the Monster, you get this much HP if you win, or this much HP halved if you loose ]
	now wdam entry is 24; [Amount of Damage monster Does when attacking.]
	now area entry is "Mall"; [ Current options are 'Outside' and 'Mall'. Case sensitive]
	now cocks entry is 1; [ How many cocks will the infection try and cause if sex is 'Male' or 'Both']
	now cock length entry is 40; [ Length infection will make cock grow to if cocks]
	now cock width entry is 28; [ Size of balls apparently ;) sneaky Nuku]
	now breasts entry is 8; [ Number of Breasts infection will give you. ]
	now breast size entry is 14; [Size of breasts infection will try to attain ]
	now male breast size entry is 0; [ Breast size for if Sex="Male", usually zero. ]
	now cunts entry is 1; [ if sex = "Female or both", indicates the number of female sexes infection will grant you.]
	now cunt length entry is 40; [ Length of female sex infection will attempt to give you. ]
	now cunt width entry is 28; [ Width of female sex infection will try and give you ]
	now libido entry is 80; [ Amount player Libido will go up if defeated ]
	now loot entry is "psionic larva";
	now lootchance entry is 50; [ Chance of loot dropping 0-100 ]
	now scale entry is 3; [ Number 1-5, approx size/height of infected PC body: 1=tiny, 3=avg, 5=huge ]
	now body descriptor entry is "[one of]hyper-sexualized[or]twisted[or]warped[or]genital-covered[as decreasingly likely outcomes]";
	now type entry is "mutant"; [ one-word creature type. Ex: feline, canine, lupine, robotic, human... Use [one of] to vary ]
	now magic entry is false;
	now resbypass entry is false; [ Bypasses Researcher bonus? true/false (almost invariably false) ]
	now non-infectious entry is false; [ Is this a non-infectious, non-shiftable creature? True/False (usually false) ]
	blank out the nocturnal entry; [ True=Nocturnal (night encounters only), False=Diurnal (day encounters only), blank for both. ]
	now altcombat entry is "default"; [ Row used to designate any special combat features, "default" for standard combat. ]

to sharethelust:
	infect "Feral Shaft Beast";
	increase libido of player by 25;
	if "Horny Bastard" is listed in feats of player, increase libido of player by 4;
	if "Cold Fish" is listed in feats of player, decrease libido of player by 4;
	decrease humanity of player by a random number between 0 and 1;
	if "Strong Psyche" is listed in feats of player, increase humanity of player by a random number between 0 and 1;
	if "Weak Psyche" is listed in feats of player, decrease humanity of player by a random number between 0 and 1;

[everyturn rule consolidated with Anthro Shaft Beast]

when play ends:
	if bodyname of player is "Feral Shaft Beast":
		if humanity of player < 10:
			say "     After taking a long nap one day, you no longer remember your name or who you were. You feel bliss like no other coursing through your every cell, and you follow a beautiful song that leads you underground toward the wonderful shaft beast hive. Settling in with your new siblings, the Broodmother replaces your old, pointless life with one of bliss and eternal lust, your mind now connected to a telepathic neural network, and you serve eagerly as a pet to other anthro shaft beasts and the Broodmother herself. It didn't take long for you to become her favorite - her little lustful monster.";
			say "     Eventually the Broodmother takes her love for you to another stage. It starts like any other worship session, pushing your gigantic head into the Broodmother's cunt... but then you can't pull away. Your head begins to merge with the Broodmother's main spire, your front legs with hers, and her tail with your spine. Soon enough, you both emerge as a single being - a Shaft Beast Taur. The Broodmother grins widely and lets bliss spread across the hive. It'll soon be time to take over the surface...";
		else:
			say "     You somehow manage to resist the Broodmother's charm. When the military arrives, you run deep into the wilderness, knowing that you're far too infectious and twisted to be allowed past the quarantine. You spend a long time living alone, far away from the will of the other shaft beasts. The isolation eventually allows you to break the shackles of the Mother's will until your mind is well and truly free.";
			say "     One day, you're attacked by a massive wolf while scavenging for food. You quickly turn the tables and pin the lupine down, your instincts urging you to fuck and transform them into another of your kind. The experience rekindles your will to spread your strain, and you and your loyal companion set out to convert any and all who enter your territory. In time, you've amassed a small pack of feral monsters like yourself, developing a new neural network to coordinate attacks and share the pleasure of your conquests.";

Table of Game Objects (continued)
name	desc	weight	object
"psionic larva"	"A small, wiggling grub. You could certainly keep it as emergency food, but ever since you took it with you, you have had some weird dreams"	1	psionic larva

psionic larva is a grab object.
psionic larva is infectious. The strain of psionic larva is "Feral Shaft Beast".
the usedesc of psionic larva is "You feel compelled to devour the wiggling grub, and you repress your inhibitions as you bite off its head. Surprisingly, it has a really good, tangy, familiar taste, and you waste no time in devouring the rest of your 'snack'. After you've finished, you gag a bit at the musky aroma still clinging to your palate, feeling equal parts repulsed and aroused by what you just ate.";

the scent of psionic larva is "The musky scent of sex wafts from the wriggling grub.".


Feral Shaft Beast ends here.
