Version 2 of Batcubus For FS by Blaydrex begins here.
[Version 2.1 - Stat adjustments and moved to Warehouse area ]

"Adds a Batcubus to Flexible Survival's Wandering Monsters table"

Section 1 - Monster Responses

when play begins:
	add { "Batcubus" } to infections of girl;
	add { "Batcubus" } to infections of furry;

to say Batcubus attack:
	if cunts of player > 0:
		Say "     She saunters over to your defeated form. 'Well well. Smells like somebody is a little excited,' she says as she starts to look over your body, especially your groin. She wastes no time in removing your clothes, and giggles with delight when she sees your aroused cunt. She lowers her head and begins to kiss your pussy, practically making out with it. Her technique is remarkable, bringing you close to the edge countless times, but always stopping just before you can climax. She spends what seems like an eternity denying you release before she decides you are ready. You feel a little pressure against your pussy and a small insertion. You look down to see she has put her nipple in you. She squeezes her breast, making milk pour into your desire filled fuckhole. She fills you with her milk before kissing your tummy where your uterus is. A warm feeling fills your womb as your pussy clamps down to stop the milk from leaking. You writhe on the ground as your body desires release heavily while being denied the pleasure once again. As quickly as the feeling began, it stops. You see some of her milk pour out, but for some odd reason it seems more consistent with sperm. She stands up and licks her purple lips, giggling to herself. 'That was fun. I hope we can meet again sometime,' she says before kissing you passionately on the lips and walking off, with you still needing release.[impregchance]";
	else:
		say "     She takes a deep breath in through her bat-like nose and shudders as she moans. Her eyes quickly snap to the bulge in you pants. She smiles and rips your pants off and gazes at your prick, eyes burning with lust. 'Oooooh. Hopefully this can get me the relief I need,' she says as she lowers her dripping cunt to grind against your stiff member. She sighs in bliss as she lowers until you are fully hilted in her. She begins to ride you like a slut who has been denied sex for a long time. Her cunt grips you tightly, like that of a virgin. Soon, it becomes too much for you to bear and you begin to shoot your load into her waiting womb, causing her to orgasm on your cock. She rewards you with bringing her large breasts to your face, forcing you to suckle her nipple till milk floods into your mouth. You stay there until you've had your fill. She gets up and kisses you sweetly on the lips before walking off to find another victim.";

to say beatthebatcubus:
	say "     The batcubus falls down to the ground, fingering herself, trying to get some form of relief. ";
	let diceroll be a random number between 40 and 150;
	if diceroll < libido of player:
		if cocks of player > 0:
			say "The scent of her arousal fills your nose and you feel your cock rapidly stiffening. Your lust brings you to turn around and look at her, unable to do anything other than start jerking off while watching her masturbate. She notices your actions and smiles warmly before spreading her legs and presenting her needy cunt to you.";
			if cock length of player > 17 or cock width of player > 9:
				say "     Something about her cunt makes you want to shove your large cock in her, so that is exactly what you decide you must do. You line up your cock with her cunt and ram it into her nice and hard. Her passage gives little resistance, but is extremely tight on your cock. Before you ca do anything she begins kissing you, repeatedly. Each kiss spreads warmth at the site and increases your lust more. You soon lose control and begin fucking her mercilessly, her tight passage bringing you to orgasm quickly. But your cock doesn't soften and your lust only grows. You begin fucking her harder and faster. You cum in her a total of five times before you begin to calm down. She gives you yet another kiss on your lips, placing your hand on her wonderful globes. You get the message and begin to suckle the milk from her nipple greedily. You drink your fill and realize she is fast sleep, obviously from exhaustion due to all the pleasure. As you begin to leave you whimper softly, missing the feeling of her kisses and her pussy as your cock lets out some cum at the thought and you feel strangely odd, but quickly dismissing the thought and continuing.";
			otherwise:
				say "     The invitation may look like fun, but something about those beautiful lips draws you to desire that much more than her cunt. She smiles softly and gets on her knees, crawling to you. She nuzzles against your cock affectionately before placing a gentle kiss on your balls. Something churns in your balls and they feel fuller and the need to release becomes more prominent. This just makes her giggle before kissing the head of your cock, making your eyes go wide as heat spreads across your cock as if an invisible pussy or mouth were wrapping around it. You whimper in need as she places kiss after kiss on your rod, driving your lust to heights you never thought possible. Your cock begins to throb insanely, pre coming out by the bucket. She giggles and looks up at you, giving an orgasmic face. This is too much for you, bringing you to cum. Your cock is basically a cum hose now, shooting the biggest load of your life all onto her face and her breasts. When you are done, it looks like she just had a cum bath, which she technically did. She just smiles. She lifts your balls and cock gently and kisses [if cunts of player > 0]your puss[yfn][otherwise]where your pussy would be if you had one[end if]. You walk away from the beautiful bat-girl thinking of how weird her thanks was...";
		otherwise if cunts of player > 0:
			say "The scent of her arousal fills your nose and you feel your cunt getting more and more wet by the second, soon having a thick trail of your liquid need running down your leg. You turn around and look at her, unable to do anything other than slide your hand under your clothes and start masturbating yourself. She notices your actions and smiles softly and beckons you to come over and have some fun.";
			if cunt width of player < 3 or cunt length of player < 6:
				say "     Your eyes hone in on her perfect breasts. You can see small trails of milk leaking from her large nipples. You smirk as a nice thought comes to your mind. You want something to fill your cunt and womb, might as well try milk. You walk up to her and roughly grab her breast. She looks surprised, obviously not used to someone being so rough and forceful.Her milk leaks out more rapidly as a sign of her growing arousal. You push her breast against your cunt, her nipple and some breast going inside. You smile and squeeze, making her milk flood into your cunt. You whimper, your pussy drinking up all that delicious milk. After you finish emptying one breast you move to the next, until that one empties as well. You pop it free, milk pouring from your cunt. She smiles, something made her happy. She kisses your abdomen where your womb is. Your uterus feels strange and your body heats up. You drop to your knees as your pussy tightens, no more milk escaping from it. You go through an intense orgasm that lasts a while. When you come down you see some more milk leaking out, but not much. But something seems off. It is thicker and looks more like cum. Her kiss must have changed the milk to sperm.[impregchance]";
			otherwise:
				say "    Your eyes remain glued to her lovely lips covered with her purple lipstick. Something about them makes you just want to kiss them. She smiles and waits patiently for you to close in before kissing you passionately on the lips, making you more horny. You stand up and place your pussy near her lips. She kisses your pussy and clit lovingly before licking with passion. Her technique is incredible, quickly bringing you to the edge. You can't help but cum, covering her face in your juices. She waits a second and begins her assault again. Your sensitive pussy is even more sensitive, causing you to moan like a little whore. She makes you cum countless times before you drop out of exhaustion. She gets up and walks away, leaving you oddly more horny than when you started.";

Section 2 - Monster Insertion

Table of random critters (continued)
name	attack	defeated	victory	desc	face	body	skin	tail	cock	face change	body change	skin change	ass change	cock change	str	dex	sta	per	int	cha	sex	hp	lev	wdam	area	cocks	cock length	cock width	breasts	breast size	male breast size	cunts	cunt length	cunt width	libido	loot	lootchance	scale (number)	body descriptor (text)	type (text)	magic (truth state)	resbypass (truth state)	non-infectious (truth state)	nocturnal (truth state)	altcombat (text)
--	--	--	--	--	--	--	--	--	--	--	--	--	--	--	--	--	--	--	--	--	--	--	--	--	--	--	--	--	--	 --	--	--	--	--	--	--	--	--	--	--	--	--	--	--	--;

[ Adds a blank row to the table, this is immediately filled ;) ]
When Play begins:
	Choose a blank row from Table of random critters;
	now name entry is "Batcubus"; [Name of your new Monster]
	now attack entry is "[one of]She grabs your groin roughly with her gloved hand while giggling.[or]She slaps you hard on the face, leaving a red mark of a hand.[or]The batcubus knocks you down and places the heel of her purple boot hard on your chest, blowing a kiss before jumping away, giggling.[at random]"; [Text used when the monster makes an Attack]
	now defeated entry is "[beatthebatcubus]"; [ Text or say command used when Monster is defeated.]
	now victory entry is  "[Batcubus attack]"; [ Text used when monster wins, can be directly entered like combat text or description. or if more complex it can be linked to a 'To Say' block as the demonstration text shows.] 
	now desc entry is "An anthropomorphic bat, but she seems different than a normal bat. Her lips are coated in a purple lipstick, which obviously contains a powerful aphrodisiac judging by the smell. Her breasts are rather large, JJ cups it looks like. Her torso appears to be covered by some red corset, but that is obviously just fur when you spot a drop of milk come out from her nipple. Her arms are in elegant white gloves that go almost all the way to her shoulders. Her legs are covered in purple high heel boots that cover them completely. Her fur is snow white. Her face and head is that of a bat's with its upturned nose and triangular ears. She simply smiles at you, licking her lips as she saunters over to you, obviously wanting to kiss you.";[ Description of the creature when you encounter it.]
	now face entry is "that of a female bat. It is beautiful and elegant, and your lips are covered with purple lipstick that is sweet when you lick it";[ Face description, format as the text 'Your face is (your text)']
	now body entry is "slender and elegant. Your torso looks like it is covered with a red corset, but it is actually fur";[ Body Description, format as the text 'Your Body is (your text)']
	now skin entry is "white furred";[ skin Description, format as the text "You have (your text) skin"]
	now tail entry is "that of a bat. It is really cute.";[ Tail description, write a whole Sentence or leave blank. ]
	now cock entry is "pteropine";[ Cock Description, format as you have a 'size' (your text) cock]
	now face change entry is "you feel something weird on your lips. You lick them just to find they taste sweet and your mouth and groin quickly fill with lust-filled warmth. They are coated in the batcubus's purple lipstick. You can't help but lick your lips over and over, each lick making you more and more horny and advances your transformation further. Your face pulls forward into a bat muzzle and your ears extend into triangles and pulled to the top of your head. You soon finish your transformation, with your face resembling that of a beautiful bat. You lick your lips once again."; [ face change text. format as "Your face feels funny as (your text)" ]
	now body change entry is "your body begins to slender out, becoming beautiful and elegant. Your hands are covered in white gloves. Your legs end up covered in purple high-heeled boots that go all the way up your legs. A strange red fur covers your torso, making it look like you are wearing a red corset, even though you are actually naked."; [ body change text. format as "Your body feels funny as (your text)" ]
	now skin change entry is "it is covered in beautiful white fur"; [ skin change text. format as "Your skin feels funny as (your text)" ]
	now ass change entry is "you bend over, panting in lust. Your ass and hips fill out, making you look oh so fuckable and fertile in your position."; [ ass/tail change text. format as "Your ass feels funny as (your text)" ]
	now cock change entry is "it becomes pteropine"; [ cock change text. format as "Your cock feels funny as (your text)" ]
	now str entry is 13;
	now dex entry is 19;
	now sta entry is 14;
	now per entry is 12;
	now int entry is 10;
	now cha entry is 16;
	now sex entry is "Female";          [ Defines which sex the infection will try and make you. current options are 'Male' 'Female' 'Both']
	now hp entry is 49;                 [ How many HP has the monster got? ]
	now lev entry is 6;                 [ Level of the Monster, you get this much hp if you win, or this much hp halved if you loose ]
	now wdam entry is 6;               [ Amount of Damage monster Does when attacking.]
	now area entry is "Warehouse";        [ Current options are 'Outside' and 'Mall'  Case sensitive]
	now cocks entry is 0;               [ How many cocks will the infection try and cause if sex is 'Male' or 'Both']
	now cock length entry is 0;         [ Length infection will make cock grow to if cocks]
	now cock width entry is 0;          [ Size of balls apparently ;) sneaky Nuku]
	now breasts entry is 2;             [ Number of Breasts infection will give you. ]
	now breast size entry is 16;        [ Size of breasts infection will try to attain ]
	now male breast size entry is 16;   [ Breast size for if Sex="Male", usually zero. ]
	now cunts entry is 1;               [ if sex = "Female or both", indicates the number of female sexes infection will grant you.]
	now cunt length entry is 12;        [ Length of female sex  infection will attempt to give you. ]
	now cunt width entry is 7;          [ Width of female sex  infection will try and give you ]
	now libido entry is 80;             [ Amount player Libido will go up if defeated ]
	now loot entry is "batcubus milk";  [ Loot monster drops, ]
	now lootchance entry is 75;         [ Chance of loot dropping 0-100 ]
	now scale entry is 3;               [ Number 1-5, approx size/height of infected PC body: 1=tiny, 3=avg, 5=huge ]
	now body descriptor entry is "[one of]slender[or]elegant[cycling]";
	now type entry is "[one of]bat[or]batty[or]bat-like[at random]";
	now magic entry is true;            [ Is this a magic creature? true/false (normally false) ]
	now resbypass entry is false;       [ Bypasses Researcher bonus? true/false (almost invariably false) ]
	now non-infectious entry is false;  [ Is this a non-infectious, non-shiftable creature? True/False (usually false) ]
	blank out the nocturnal entry;      [ True=Nocturnal (night encounters only), False=Diurnal (day encounters only), blank for both. ]
	now altcombat entry is "default";   [ Row used to designate any special combat features, "default" for standard combat. ]


Section 3 - Drop Item 

Table of Game Objects (continued)
name	desc	weight	object
"batcubus milk"	"A small plastic bottle, filled with fresh batcubus milk."	1	batcubus milk

instead of sniffing batcubus milk:
say "You open the lid of the bottle and smell the milk. Seems fresh and drinkable, even though it isn't refrigerated. Must be a side effect of the nanites in it.";

batcubus milk is a grab object.
the usedesc of batcubus milk is "[batcubus milk use]";

to say batcubus milk use:
	say "Taking the cap of the bottle of milk, you greedily drink down its contents, swallowing the tasty milk.";
	decrease thirst of player by 6;
	if thirst of player < 0, now thirst of player is 0;
	infect "Batcubus";

Section 4 - Endings

When play ends:
	if bodyname of player is "Batcubus" and matriarchdefeated is 0 and matriarchowned is 0:
		if humanity of player < 10:
			say "You search the city looking for males to impregnate you and anybody to kiss, your cunt always dripping, ready to be fucked at any time. Sometimes thoughts of your past return, but a single lick of your lips quickly sends your lust soaring and you can't help but forget again and go look for relief you so desperately need.";
		otherwise:
			say "Life as a batcubus proves fun. Every time you find someone you enjoy all you have to do is kiss them and they are putty in your hands. Thanks to this you have a good life, letting you have everything you want, never needing to work a day in your life";
			if cocks of player is greater than 0 and cunts of player is greater than 0:
				say "You spend your days fighting the urge to lick your lips. Being one gender or the other would allow you to instinctively lick them safely, but the combined lust of your female and male sex organs would be too much. A single lick could send you into a sexual fury. Last time it happened you tried to turn a whole town into batcubuses. Hopefully one day someone can find out how to get this lipstick off you.";
			otherwise if cocks of player is greater than 0:
				say "You find that having a cock isn't as fun as having a slavering cunt like most other batcubuses, but you make do. Your cock is insatiable, no matter how much you cum and fuck. One day you find a tigress hooker, who takes an interest in you. Shi wastes no time in raping you and dominating you until you submit to hir. Shi claims you as hir own and shi is actually able to keep up with your sex drive, so it works out. You spend the rest of your days happily mated to hir.";
			otherwise:
				say "...";

Batcubus For FS ends here.
