Version 5 of Feral Sea Dragon by Tunalord Sefont begins here.
[Version 5 - TBM Scene additions by Blue Bishop, overseen by Stripes]

"Adds a Feral Sea Dragon to Flexible Survivals Wandering Monsters table, With Impreg chance"
[Description text for this Extension.]

twistfsdfeedmemory is a truth state that varies. twistfsdfeedmemory is usually false.
MFSDUBM is a truth state that varies. MFSDUBM is usually false.

Section 1 - Monster Responses

[ Use To say for overlong behaviours that would make the table difficult to read and understand. Typically needed if there are alot of cock/species/cunt checks. ] 

to say dragon attack:
	if "Male Preferred" is not listed in feats of player and girl is not banned:		[change target to female for infection if valid]
		repeat with y running from 1 to number of filled rows in table of random critters:
			choose row y in table of random critters;
			if name entry is "feral sea dragoness":
				now monster is y;
				break;
	if hp of player > 0 and FSDOPEN is 0:
		say "     You immediately throw up your arms and lower your guard, showing you don't wish to fight. [One of]He doesn't immediately buy it, cautiously nosing you until fall over. This certainly amuses him, at least, and while he looks you over[or] He huffs a mocking sound and firmly sweeps his tail over to push you onto your side. He advances to look you over, and[at random] you're given a glimpse of his emergent cock, illustrating his lewd intent.";
	otherwise if FSDOPEN is 0:
		say "     Seeing an opening, he unloads a deafening roar of dominance and slaps you down with his massive tail, and you're briefly knocked out.  When you come to, you can already feel the beast's enquiring tongue over your vulnerable form, your vision clearing to give you a blatant few of his erect cock. There's no question what he has in store for you.";
	if bodyname of player is "feral sea dragon" or bodyname of player is "feral sea dragoness":
		if cunts of player > 0 and cunt length of player >= 12 and cunt width of player >= 7:
			say "     Moving around to mount you, you soon feel the head of his hard organ press against your [cunt size desc of player] cunt.  He makes a soft hissing sound as the spaded shaft sinks slowly inside you, sending waves of intense pleasure before that head is fully engulfed.  Quite the tease, he only engulfs the rod half-way before pulling it out almost entirely, your feral instinct driving you to visually express your despair--much to his amusement--before you find solace in it's return.  He plays this game with you only briefly before he is taken by the imperative of his own feral needs and starts ramming you with his cock proper.";
			say "     You writhe limply under the beast's girth, mind ahaze in pleasure.  It's as though this creature's cock was made just for you, your needy cunt constricting against its rigid mass out of a carnal need to have it in you, it's motion no doubt lubricated by your sexual fluids mixed with his own.  Though you would rather he fuck you forever it's inevitable that he concludes with one final thrust, his hilted dick pumping your womb until it's bloated with his seed, triggering your own climax in response[if cocks of player > 1], all the while your own, [cock size desc of player], and very much neglected members spill their seed across the sand before both[otherwise if cocks of player > 0], all the while your own, [cock size desc of player], and very much neglected member spills its seed across the sand before both[otherwise].  Both[end if] of you cry out in celebration of this dual orgasm. His a deep throaty roar, yours a beautifully sounding song.[impregchance]";
			say "     Satisfied, he dismounts you.  Forcing his cock free of your abused hole with [one of]a moist sucking[or]a wet popping[at random] sound.  Huffing a little, he's kind enough to give you a soft, affectionate lick across your side before he dives back into the water's depths, no doubt waiting for your return.[impregchance]";
		otherwise:
			if cunts of player > 0:		[Lead-in for inadequately sized female]
				say "     Physical form mostly similar to himself, he appears to be using his tongue to probe your cunt[sfn], the sickeningly slick organ trying to penetrate [if cunts of player > 1]one of these holes[otherwise]this hole[end if] before finding it to be too small to accommodate such an impressive beast.  He snorts as he shuffles around a bit, perhaps a little perturbed, but that doesn't mean he's not about to have fun with his potential mate.";
			if a random chance of 2 in 5 succeeds and "More Anal" is listed in feats of player:
				say "     Moving around to mount you, you soon feel the head of his hard organ press against your [bodytype of player] anus.  He makes a soft hissing sound as the spaded shaft sinks slowly inside you, sending waves of intense pleasure before that head is fully engulfed";
				if cunts of player > 0:
					say ".  Quite the tease, he only engulfs the rod half-way before pulling it out almost entirely, your feral instinct driving you to visually express your despair--much to his amusement--before you find solace in it's return.  He plays this game with you only briefly before he is taken by the imperative of his own feral needs and starts ramming you with his cock properly.";
				otherwise:
					say ".  He illustrates quite the reckless abandon when starts ramming his cock into your hole, perhaps a lot less invested in your own personal enjoyment under the implication that you won't be offering him any offspring down the line";
					if "MPreg" is listed in feats of player:
						say ", much to his ignorance";
					say ".  Regardless, you can't help but derive gratification from the rough treatment of such a virile male.";
					say "     You writhe limply under the beast's girth, mind ahaze in pleasure.  It's as though this creature's cock was made just for you, your needy ring constricting against its rigid mass out of a carnal need to have it in you, it's motion no doubt lubricated in its endeavours by his own sexual fluids.  Though you would rather he fuck you forever it's inevitable that he concludes with one final thrust, his hilted dick pumping your bowels until they're bloated with his seed[if cocks of player > 1], your own neglected, [cock size desc of player] members firing their seed impotently into the sand in inevitable response[otherwise if cocks of player > 0], your own neglected, [cock size desc of player] member firing its seed impotently into the sand in inevitable response[otherwise if cunts of player > 0], triggering your own climax in response[otherwise], struggling weakly as you lack the sexual outlet necessary to satisfy yourself[end if][if cunts of player > 0].  Both of you cry out in celebration of this dual orgasm. His a deep throaty roar. Yours a beautifully sounding song.[otherwise if cocks of player > 0].  Both of you cry out in celebration of this dual orgasm. His a deep throaty roar while you feign a feminine-sounding song, driven by your feral-tainted mind to reinforce his more masculine dominion over your lesser male form[otherwise].  In the ecstasy of his sole release he lets out a deep throaty roar, of which you can only abide in frustration and embarrassment[end if].";
					say "     Satisfied, he dismounts you.  Forcing his cock free of your abused hole with [one of]a moist sucking[or]a wet popping[at random] sound.  Huffing a little, [if cunts of player > 0]he's kind enough to give you a soft, affectionate lick across your side before he dives back into the water's depths,[otherwise]he nips your ass playfully, amused by his little cock sleeve before he dives back into the water's depths,[end if] no doubt waiting for your return.[mimpregchance]";
			otherwise:
				say "     He climbs on top of you, his bulky weight pinning you to the sandy floor.  He's shameless in prodding his proud cock against your [bodytype of player] snout, and by now your feral-tainted mind cannot resist submitting to this virile beast's needs.  You open your jaws, your thick tongue the only cushion when it's harshly thrusted into the confines of your beleaguered maw.  Gently suckling it.  It's at least good that your elongated neck can accommodate the sheer span of his masculine organ because he shows no restraint in burying it entirely within you.";
				say "     Muffled by the obvious obstruction, you can't help but make a soft, song-like sound as your infection drives you to comply with your feral and submissive circumstances, your mind filling with only the desire to please this powerful male.  Your tongue caresses it's beastial length, his thrust picking up a feverish pace as you feel him nipping you, driven by his lustful aggression, only to finally have him roar out, his throbbing cock pumping your with an immense load of his cum. Pinned, you can't pull away, and your belly is subsequently stuffed with the entire load of his expansive release.";
				say "     He slowly gathers himself and pulls his rod from you maw, your submissive haze driving you to lick it clean. He seems a bit amused by your obedience, [if cunts of player > 0]and regards you with an affectionate nuzzle before he[otherwise]and once he's properly satisfied with making you his little sea dragon bitch he[end if] turns to dive back into the water.";
	otherwise:
		if "Less Anal" is listed in feats of player:	[short lead-in]
			say "     Slightly pinning yourself against the beach, you partially sink into the sand under his weight, though his underside is at least soft enough to not be a particular strain on you.  It would appear he's giving you a look-over, determining what fate to subject his new victim to.";
		otherwise:							[full lead-in]
			say "     Slightly pinning yourself against the beach, you partially sink into the sand under his weight, though his underside is at least soft enough to not be a particular strain on you.  You feel his thick tongue begin to probe your more private regions, that sickeningly slick organ having no shame in embarrassing you as much as it can[if cunts of player > 1], illuminating its clearly perverse intent by prodding your vulnerable cunts, perhaps testing their willingness to accommodate its girth before[otherwise if cunts of player > 0], illuminating its clearly perverse intent by prodding your vulnerable cunt, perhaps testing its willingness to accommodate its girth before[otherwise if cocks of player > 0].  He gives brief attention to your [cock size desc of player] cock[smn], certainly enough to make you go right hard, though that doesn't appear to be his main intent.  Curiosity sated,[otherwise].  His little exploration only leads him to find your asshole, to which he probes curiously, perhaps more surprised that such a strange, genitalia-devoid creature like yourself could even exist.  Curiosity sated,[end if] he pulls himself free, your exposed and saliva-drenched behind chilled by the ocean air.";
		if fsdfeedmemory >= 2 and lastfsdfeeding - turns >= 8 and (("Kinky" is listed in feats of player and a random chance of 1 in 4 succeeds) or a random chance of 1 in 3 succeeds) and "Touched by Madness" is listed in feats of player:
			If twistfsdfeedmemory is false:
				say "     His exposure to you seems to have an oddly disorienting effect on the sea dragon, and he needs a moment to recover from it before he starts off once more. Oddly enough, he shifts a bit to give you a better view of his face, his expression strangely softened, a blatant contradiction to his normally harsher demeanour.";
				say "     Before you can even try to determine the cause of this, he begins to make a hoarse, hacking sound, a sound you've become all-too familiar with by now, though never by a male of this species. Suddenly, you're mouth is assailed by his lips, acrid breath compelling you to gasp for air, only for that now-gaping hole to be flooded with half-eaten fish.";
				say "     You imagine you'd be used to this by now, but this creature's rougher, more belligerent demeanour makes dealing with this all the more difficult, exacerbated by the fact that he clearly isn't experienced with this and ends up slightly overfeeding you.";
				say "     Satisfied and clearly happy for his deed, he lets you off, leaving you to contend with this rather unpleasant--if albeit free--meal. As he returns to the water's depths, it's unclear that this sort of alteration will have any sort of lasting effect on him--at least, when he's around anyone other that you.";
				now twistfsdfeedmemory is true;
			otherwise:
				say "     Shifting around to give you a better view of his face, his softened expression an indication of his now-familiar intent. Beginning to cough up a meal, you find yourself ill-inclined to contest his sudden parental interests. Soon shifting to offer you this pragmatic kiss, you sheepishly abide the flood of partially digested fish.";
				say "     Thankfully, he does appear to be getting better at this, though his more abrasive design still makes the transaction a slightly awkward one. Once satisfied he lets you off with a strangely jovial chirp, leaving you to recover from this whole ordeal. As he returns to the water's depths, you ponder the implications of what has just transpired before setting off.";
			decrease hunger of player by a random number between 10 and 24;
			now lastfsdfeeding is turns;
			infect;
		otherwise if "Touched by Madness" is listed in feats of player and "MPreg" is listed in feats of player and (("Kinky" is listed in feats of player and a random chance of 1 in 3 succeeds) or a random chance of 1 in 4 succeeds) and scalevalue of player < 4 and inasituation is false:
			If MFSDUBM is false:
				say "     He pauses as if stopped by some unseen force, the power of which compelling him to move off of you. Baffled for a moment, he appears confused, somehow affected by your presence. Before you might do anything with this new-found freedom, though, his perception of the situation returns. Looking at him now, his demeanour has radically shifted; harsh once was his regard; assertive, domineering, his expression now soft and abiding, almost matronly.";
				say "     Bearing down upon you once more, his slick, dripping tongue slathering your smaller frame in an odd show of affection, until you are drenched in his saliva, blatantly arousing you. He doesn't even remotely seem interested in this; rather, he would suddenly drag herself over you, soft underbelly and clearly erect cock grinding against your lubricated frame before he stops, showing no desire to spare you of his massive weight. Instinctively, you push against his pressure, but this only abides his tainted intent, and your endeavours backfire when you push yourself past his anal ring.";
				say "     Unable to contest this new, severely twisted desire, he begins to grind himself against the sand, his portal tightening against your frame as your lower torso soon follows, pulling you deeper into his slick depths. This overwhelming heat; this hungry, supple abyss, it [if cocks of player > 0 or cunts of player > 0]is more than enough to elicit your orgasm, almost immediately, fate sealed when this is all that the dragon needs to reach his own climax[otherwise]torments you to no end, your fate soon sealed as the dragon reaches climax[end if], and though your fate may seem grim, you find yourself pulled to a destination alien even to this perverse domain before your vision fades. The dragon would no doubt recover and move on, even after soaking his underbelly with his own cum, the occupancy of his new captive not outwardly apparent to those who might see his large form.";
				now MFSDUBM is true;
			otherwise:
				say "     He pulls off of you, his demeanour shifting into something now all-too familiar. [if hp of player is 0 and player is not submissive]Your better judgement compels you to flee, but this only provokes him into pinning you once more; you will be subject to his perverse verdict regardless. In spite of this assertion, he offers what he doubtlessly now perceives as his twisted offspring plenty of affection, though his thick, fish-smelling tongue's endeavours are dual in nature, preparing you for what is to follow[otherwise]Overwhelmed by his inappropriately maternal pull, he need only turn sideways, exposing his hardening cock and eager hole to you, to compel you forward. Your tongue slathering this hole and cock base with affection as he reciprocates across your frame, now doubtlessly perceiving you as his twisted offspring, what better judgement you might of had deflected by the reality of your lack of choice[end if].";
				say "     Blatantly aroused as you are, his satisfaction is met, [if hp of player is 0 and player is not submissive]forcing himself down on you once more, and you are offered no choice but to accept his aquatic ring's embrace, smaller form quickly disappearing entirely under him[otherwise]compelling you to enter his hungering ring, though you might only comply with your head and torso before he slams himself upright once more, engulfing the remainder of you with ease[end if].";
				say "     The sound of his conflicted mess of song and roar from such tainted need muffled within these confines, his passage tightens against your wholly engulfed frame, pulling you deeper into his slick depths as he seeks reprieve. This overwhelming heat; this hungry, supple abyss, now all too well-known to you, it [if cocks of player > 0 or cunts of player > 0]is but a moment before it elicits your orgasm, fate sealed when this is all that the dragon needs to reach his own climax[otherwise]torments you to no end, your fate soon sealed as the dragon reaches climax[end if], pulling you into that familiar, final, and inevitable destination before your vision fades. The Dragon would no doubt recover and move on, even after soaking his underbelly with his own cum, the occupancy of his new captive not outwardly apparent to those who might see his large form, and doubtlessly happy that you are his.";
			attempttowait;
			if (("Kinky" is listed in feats of player and a random chance of 1 in 3 succeeds) or a random chance of 1 in 4 succeeds) and FSDOPEN < 2:
				Say "     In due time you come to, the thick, hard walls of an egg surrounding you. However, you feel yourself slightly tumbling and shifting about and when you attempt to break free of the egg you find yourself unable to. The heat is overwhelming, [if cocks of player > 0 or cunts of player > 0]your arousal quickly rising once more, driving you to pleasure yourself uncontrollably within these confines, making a further mess of yourself[otherwise]your arousal quickly rising once more, forced to abide the torment of these demented confines[end if].";
				infect;
				say "     After what seems like forever, you can see the familiar light of the outside coming through the translucent walls of your prison, compelling you to finally break free, and once you acclimate to the open air it's made very clear -why- you were forced within those confines longer than natural";
				if a random chance of 1 in 2 succeeds and girl is not banned:
					say ". A sea dragoness is before you, looking at her somewhat tired and lust-addled form, it's clear that she happened upon your egg and was compelled to use it for her own sexual gratification--much to your expense.";
					if (("Kinky" is listed in feats of player and a random chance of 3 in 8 succeeds) or a random chance of 1 in 5 succeeds):
						say "     Looking at her now, she doesn't appear fully satisfied, and looks as though she might concede to using -you- instead of your prior residence. You don't think you can take another fight, so your choice is to run or submit. Run for it?";
						If the player consents:
							let bonus be ( dexterity of player - 10 ) / 2;
							let target be 14;
							if "Submissive" is listed in feats of player, increase target by 1;
							let dice be a random number from 1 to 20;
							if bonus + dice is greater than target:
								say "You make a run for it, successfully getting away from the beast with relative ease. Thankfully, you manage to find your things, strewn across the [if showlocale is true]beach[otherwise]ground[end if].";
								now FSDOPEN is 0;
							otherwise:
								say "You try to make a run for it, but you stumble and fall onto the [if showlocale is true]sand[otherwise]ground[end if], and in seconds the dragoness is on top of you, ready to subject you to her desire.";
								increase FSDOPEN by 1; [This will deflect the opening submit/lose line]
								say "[dragoness attack]";
						otherwise:
							say "You decide the best thing to do is just let her have her way with you, the eager dragoness soon pinning you against the [if showlocale is true]sand[otherwise]ground[end if], ready to subject you to her desire.";
							if hp of player < 1, now hp of player is 1;
							increase FSDOPEN by 1; [This will deflect the opening submit/lose line]
							say "[dragoness attack]";
					otherwise:
						say "     Doubtlessly exhausted as she is, she turns to depart, leaving you to retreat and gather your belongings--strewn across the beach as they are--along the way.";
						now FSDOPEN is 0;
				Otherwise:
					say ". Another sea dragon is before you, [one of]though you instinctively know that it's[or]fairly certain that it's not[at random] the same one that first trapped you. Looking at his somewhat tired and lust-addled form, it's clear that he was compelled to use your egg for his own sexual gratification--much to your expense.";
					if (("Kinky" is listed in feats of player and a random chance of 3 in 8 succeeds) or a random chance of 1 in 5 succeeds):
						say "     Looking at him now, he doesn't appear fully satisfied, and looks as though he might concede to using -you- instead of your prior residence. You don't think you can take another fight, so your choice is to run or submit. Run for it?";
						If player consents:
							let bonus be ( dexterity of player - 10 ) / 2;
							let target be 14;
							if "Submissive" is listed in feats of player, increase target by 1;
							let dice be a random number from 1 to 20;
							if bonus + dice is greater than target:
								say "You make a run for it, successfully getting away from the beast with relative ease. Thankfully, you manage to find your things, strewn across the [if showlocale is true]beach[otherwise]ground[end if].";
								now FSDOPEN is 0;
							otherwise:
								say "You try to make a run for it, but you stumble and fall onto the [if showlocale is true]sand[otherwise]ground[end if], and in seconds the sea dragon is on top of you, ready to subject you to his desire.";
								increase FSDOPEN by 1; [This will deflect the opening submit/lose line, check will need to be added for it]
								say "[dragon attack]";
						otherwise:
							say "You decide the best thing to do is just let him have his way with you, the eager sea dragon soon pinning you against the [if showlocale is true]sand[otherwise]ground[end if], ready to subject you to his desire.";
							if hp of player < 1, now hp of player is 1;
							increase FSDOPEN by 1; [This will deflect the opening submit/lose line, check will need to be added for it]
							say "[dragon attack]";
					Otherwise:
						say "     Doubtlessly exhausted as he is he turns to depart, leaving you to retreat and gather your belongings--strewn across the beach as they are--along the way.";           
						now FSDOPEN is 0;
			Otherwise:
				say "     In due time you come to, greeted by the thick and hard confines of an egg, light from the outside spilling through the translucent surface and compelling you to break yourself free. Exposed to the salty air once more, you were thankfully left on the beach, and you clean yourself off before gathering your belongings as they are, strewn across the beach.";
				infect;
				now FSDOPEN is 0;
		otherwise if cunts of player > 0 and ( cunt length of player > 12 and cunt width of player > 7 ):
			say "     Finally, and thankfully, you're relinquished of his weight; however, before you can get up you're pinned by his massive bulk a second time, now completely on top of you.  He's shifted his weight enough so not to crush you, but now he's in a much better position to impale you with his massive, throbbing dick.";
			say "     You twitch with every irreverent and jerking thrust, only teasing tests [if cunts of player > 1]for one of[otherwise]of[end if] your [bodytype of player] cunt's willingness to accommodate his flared head.  Soon your feel him put on the pressure as he slowly squeezes the rigid organ past your entrance, the intense sensation of which grants you inevitable reprieve when you get past its spade-shaped tip.  The beast lets out an airy hiss in his own approval, but only lets you adapt to his girth briefly before he begins fucking you in earnest.";
			say "     His assault quickly becomes relentless in its pace, intent on using you with little regard to your well being.  Any protests you might offer up rapidly diminish as you feel his pre incrementally spurt within your depth, what pain and discomfort you might have had driven away in favour of an immense and overwhelming desire to continue to be reamed by this powerful dragon, and soon you are drowning in ecstasy with every immense thrust[if cocks of player > 1].  You orgasm over and over again, sandy ground under you made sticky as your own, [cock size desc of player] cocks make a repeated mess of things, driving you into a manic and blinding lust-frenzy[otherwise if cocks of player > 0].  You orgasm over and over again, sandy ground under you made sticky as your own, [cock size desc of player] cock makes a repeated mess of things, driving you into a manic and blinding lust-frenzy[otherwise].  You orgasm over and over again, driving you into a manic and blinding lust-frenzy[end if].  The powerful beast begins pressing harder against your beleaguered form as he draws closer to his own release, and if you had any working sense of self-preservation you'd worry over your well-being but by now all you can feel is his flesh, his heat envelop you more and more.";
			say "     You feel like you're going to pass out, the immense pleasure of this monster more than you can handle before he suddenly lets out a deafening roar[if scalevalue of player < 4].  Your belly bulges as your womb is almost immediately stuffed to its limits with the dragon's cum, each subsequent and torrential spurt squirting out from your stuffed hole[otherwise].  You begin to feel his massive load firing inside you, your belly slowly bulging further and further with each progressive throb[end if].  Slowly, as he regains himself, he crawls off of you, relinquishing you of his now-softened cock[if scalevalue of player < 4], most of his load gushing out of you as a result[end if].  Still in a lustful haze, you briefly attempt to lick yourself clean of his of his fluids before you collapse from exhaustion. When you come to the dragon's nowhere to be seen, no doubt satisfied with leaving you on this beach exposed and sore as you likely are now.[impregchance]";
		otherwise if ( scalevalue of player > 3 or ( scalevalue of player is 3 and "Twisted Capacity" is listed in feats of player ) ) and ( ( cunts of player > 0 and "More Anal" is listed in feats of player ) or ( cunts of player is 0 and "Less Anal" is not listed in feats of player ) ) and a random chance of 3 in 5 succeeds:
			say "     Finally, and thankfully, you're relinquished of his weight; however, before you can get up you pinned by his massive bulk a second time, now completely on top of you. He's shifted his weight enough so not to crush you, but now he's in a much better position to impale you with his massive, throbbing dick.";
			say "     You twitch with every irreverent and jerking thrust, only teasing tests of your [bodytype of player] asshole's willingness to accommodate his flared head, [if scalevalue of player is 3]and when it's clear that--in spite your small size--you will easily abide him[otherwise]before[end if] you feel him put on the pressure as he slowly squeezes the rigid organ past your tight ring, the intense sensation of which grants you inevitable reprieve when you get past that spade-shaped tip. The beast lets out an airy hiss in his own approval, but only lets you adapt to his girth briefly before he begins fucking you in earnest.";
			say "     His assault quickly becomes relentless in its pace, intent on using you with little regard to your well being. Any protests you might offer up rapidly diminish as you feel his pre incrementally spurt within your depth, what pain and discomfort you might have had driven away in favour of an immense and overwhelming desire to continue to be reamed by this powerful dragon, and soon you are drowning in ecstasy with every immense thrust[if cocks of player > 1].  You orgasm over and over again, sandy ground under you made sticky as your own, [cock size desc of player] cocks make a mess of things, driving you into a manic and blinding lust-frenzy[otherwise if cocks of player > 0].  You orgasm over and over again, sandy ground under you made sticky as your own, [cock size desc of player] cock makes a mess of things, driving you into a manic and blinding lust-frenzy[otherwise if cunts of player > 0].  You orgasm over and over again, driving you into a manic and blinding lust-frenzy[otherwise].  You are driven into a manic and blinding lust-frenzy, exacerbated by the tormenting lack of any way to satiated it[end if].  The powerful beast begins pressing harder against your beleaguered form as he draws closer to his own release, and if you had any working sense of self-preservation you'd worry over your well-being but by now all you can feel is his flesh, his heat envelop you more and more.";
			say "     You feel like you're going to pass out, the immense pleasure of this monster more than you can handle before he suddenly lets out a deafening roar. You begin to feel his massive load firing inside you, your [if scalevalue of player is 3]already-bulging belly quicking expanding[otherwise]belly slowly bulging[end if] further and further with each progressive throb. Slowly, as he regains himself, he crawls off of you, relinquishing you of his now-softened cock. Still in a lustful haze, you briefly attempt to lick yourself clean of his of his fluids before you collapse from exhaustion. When you come to the dragon's nowhere to be seen, no doubt satisfied with leaving you on this beach exposed and sore as you likely are now.[mimpregchance]";
		otherwise if "More Anal" is listed in feats of player and a random chance of 1 in 3 succeeds:
			say "     Carefully, the beast shifts more of its weight over you.  Much in spite of what protests you can offer up against him, he's simply too heavy for you to make any effort of pushing him off.  Satisfied with his grip on you, he seems more intent on abusing you rather than fucking you properly, an intent of which he obligingly informs you when you feel his tongue begin to force its way past your anal ring.";
			say "     [if scalevalue of player < 4 and the player is not twistcapped]The slimy organ really puts the strain on you as it's too large to easily fit in that hole, but the beast is diligent if nothing else and in due time you feel it slowly worm its way in.  You're so diminutive relative to his own scale that your behind is easily eclipsed by his toothy maw, making you frightful that the beast may have half a mind to swallow you whole, though for now it only has the effect of coating your lower half in his saliva[otherwise]It's initial efforts are probing, curious as to how pliable your hole might be, before the slimy organ begins to worm its way into the depths of your bowels with little obstruction.  With a huff and a rumble the unengulfed portion of his long frequently buckles and bends prior to its brief re-immersion, the organ making a mess of your [bodytype of player] thighs and groin as he fucks you with his tongue[end if].  It's fervent motion doubtlessly lubricated by copious amounts of the beast's saliva, you feel his wanton affections grab a hold of you, pulling you further and further into a compliant and aroused state until you are overwhelmed by the ecstasy of the beast's touch.";
			if cocks of player > 0:
				say "     Your audible moans amusing to the dragon, it's not long before your [cock size desc of player], [bodytype of player] dick[if cocks of player > 1]s explode with their[otherwise] explodes with it's[end if] inevitable release[if cock width of player > 12].  You fire off gout after excessive gout of seed against yourself and the beast, so much so that it appears to mildly perturbed, clearly not that interested in your fluids at all, let alone in this much excess[otherwise].  You convulse with every successive throb of your release, spilling your seed against both the yourself and the dragon, not that he seems to particularly care[end if].  He continues to milk you dry of your fluids before both his tongue and his body relinquishes its hold on you.";
			otherwise:
				say "     [if cunts of player > 0]Your audible moans amusing to the dragon, it's not long before your writhe with each concussive wave of pleasure as you orgasm, your sexual fluids spraying against the beast's irreverent organ.  He inevitably pulls his tongue free, taking this opportunity to lick you clean of your climax, savouring your taste before he finally crawls off of you[otherwise]Your audible moans amusing to the dragon, you can only writhe in ecstatic agony as he continues to assault you with no end in sight.  You can't satisfy these overwhelming desires and you feel like the beast's irreverent affection will knock you unconscious before he finally relents.  Satisfied with his torment, both his tongue and his body relinquish his hold from you[end if].";
			say "     He turns to depart.  Still with some energy but still driven into a lustful frenzy by the creature's influence, you try to crawl after him only for him to dive back into the water's depths.  You collapse from exhaustion, and it takes you awhile to get back up and clean the mess of bodily fluids the dragon left in his wake.";
		otherwise:			[oral]
			say "     Eventually, and thankfully, you're relinquished of his weight, only for him move over you entirely. He shifts his weight just enough as to not completely smother you, but enough to hold your safety ransom, a ransom he intends to have you pay in pleasure when he pulls his massive member in front of you.";
			say "     [if humanity of player < 51 or the player is submissive]You feel an overwhelming wave of submission as you can't resist the desire to taste such a powerful cock, immediately obliging and pulling the head into your eager,[otherwise]You're forced to stare at the dripping cock, occasionally and irreverently prodding you, smearing your face with his pre.  Sadly, he's not letting you go anytime soon, so you reluctantly engulf the rod within your[end if] [facename of player] maw[if scalevalue of player < 4].  The thing is much too big for you, but you do what you can to ensure that your captor is sufficiently pleased[otherwise].  You're big enough to fit the flared and distinctly spade-shaped rod with relative ease, much to the pleasure of your captor, though--due to that spade shape--removing it seems to be a bit of a challenge, not that the beast has any regard for that right now[end if].";
			if humanity of player > 50:
				say "     [if the player is submissive]Already driven to service this powerful beast, as you taste his masculine fluids this desire becomes increasingly fervent, driving you into a manic and blinding desire to pleasure this male even at the expense of your own restraint and safety[otherwise]Though you were ill-inclined to service the creature before, as you begin to taste his pre you feel an intensifying and overwhelming desire to submit to this beast, the influence of its infection having increasing effect on you, to an almost dizzying degree[end if]";
			otherwise:
				say "     Already driven to service this powerful beast, as you taste his masculine fluids this desire becomes increasingly fervent, driving you into a manic and blinding desire to pleasure this male even at the expense of your own restraint and safety";
			say ".  You feel his weight press more and more against you, but all you can do take immense pleasure in the feel of his overwhelming warmth both on top of you and inside you, and you feel like you're about to pass out before your jolted to attention when his cock immediately explodes with his release.";
			say "     [if scalevalue of player < 4]Your stomach fills with his hot fluids almost immediately and his cock is forced free of your hold, absolutely drenching you in his salty and sticky fluids, not that you mind since, by now, you're driven by a mad lust and can only numbly try to lick the fluids clean from his massive form[otherwise]By now the rods engulfed fairly deep in your gullet, forcing you to let out a muffled moan as your stomach slowly bloats with his thick fluids, so much so that your large form nearly displaces the beast from his position of having you pinned down, not that he really cares by now.  Eventually, the flow stops, but you're still driven mad with lust, and can only weakly lick his softening cock as it's pulled from you[end if].  Thankfully, he lets you off without any more trouble, and just leaves you exhausted and half-buried in the sand before he crawls back into the sea from whence he came.";


To say dragon loss:
	say "     Bested by you, the beast roars out in frustration, retreating back into the water's deeps.  For now you can at least take comfort in victory, though this likely isn't the last you've seen of him.";


to say fsdm desc:
	now FSDOPEN is 0;
	now firebreathcount is 0;
	now firebreathready is false;
	say "     You notice something in the water, which appears to be a large shadow on its approach towards you.  Suddenly, the prior silence is shattered with the concussive crashing of waves as a massive beast hurls itself from under its surface, landing on the beach close to you.  [one of]The dragon sniffs the air before seeing you, its eyes agleam with particular hunger[or]Looking at you, the dragon roars its challenge with a frightening glare[or]The dragon eyes you unnervingly as it seems to consider you for some purpose[at random].  You'd imagine its fin-like limbs would be ill-equipped to move across land, but he's quick to prove otherwise as the massive bulk begins rushing down upon you.";

Section 2 - Monster Insertion

Table of random critters (continued)
name	attack	defeated	victory	desc	face	body	skin	tail	cock	face change	body change	skin change	ass change	cock change	str	dex	sta	per	int	cha	sex	hp	lev	wdam	area	cocks	cock length	cock width	breasts	breast size	male breast size	cunts	cunt length	cunt width	libido	loot	lootchance	scale (number)	body descriptor (text)	type (text)	magic (truth state)	resbypass (truth state)	non-infectious (truth state)	nocturnal (truth state)	altcombat (text)
--	--	--	--	--	--	--	--	--	--	--	--	--	--	--	--	--	--	--	--	--	--	--	--	--	--	--	--	--	-- 	--	--	--	--	--	--	--	--	--	--	--	--	--	--	--	--;

When Play begins:
	Choose a blank row from Table of random critters;
	now name entry is "feral sea dragon"; [Name of your new Monster]
	now attack entry is "[one of]The dragons massive head slams against you.[or]The dragon slaps you against a cluster of rocks with its rudder like tail.[or]It slams you into the soft sand by hammering you with its narrow tail.[or]He stomps you into the soft sand with its webbed hand like paw.[at random]"; [Text used when the monster makes an Attack]
	now defeated entry is "[dragon loss]"; [ Text or say command used when Monster is defeated.]
	now victory entry is  "[dragon attack]"; [ Text used when monster wins, can be directly entered like combat text or description. or if more complex it can be linked to a 'To Say' block as the demonstration text shows.] 
	now desc entry is "[fsdm desc]";[ Description of the creature when you encounter it.]
	now face entry is "very much draconic in shape, adorned with a set of barbed and savage teeth.  Clearly aquatic in design, ridges and fins adorn the sides of your head, and you find it a challenge to maneuver any building with such an elongated neck";[ Reference "You have a (your text) face."] 
	now body entry is "distinctly bloated and bulky fare, though somewhat streamlined in presentation, inferring that you'd be better suited for hauling it underwater, if your webbed and finned limbs were any indication";[ Body Description, format as the text "Your Body is (your text)"] 
	now skin entry is "[one of]light blue, smoothly scaled[or]light blue, softly scaled[or]light blue, delicately scaled[at random]";[Reference "You have (your text) skin"] 
	now tail entry is "You have a long, somewhat bulky tail, top adorned with a sail-like fin.";
	now cock entry is "[one of]spade-tipped and tapered[or]black[at random]";
	now face change entry is "you undergo the effects of this infectious strain.  Your face draws forward, narrowing into a distinctly draconic muzzle, the features of which are subtly masculine and finned for aquatic travel, and you nearly fall over as you find your neck suddenly elongated"; [Reference "Your face feels funny as (your text)" ]
	now body change entry is "you undergo the effects of this infectious strain.  Your features become increasingly rounded to appeal to a more aquatic--though distinctly draconic--lifestyle, though thankfully your limbs retain their articulation and mobility so that you fare on land with minimal difficult"; [ Reference "Your body feels funny as (your text)" ]
	now skin change entry is "it toughens, scales sprouting from your flesh to cover the whole of your body.  Curiously, it feels better suited for aquatic life than one on land"; [ Reference "Your skin feels funny as (your text)" ]
	now ass change entry is "you undergo the effects of this infectious strain.  You nearly lose balance as a long, large--though relatively lightweight--tail explodes from your behind.  It's distinguished with a fin across it's top, inferring it's more aquatic application"; [ Reference "Your ass feels funny as (your text)" ]
	now cock change entry is "your cock turns black.  It gradually tapers towards the tip, the flair spreading to give it a distinctly spade shape";
	now str entry is 30;
	now dex entry is 14;
	now sta entry is 28;
	now per entry is 12;
	now int entry is 6;
	now cha entry is 3;
	now sex entry is "Male";
	now hp entry is 100;			[ How many HP has the monster got? ]
	now lev entry is 10;			[ Level of the Monster, you get this much hp if you win, or this much hp halved if you loose ] 
	now wdam entry is 25;			[Amount of Damage monster Does when attacking.]
	now area entry is "Beach";
	now cocks entry is 1;
	now cock length entry is 21;
	now cock width entry is 15;
	now breasts entry is 0;
	now breast size entry is 0;
	now male breast size entry is 0;
	now cunts entry is 0;
	now cunt length entry is 21;
	now cunt width entry is 15;
	now libido entry is 25;
	now loot entry is "";
	now lootchance entry is 0;
	[ These represent the new additions to the table of random critters ]
	now scale entry is 5;				[ Number 1-5, approx size/height of infected PC body:  1=tiny, 3=avg, 5=huge ]
	now body descriptor entry is "[one of]large[or]bulky[or]aquatic[or]muscled[at random]";
	now type entry is "[one of]draconic[or]reptilian[purely at random]";		[ one-word creature type. Ex: feline, canine, lupine, robotic, human... Use [one of] to vary ]
	now magic entry is false;			[ Is this a magic creature? true/false (normally false) ]
	now resbypass entry is false;			[ Bypasses Researcher bonus? true/false (almost invariably false) ]
	now non-infectious entry is false;		[ Is this a non-infectious, non-shiftable creature? True/False (usually false) ]
	blank out the nocturnal entry;		[ True=Nocturnal (night encounters only), False=Diurnal (day encounters only), blank for both. ]
	now altcombat entry is "firebreath";	[ Row used to designate any special combat features, "default" for standard combat. ]

when play ends:
	if bodyname of player is "feral sea dragon" or bodyname of player is "feral sea dragoness":
		if humanity of player is less than 10:
			say "     Losing your mind to your feral compulsions your instincts draw you back to the beach--which is perhaps for the better as the infection reaches its natural conclusion and you lose all land-based articulation and mobility.  You find yourself [if cunts of player > 0]singing[otherwise if cocks of player > 0]roaring[otherwise]crying[end if] out into the ocean, in search of a mate.";
			if cocks of player > 0 and drgnsbmt >= 3:
				say "     You soon hear a reciprocating song soon calling out from the ocean.  Heeding your call, she rises from the water to greet you, to which you shyly offer yourself.  She seems more than happy to have you, and leads you into the water and to a cave, where you're met with a... peculiar sight.  A veritable harem of females, at least half a dozen by the looks, await you, all which seem very pleased to have you.  They appear to be more dominantly-oriented females, banded together to ward off their aggressive male counterpart.  Whether these females are a product of your own submissive influence or that they exist as a natural part of this strange ecosystem is beyond your feral mind, but what you do know is that there are a lot of females who need a male they can [']use['], the term to be taken quite literally.";
				say "     You're forcibly prevented from ever leaving the cave, not that you would mind as they feed and ride you frequently, to the point where you grow increasingly lethargic, relegating you to watch over their young whilst they hunt[if anallevel is 3 or cunts of player > 0].  You grow so lethargic, in fact, that you hardly protest when your adolescent male spawn mount you as practice or mere pleasure.  You don't mind, even when your mates tease you for it[end if].  It is a simple, lustful existence where you submissively fulfill the sexual desires of those around you, and nothing pleases you greater than doing just that.";
 			otherwise if ( cocks of player > 0 and cunts of player is 0 and ( girl is banned or ( "Submissive" is listed in feats of player and "Less Anal" is not listed in feats of player and a random chance of 1 in 3 succeeds ) or "More Anal" is listed in feats of player or ( "MPreg" is listed in feats of player and a random chance of 2 in 3 succeeds ) ) ) or ( cocks of player is 0 and cunts of player is 0 ):	[M/M ending]
				say "     You're met with the distant roar of a male, and though you find yourself hesitating in regards to this turn of event your input on the matter becomes irrelevant when the dragon suddenly rises up from the waters to meet you.  He sees your hesitation and responds immediately by forcing you onto your side, his already-emergent cock irreverently forcing itself into your unsuspecting hole.  You cry out ";
				if bodyname of player is "feral sea dragoness":
					say "the monster frequently mocking your protests, often citing your dragoness appearance as reason for why you should enjoy being the property of such a fertile male until you concede and hide yourself under his dominant form, pumped full of his seed.";
				otherwise:
					say "your protests only pleasuring the monster further as he ravages you, until you concede and hide yourself under his dominant form while he pumps you full of his seed.";
				say "     Eventually, you're pulled back into the depths with him.  The craven beast keeps you in his home as his own personal fucktoy, [if girl is banned]ravaging you daily without relent until you look forward to his abuse, feeding you in half-eaten fish and his own, thick seed[otherwise]and though he must gather females to satisfy his need for offspring, he's never one to neglect you of his harsh affections.  He refuses to share any of said females with you, not that you mind, as by now you've grown to love his abuse[end if]";
				if "MPreg" is listed in feats of player:
					say ".  However, you can imagine his surprise when he finds out that you're actually getting pregnant from being fucked silly by him.  He, of course, attributes this to his exceptional virility, though he's now at least a bit more kind to you.";
				otherwise:
					say ".";
			otherwise if cunts of player > 0 and cocks of player is 0 and guy is banned:
				say "     Your song is soon returned with that of another, and you pull yourself into the water's depths, meeting up with the fellow dragoness.  She regards you with soft affections before she leads you a remote cave hidden along the coast.  You two spend the rest of your days together, offering each other pleasurable company.  As time would pass and the world seems to calm, you and your companion are occasionally accosted by strangers, though in one instance where the two of you teach a trespasser a [']lesson['] when your mate forces one of them up your cunt only to later lay them as one of your own you quickly learn a way the two of you can start a family...";
			otherwise if cunts of player > 0:
				say "     Your call is met with a distant roar, and you're soon drawn to meet each other within the water's depths.  Offering yourself to him, he regards you with a rumble of immediate approval, an approval he is quick to illustrate when he promptly crawls over your form and drives his hardening cock into your needy cunt.  He mates you with a clear and immediate fervor; the first of a great many times";
				if "Sterile" is listed in feats of player:
					say ".  Very much in spite your inability to bear children for him, he keeps you along for his own personal pleasure.  Of course, this means he has to gather additional females to bear his offspring, and you find yourself taking great joy in helping to rear these children before they're sent out into the world.";
				otherwise:
					say ".  You constantly bear your mate's children for him, giving birth and attending to your offspring briefly before they are sent off to fend for themselves in the wild, only to be filled again with his seed.  Soon your mate gathers more females for his harem, but as his first he regards you with the most reverence[if cocks of player > 0].  On occasion he even lets you mate with a number of his other consorts yourself, when he so allows it[end if]";
			otherwise:
				say "     Your gesture is inevitably reciprocated with the song of an eager female.  Compelled to swim into the water's depths you meet up with your new mate; though, as you approach, the sea dragoness would tease you by swimming off, eliciting your chase.  It's made apparent of her intent when she leads you to a hidden cavern, offering herself before you as you approach.  Such an offer the creature shows great pleasure in it's acceptance when you're compelled by your feral lust to mount her.  Rutting her fast and hard, you claim her and this territory as your own.";
				say "     As she bears your offspring you gather other dragonesses in the area for your personal harem, and it's not long before you possess a great number of them.  As time would pass, your children would spread to the far corners of the world, until all who fare the sea do so with an ever-present fear of your kin.";
		[Player survival endings have not been rewritten. - Nov 18/12]
		otherwise if bodyname of player is "feral sea dragon":	[survive as feral sea dragon]
			say "Your form is that of a sea dragon.  It may be that of a quadruped, but it has its own beauty about it.  You are glad you were able to escape that dragon that changed you.";
			if cocks of player > 0:
				say "You feel compelled to return to the ocean.  You swim leisurely for a couple hours.  The caress of the currants filling you with a bliss as you hear a faint sound.  You cock your head as you identify the sound.  Speech.  soon you notice shadows pass by and recognize the shapes to be those of surfboards.  Two of them.  You suddenly realize you can smell them through the water.  You float in place for a moment as you cock begins to emerge.  Then you see your chance and take it!  You grab one of the surfer's legs with your jaws.  Holding them to your belly with your forepaws you begin to pound the otter's ass.  You don[apostrophe]t care what its gender is.  Your only care is getting off.  In only a minute or two the water turns cloudy as you fill the unconscious otter boy with your non-infectious sperm.  Now sated you realize he can[apostrophe]t breathe underwater.  You swim closer to shore and deposit him.  Staying only long enough to be sure they found him.  This continues for a few weeks.  Then the surfers stop showing up. One day you find yourself staring at the empty beach from just offshore.  You make a squealing whale song kind of noise trying to express your need to anyone who will listen.  Sadly no one hears it and you disappear back to the sea.  Only returning to shore during surf season to satisfy your needs.  You become ecstatic the first time you discover you can fit them inside your cunt.";
				if humanity of player is greater than 50:
					say "You fight the urge to live at sea, but you can't stay away from it.  You find yourself lounging on the beach.  Feeling no need to have any property you are perfectly content to just lay in the sand.  The beach soon becomes a popular tourist attraction due to your presence.  Your days are filled with entertaining children while nights bring those interested in your dual genitals.";
			otherwise:
				if humanity of player is less than 50:
					say "You walk into the water as the military arrives and swim off.  Living for a couple weeks off nothing but fish.  Eventually you find yourself on another beach.  You lie down in the sand and stretch yourself out as those on the beach show interest in you.  You lift your head and open your jaws a moment, but your now unsure what you were trying to do and close them.  Then set your head back on the sand as the furred scaled and humans in the crowd continue to gawk at you.  Eventually officials show up and begin to persuade you into a large truck.  You see the letters on it and try piecing them together but no matter how much you try they just don[apostrophe]t seem to have meaning.  You only spend two days at your destination before your being passed to a wealthy looking man.  He takes you to his manor where he introduces you to your new home.  The next week you find yourself easily accepting the artificial beach as your home.  Once the week is up the man makes some noises that sound oddly familiar before another sea dragon is led into the enclosure.  Curious you begin to inspect the dragon and discover it[apostrophe]s a male!  You soon find yourself leading him around the enclosure.  Teasing him with glimpses of your cunt.  He makes sounds that you vaguely understand and you struggle to find words to respond 'Come. go. g-get some.'  You lower your chest to the ground and move your tail out of the way invitingly.  You growl as he takes his time to mount you.  He gets the message and forcefully drives his black cock into you.  You sing your pleasure as he roughly ruts you.  Your head lays on the sandy ground as the rough mating puts you in a pleasant haze.  It[apostrophe]s over quickly and something in your mind nags at you that it could have been better, but you just feel sated and collapse into the sand.  His cum leaking from your cunt into the sand.  He says something and walks off to the water as you begin thinking about how great it[apostrophe]ll be to have a clutch of eggs.";
				otherwise:
					say "You escape into the sea.  Cautiously following the coastline you swim for a few days.  Eventually you come across another beach.  You walk out of the sea onto the beach and look around.  Heading off to a nearby city.  You scare off almost everyone you come across.  Apparently it was going to be difficult to fit in. Eventually you find someone who isn[apostrophe]t scared of you and you ask him for help.  He agrees to house you and feed you as payment for a job.  You agree and it turns out he owns a hotel.  It isn[apostrophe]t enormous but big enough to afford the cost of feeding a dragoness.  As word spreads of the hotels new main attraction you discover a way to make tips.  You discovered it by overhearing a conversation of two patrons and decided to take up their idea.  So you grabbed one of them and took him to your private den near the lobby.  Dropping him on your bedding you turn around and lower yourself as you suggestively say 'I hear you[apostrophe]re interested in mating a dragoness.'  He doesn[apostrophe]t hesitate and begins to thrust his human penis into you.  At first it doesn[apostrophe]t seem to be worth it.  However soon his cock begins to grow.  Filling you much more snugly.  You smile as it turns into a worthy endeavor thanks to you still being a little infective.";
		otherwise:									[survive as feral sea dragoness]
			say "Your form is that of a sea dragon.  It may be that of a quadruped, but it has its own beauty about it.  You are glad you were able to escape that dragon that changed you.";
			if cocks of player > 0:
				if cunts of player is 0:
					say "Your new form is quite pleasant.  Although you can[apostrophe]t bare to be too far from the ocean.  Luckily you find a job as a lifeguard.  You excel at your job and you begin receiving offers from beach towns that wish to have you to attract tourism.";
					if humanity of player is less than 50, say "You lose yourself in the fame your skill and appearance create. Soon you[apostrophe]ve transformed your fame to infamy as a lapse of control leads to you attempting to rape a swimmer on live television.  You stop receiving offers and soon aren[apostrophe]t even welcome at any beaches.  You eventually decide it[apostrophe]s best if you live your life out at sea.";
					if humanity of player is greater than 49, say "You enjoy your fame and fortune.  You have one close call with your beastly urges but had managed to restrain yourself.  You begin to build a harem.  To keep your urges under control.  Every evening your specially designed home is filled with the sounds of draconic rutting.";
				otherwise:
					if humanity of player is less than 50:
						say "You feel compelled to return to the ocean.  You swim leisurely for a couple hours.  The caress of the currants filling you with a bliss as you hear a faint sound.  You cock your head as you identify the sound.  Speech.  soon you notice shadows pass by and recognize the shapes to be those of surfboards.  Two of them.  You suddenly realize you can smell them through the water.  You float in place for a moment as you cock begins to emerge.  Then you see your chance and take it!  You grab one of the surfers legs with your jaws.  Holding them to your belly with your forepaws you begin to pound the otters ass.  You don[apostrophe]t care what its gender is.  Your only care is getting off.  In only a minute or two the water turns cloudy as you fill the unconscious otter boy with your noninfectious sperm.  Now sated you realize he can[apostrophe]t breathe underwater.  You swim closer to shore and deposit him.  Staying only long enough to be sure they found him.  This continues for a few weeks.  Then the surfers stop showing up. One day you find yourself staring at the empty beach from just offshore.  You make a squealing whale song kind of noise trying to express your need to anyone who will listen.  Sadly no one hears it and you disappear back to the sea.  Only returning to shore during surf season to satisfy your needs.  You become ecstatic the first time you discover you can fit them inside your cunt.";
					otherwise:
						say "You fight the urge to live at sea, but you can't stay away from it.  You find yourself lounging on the beach.  Feeling no need to have any property you are perfectly content to just lay in the sand.  The beach soon becomes a popular tourist attraction due to your presence.  Your days are filled with entertaining children while nights bring those interested in your dual genitals.";
			otherwise:
				if humanity of player is less than 50:
					say "You walk into the water as the military arrives and swim off.  Living for a couple weeks off nothing but fish.  Eventually you find yourself on another beach.  You lie down in the sand and stretch yourself out as those on the beach show interest in you.  You lift your head and open your jaws a moment, but your now unsure what you were trying to do and close them.  Then set your head back on the sand as the furred scaled and humans in the crowd continue to gawk at you.  Eventually officials show up and begin to persuade you into a large truck.  You see the letters on it and try piecing them together but no matter how much you try they just don[apostrophe]t seem to have meaning.  You only spend two days at your destination before your being passed to a wealthy looking man.  He takes you to his manor where he introduces you to your new home.  The next week you find yourself easily accepting the artificial beach as your home.  Once the week is up the man makes some noises that sound oddly familiar before another sea dragon is led into the enclosure.  Curious you begin to inspect the dragon and discover it[apostrophe]s a male!  You soon find yourself leading him around the enclosure.  Teasing him with glimpses of your cunt.  He makes sounds that you vaguely understand and you struggle to find words to respond 'Come. go. g-get some.'  You lower your chest to the ground and move your tail out of the way invitingly.  You growl as he takes his time to mount you.  He gets the message and forcefully drives his black cock into you.  You sing your pleasure as he roughly ruts you.  Your head lays on the sandy ground as the rough mating puts you in a pleasant haze.  It[apostrophe]s over quickly and something in your mind nags at you that it could have been better, but you just feel sated and collapse into the sand.  His cum leaking from your cunt into the sand.  He says something and walks off to the water as you begin thinking about how great it[apostrophe]ll be to have a clutch of eggs.";
				otherwise:
					say "You escape into the sea.  Cautiously following the coastline you swim for a few days.  Eventually you come across another beach.  You walk out of the sea onto the beach and look around.  Heading off to a nearby city.  You scare off almost everyone you come across.  Apparently it was going to be difficult to fit in. Eventually you find someone who isn[apostrophe]t scared of you and you ask him for help.  He agrees to house you and feed you as payment for a job.  You agree and it turns out he owns a hotel.  It isn[apostrophe]t enormous but big enough to afford the cost of feeding a dragoness.  As word spreads of the hotels new main attraction you discover a way to make tips.  You discovered it by overhearing a conversation of two patrons and decided to take up their idea.  So you grabbed one of them and took him to your private den near the lobby.  Dropping him on your bedding you turn around and lower yourself as you suggestively say 'I hear you[apostrophe]re interested in mating a dragoness.'  He doesn[apostrophe]t hesitate and begins to thrust his human penis into you.  At first it doesn[apostrophe]t seem to be worth it.  However soon his cock begins to grow.  Filling you much more snugly.  You smile as it turns into a worthy endeavor thanks to you still being a little infective.";


Feral Sea Dragon ends here.
