Version 1 of Hitching Post by SgtPepper234 begins here.
[ Verson 1 - New File]

Picnic Area is a room.
earea of Picnic Area is "Park".
The description of Picnic Area is "     The ground here is poured concrete over a 10 meter squared area. Broken benches and built in barbeques indicate that this was once a public picnic spot. Set into the ground nearby is a large set of reinforced prison stocks.".

Prison Stocks is an object. It is in the Picnic Area. It is fixed in place. Understand "stocks" as Prison Stocks.
the description of Prison Stocks is "This heavily reinforced structure is clearly intended to be used for entertainment purposes. You could [link]lock yourself in[as]use prison stocks[end link] if you want to be used like breeding stock.";

HitchInPrisonStock is an action applying to nothing.
understand "lock yourself in" and "use prison stocks" and "use stocks" and  "use prison" and  "use hitching post" and  "use post" and  "use hitching" as HitchInPrisonStock.

check HitchInPrisonStock:
	if the player is not in Picnic Area:
		say "What? There is nothing like that here.";
		stop the action;

carry out HitchInPrisonStock:
	say "     ([link]Y[as]y[end link]) - Lock yourself in the stocks at the mercy of the horny creatures that roam the park.";
	say "     ([link]N[as]n[end link]) - Suppress the urge to be used like breeding stock.";
	if player consents:
		let randomnumber be a random number from 1 to 4;
		if randomnumber is:
			-- 1:
				say "[Shemale Collie Event]";
			-- 2:
				say "[Behemoth Event]";
			-- 3:
				say "[Blue Gryphon Event]";
			-- 4:
				say "[Hyena Gang Event]";
	else:
		LineBreak;
		say "     You decide to leave the stocks and continue your journey. Let some other submissive breeder lock themselves in.";

Public Hitching Post is a situation.
The sarea of Public Hitching Post is "Park".

instead of resolving Public Hitching Post:
	say "     As you wander through the city's open park, you notice something that hadn't caught your eye before. A device set casually near a public rest area, that is quite clearly an old-timey set of prison stocks. There appears be a slam latch to secure the device shut around the prisoner's neck and wrists which fit snugly into the three holes set in the wooden device. The structure looks extremely sturdy, reinforced with thick iron bars and metal bands. A shiny set of solid manacles are set into the floor at ankle height. Or at least they would be shiny if they weren't spattered with sticky and dried white gunk that you can only assume is semen. Between the manacles and the stocks is a horizontal padded beam at hip height. Next to it, a sign stands erected bearing the words, 'Public Hitching Post'. You can only imagine what goes on at this place.";
	LineBreak;
	say "     As you inspect the device, you get the feeling that it is used more for fun than punishment. Despite its primitive appearance, a number of modern alterations seem to have been designed to make the device more user-friendly. A plaque on the sign beneath the words, 'Public Hitching Post', provides you with more information. It reads, 'WARNING! Utilising this device could be dangerous to your health. Device will reset and open automatically after one hour.'";
	say "     Someone would have to be crazy to willingly submit themselves to such treatment, but a stirring in your loins makes you pause. For a fleeting moment the thought of being at the mercy of the monsters roaming the city makes your crotch tingle in anticipation. ";
	LineBreak;
	say "     [bold type]Could you willingly lock yourself into this device and let any passing creature do with you as they please?[roman type][line break]";
	LineBreak;
	say "     ([link]Y[as]y[end link]) - Lock yourself in the stocks at the mercy of the horny creatures that roam the park.";
	say "     ([link]N[as]n[end link]) - Suppress the urge to be used like breeding stock.";
	if player consents:
		LineBreak;
		let randomnumber be a random number from 1 to 4;
		if randomnumber is:
			-- 1:
				say "[Shemale Collie Event]";
			-- 2:
				say "[Behemoth Event]";
			-- 3:
				say "[Blue Gryphon Event]";
			-- 4:
				say "[Hyena Gang Event]";
	else:
		LineBreak;
		say "     You decide to leave the stocks and continue your journey. Let some other submissive breeder lock themselves in.";
	say "     Leaving the picnic area, you make your way through the underbrush in a direction that seems promising - surprisingly, you stumble upon the main park trail within barely a minute or three. So you've been this close to the park entrance all along? Good to know, if you want to return to the picnic area sometime. You make a note of the fact that it lies [bold type]Northeast[roman type] of the park trail, just a short distance through the overgrown wood.";
	change the northeast exit of Park Trail to Picnic Area; [connecting the location to the other room]
	change the southwest exit of Picnic Area to Park Trail;
	now Public Hitching Post is resolved;

to say Hitching Scene Start:
	say "     Removing all garments, you place your feet in the spaces indicated in front of the manacles about a shoulder length apart. Bending over the padded beam you are grateful for the soft, if slightly damp wool cushioning your pelvis, and you rest your head and wrists in the spaces provided. You watch as the wooden block descends automatically to close tightly around your neck and wrists. There is an ominous 'click' as the device locks and you feel the manacles snap shut around your ankles. Completely immobilized, you feel incredibly exposed with your ass raised just slightly above head height thanks to the beam at your waist.";

to say Shemale Collie Event:
	setmonster "Shemale Smooth Collie";
	say "[Hitching Scene Start]";
	say "     After about ten minutes of waiting in the stocks your muscles are getting stiff, and you start to second-guess your decision. However, your thoughts are soon interrupted by the sound of paws scratching over cement – from somewhere behind you. The noise slows down as the scrabbling draws nearer and you hear a feminine snigger. You can't turn around to see what beast has approached you, but fortunately there is no need as a shemale smooth collie comes around the front to leer at you. 'Aren't you just a dear, putting yourself on offer like this, and me thinking it's been far too long since I mounted a bitch!' The doggy anthro's voice has an animalistic growl to it as she sizes you up.";
	if player is female: [female + herm]
		say "     You can see the herm's doggie pecker slipping from its sheath - dripping, pink and covered in angry looking purple veins. Your eyes widen at the sight of the massive dog-cock, extending in arousal. It looks at least eight inches long, and it's positively spraying pre over the ground in front of your face. A quick breath is all it takes to be aroused by her hot musk. Your pussy practically creams in anticipation and excitement. Grabbing the thick doggie cock in both her hands, the anthro shoves it towards your lips. 'Lick', she barks commandingly, grinning down at you. Obediently you moisten your lips and swirl your eager tongue around the monster dong's leaking tip, swallowing the spurts of pre as they spray intermittently into your mouth and all over your face. She pants with pleasure, and the doggie cock hardens into your welcoming mouth. Your eyes gape as you see another few inches slide from the musky sheath to reveal a tennis-ball sized knot. The canine's shaft must be a foot long, now that it is fully erect.";
		WaitLineBreak;
		say "     Eagerly sucking at the hot shaft in your maw, you find swallowing is becoming more difficult as the pre spurts become bigger and more frequent. The collie's cock is glistening and wet covered in your slobber her leaking precum. The lusty dog's pointed tip slips easily to the back of your throat, and you gag a little as a glut of clear liquid pre squirts down into your belly. The furry hips of the opportunistic anthro pound against your face with each deep thrust into your throat, and you can feel a familiar tensing that indicates she is getting closer to cumming. The panting collie suddenly stops and pulls out of your gullet, smiling down at you as her rock hard pecker continues to squirt ropes of pre that baste your face and soak into your hair. 'Wouldn't want to finish in your throat now would I?' She says with a lecherous grin, 'You might drown.' With a malicious wink, she walks around to where your eager cunt rests winking and waiting.";
		say "     Your whole body trembles in anticipation of the massive pulsing member, and you hear the herm move to stand between your spread legs. The eager dog-anthro places her iron rod in between the cheeks of your pack passage, and begins to hot-dog the thick pointed dick along your eager crevice. Your body betrays your eagerness to get fucked, as you moan and attempt to grind back into the firm monster. Unfortunately your manacled body prevents you from taking the prick inside you. The lecherous herm gives a bark-like laugh at your eagerness, before lining up with your winking cunt-lips and driving her bestial cock deep inside you.";
		WaitLineBreak;
		say "     The thickness and length of the hot puppy-pecker in your tight vaginal canal has you groaning in delight as the herm pulls back, only drive the rest of the turgid pole back into your waiting body. Now that the full length of the collie's foot-long cock sits embedded inside you, the only thing that remains is the knot. With a shudder of pleasure, you can only imagine how much that knot may grow once tied with your tight hole. The horny herm pants as she begins to fuck you more forcefully, shoving the veiny cock in deep, and teasing and pulling at every inch of your pleasure-receptive walls. Your pussy squelches and squirts liberal amounts of fem-cum around the pounding member.";
		say "     The smooth collie has started to make yipping noises with every thrust into your throbbing hole as the fucking becomes more intense. Your body is shaking in pleasure and anticipation of what is sure to be a powerful orgasm. The herm keeps hammering the knot at your stretched labia, demanding entrance as she nears climax. Finally with a powerful thrust she forces the bitch-breaker past your barrier and into your gaping cunt. With an elated cry you feel your entrance seal tightly around the rapidly ballooning fuck-lock.";
		WaitLineBreak;
		say "     The tennis ball sized knot rapidly grows to the size of a large grapefruit as the insatiable herm howls in pleasure. The monster cock pulses inside you and swells as a torrent of seed is unleashed from her rapidly shrinking balls. The herm's hips are still on autopilot as they attempt to imbed the grapefruit-sized knot deeper into your pussy. The intensity of the coupling is too much for your helpless body to stand, and soon your own powerful orgasm takes you. Your pussy clenches eagerly around the knot tied inside you as you spasm and squirt clear and copious amounts of fem-cum down your thighs and on the ground. The knot embedded in your cunt is held ever more tightly by your clasping vaginal ring, causing the herm's powerful semen to surge deep into your cervix and bath your fallopian tubes in her animalistic lust. A deeper animalistic lust causes you to shudder at the thought of this beast getting you pregnant.";
		say "     When the collie finally stops humping you, your abdomen has a pronounced bulge as a result of all the cum packed deep inside your womb. A warm weight sits in your lower torso that fills you with pleasure at the thought of the lusty collie's hot baby batter inseminating your fertile eggs. Her panting slows down to regular breathing. You can feel the knot-tied cock occasionally twitch as another glut of semen spurts inside you, stretching you just a little more. By the time the anthro dog's massive knot deflates enough to slip from your stretched orifice, the stocks have already been unlocked for almost a quarter hour, while the collie licked your back and face in an affectionate, almost thankful manner.";
		WaitLineBreak;
		say "     She slides the softening length of dog-cock from your abused hole with a slurp, followed by only a trickle of semen. The rest of it must be firmly inside you by now. 'Thanks bitch!' She barks, and with a slap of your ass, runs off to find some other unsuspecting victim to breed.[fimpregchance]";
	else:
		say "     You can see the herm's doggie pecker slipping from its sheath - dripping, pink and covered in angry looking purple veins. Your eyes widen at the sight of the massive dog-cock, extending in arousal. It looks at least 8 inches long, and is positively spraying pre over the ground in front of your face. A quick breath is all it takes to be aroused by her hot musk. Your cock hardens in anticipation and excitement. Grabbing the thick doggie cock in both her hands, the anthro shoves it towards your lips. 'Lick', she barks commandingly, grinning down at you. Obediently you moisten your lips and swirl your eager tongue around the monster dong's leaking tip, swallowing the spurts of pre as they spray intermittently into your mouth and all over your face. She pants with pleasure, and the doggie cock hardens into your welcoming mouth. Your eyes gape as you see another few inches slide from the musky sheath to reveal a tennis-ball sized knot. The canine's shaft must be a foot long, now that it is fully erect.";
		WaitLineBreak;
		say "     Eagerly sucking at the hot shaft in your maw, you find swallowing is becoming more difficult as the pre spurts become bigger and more frequent. The collie's cock is glistening and wet covered in your slobber her leaking precum. The lusty dog's pointed tip slips easily to the back of your throat, and you gag a little as a glut of clear liquid pre squirts down into your belly. The furry hips of the opportunistic anthro pound against your face with each deep thrust into your throat, and you can feel a familiar tensing that indicates she is getting closer to cumming. The panting collie suddenly stops and pulls out of your gullet, smiling down at you as her rock hard pecker continues to squirt ropes of pre that baste your face and soak into your hair. 'Wouldn't want to finish in your throat now would I?' She says with a lecherous grin, 'You might drown.' With a malicious wink, she walks around to where your back passage rests winking and waiting.";
		say "     Your whole body trembles in anticipation of the massive pulsing member, and you hear the herm move to stand between your spread legs. The eager dog-anthro places her iron rod in between the cheeks of your pack passage, and begins to hot-dog the thick pointed dick along your eager crevice. Your body betrays your eagerness to get fucked, as you moan and attempt to grind back into the firm monster. Unfortunately your manacled body prevents you from taking the prick inside you. The lecherous herm gives a bark-like laugh at your eagerness, before lining up with your puckered sphincter and driving her bestial cock deep inside you.";
		WaitLineBreak;
		say "     The thickness and length of the hot puppy-pecker in your gripping passage has you groaning in delight as the herm pulls back, only drive the rest of the turgid pole back into your waiting body. Now that the full length of the collie's foot-long cock sits embedded inside you, the only thing that remains is the knot. With a shudder of pleasure, you can only imagine how much that knot may grow once tied with your tight hole. The horny herm pants as she begins to fuck you more forcefully, shoving the veiny cock in deep, and teasing and pulling at every inch of your pleasure-receptive walls. Your cock drips with copious amounts of pre.";
		say "     The smooth collie has started to make yipping noises with every thrust into your throbbing hole as the fucking becomes more intense. Your body is shaking in pleasure and anticipation of what is sure to be a powerful orgasm. The herm keeps hammering the knot at your back door, demanding entrance as she nears climax. Finally with a powerful thrust she forces the bitch-breaker past your barrier and into your gaping ass. With an elated cry you feel your entrance seal tightly around the rapidly ballooning fuck-lock.";
		WaitLineBreak;
		say "     The tennis ball sized knot rapidly grows to the size of a large grapefruit as the insatiable herm howls in pleasure. The monster cock pulses inside you and swells as a torrent of seed is unleashed from her rapidly shrinking balls. The herm's hips are still on autopilot as they attempt to imbed the grapefruit-sized knot deeper into your ass. The intensity of the coupling is too much for your helpless body to stand, and soon your own powerful orgasm takes you. [if cocks of player > 0]As your cock squirts rope after rope of semen against the bench and onto the ground[else]As your body shudders and shakes in climactic release[end if], you feel your ass clenching around the base of the massive knot tied in your rear, aiding it in delivering an enormous payload of semen straight into your bowels. You feel the cum surge deep into your body, and are further aroused by the familiar sensation of warmth as it spreads into your belly.";
		say "     When the collie finally stops humping you, your belly has a pronounced bulge as a result of all the cum packed deep inside you. A warm weight sits in your lower abdomen that fills you with pleasure at the thought of the lusty collie's hot baby batter being absorbed into your willing body. Her panting slows down to regular breathing. You can feel the knot-tied cock occasionally twitch as another glut of semen spurts inside you, stretching you just a little more. By the time the anthro dog's massive knot deflates enough to slip from your stretched orifice, the stocks have already been unlocked for almost a quarter hour, while the collie licked your back and face in an affectionate, almost thankful manner.";
		WaitLineBreak;
		say "     She slides the softening length of dog-cock from your abused hole with a slurp, followed closely by only a trickle of semen. The rest of it must be firmly inside you by now. 'Thanks bitch!' She barks, and with a slap of your ass, runs off to find some other unsuspecting victim to breed.[mimpregchance]";

to say Blue Gryphon Event:
	setmonster "Hermaphrodite Gryphon";
	say "[Hitching Scene Start]";
	say "     You are not kept waiting long before you hear a screech overhead. Unable to look up from your prone position, you can only assume it is coming from a blue gryphon or a hawkman. A clatter of talons on the concrete somewhere behind you lets you know that the beast has landed. There is a short silence but your partner-to-be soon moves up front to greet you. A tall, virile looking blue gryphon stands before you. Her black knotted cock is already growing hard and dripping with pre. Licking your lips in eagerness you smile up at the bird herm. Grinning back the blue gryphon says, 'Hey there good looking, you eager for a good hard fucking hmmm?' Blushing somewhat at your obvious sluttery (having just incapacitated yourself for the pleasure of others), you nod at the lusty gryphoness.";
	if player is female: [female + herm]
		say "     The horny herm bends down to your face, and flicks a slippery tongue into your mouth to kiss you. Your tongues dart in and out of each other's mouths before the blue bird of sexiness pulls back and grips the steaming rod between her thighs. Holding it just out of reach of your tongue, the lecherous beast coyly asks, 'So you won't mind if my friend and I make use of you then?' There is a moment of pause as she takes your head in her clawed hands. 'Friend?' Your brain asks you before another set of clawed hands grip your backside, and you feel the familiar heat of a hot moist cock line up with your gaping cunt. Just before you can cry out in protest, both gryphons shove their large black cocks into your holes! Your muffled yell is silenced by the thick piston that plows into the back of your throat. The gryphon behind you doesn't bother to take it easy either, instead forcing the full length of her rigid hot tool deep into your spasming pussy. The walls of you velvety vagina squeeze tightly around the large intruder, failing to keep it from pressing deep into your wanton hole.";
		WaitLineBreak;
		say "     Your entire body shakes and tenses against the forceful intrusions, but your bindings make it impossible to move even an inch. The amorous herms hold their throbbing bestial dicks deep inside, forcing you to become accustomed to their more-than-generous sizes. The cock in your throat is blocking your windpipe, while your nose is pressed into her furry pelvis causing you to lose oxygen as you struggle harder. With the blackness creeping in at the edges of your vision, your arms and legs lose strength, and you slump limply into the bindings. Immediately the thick dong in your gullet is withdrawn and you gratefully inhale deep lungfulls of air. 'Now that you're a little more relaxed cutie, we can enjoy some fun!' You hear from the gryphoness above you.";
		say "     Slowly and more gently this time, the amorous avian slides her long black pecker back into your mouth. This time you have a moment to enjoy the salty taste of her pre spilling onto your tongue and lubricating your oral passage. Seeing that you've relaxed, the herm behind you slowly drags her thick rod from your cock hoster, leaving an empty feeling in its wake. This is quickly filled as the she hammers herself back in to the knot which presses insistently at your taught labia. The eager gryphoness keeps a solid pace as she fucks you, rubbing all the right spots with each deep pounding, and causing you to release a deep groan of satisfaction around the cock in your gullet.";
		WaitLineBreak;
		say "     The horny blue gryphon in your mouth starts to thrust more insistently into your throat slick pre mixes with your saliva to create a lubricated passageway for her pleasure. The thick ebony cock digs deeper into your face with each forward thrust, burying itself further and further into your gullet while her knot parts your aching jaw wider than is comfortable. Your body has accepted the two virile beasts with an eagerness that makes you blush, and the avian herms are enjoying every second of it. Every thrust comes faster on the heels of the last. There is a potent musk coming from the herm in your mouth, rising hotly from what must be a sweltering pussy. Both rigid herm-dicks are pushing themselves inside you with a fierce intensity and you know they must be getting close.";
		say "     The fat cock in your slick cunt hammers hard, attempting to bury its knot into your wanton hole. Every forceful thrust pushes it just a little further into your gradually relenting vaginal opening. Each moan encourages the cock in your mouth, causing your oral mate to attempt to knot with your face. Your eyes bulge as you jaw stretches painfully, but thankfully the lusty beast can't quite force her wide base into your mouth. With one last fierce thrust, the thick knot behind you gapes your ring and pops inside you tight cunt. With your pussy now spasming tightly around the base, the grateful gryphon has buried the full length of her fat monster cock into your squelching sheath. The ecstatic blue avian releases an ear splitting cry as she begins to cum powerfully inside you, bathing your fertile eggs in cum. The intensity of the penetration is too much for your helpless body to take, and you too begin to cum with intensity. Your lower half is soaked, and you groan at the feeling of your liquid lust squirting powerfully against the crossbar to splash back at your pelvis.";
		WaitLineBreak;
		say "     Your own orgasmic exultations stimulate the cock in your face, and with a frustrated cry of ecstasy the wild herm pushes herself as deep as she is able and cums straight into your waiting stomach. She holds your lips taught against her bulging knot, shuddering and thrusting throughout her orgasm. The gryphoness behind you is still shooting thick ropes of cum deep into your womb as your writhing cunt milks her for more semen. She strokes your back with surprisingly gentle hands to show her appreciation for your willingness as a breeder slut. Your stomach has begun to round out from all the cum being packed into your body, and you groan in pleasure to think of all the semen pooling in your belly.";
		say "     When the softening cock is finally pulled from your mouth, your stomach feels bloated and your lower abdomen heavy. The gryphoness leans down to kiss you once more, tasting the hot cum still in your mouth with her slippery tongue. With one final peck she stretches her wings and flies off, leaving you knotted on the cock still lodged firmly in your vagina. The break in the intensity of the fucking allows you to truly enjoy the fullness provided by the thick rod inside you. You clench your opening tightly around the base of the cock, enjoying another little spurt from the already-drained balls of your partner. The gryphoness responds with a grateful cooing as her knot slowly deflates enough to slip from your abused vaginal cavity. This is followed closely by a mess of cum that pours down your thighs. Just as she flies off there is a click in the stocks and you are freed once more. Gathering your gear you pause to take one more glance at the stocks. Although you know it isn't possible to be trapped there, the thought of being a permanent fixture of the post sends a tingle down your spine.[fimpregchance]";
	else:
		say "     The horny herm bends down to your face, and flicks a slippery tongue into your mouth to kiss you. Your tongues dart in and out of each other's mouths before the blue bird of sexiness pulls back and grips the steaming rod between her thighs. Holding it just out of reach of your tongue, the lecherous beast coyly asks, 'So you won't mind if my friend and I make use of you then?' There is a moment of pause as she takes your head in her clawed hands. 'Friend?' Your brain asks you before another set of clawed hands grip your backside, and you feel the familiar heat of a hot moist cock line up with your puckered asshole. Just before you can cry out in protest, both gryphons shove their large black cocks into your holes! Your muffled yell is silenced by the thick piston that plows into the back of your throat. The gryphon behind you doesn't bother to take it easy either, instead forcing the full length of her rigid hot tool deep into your spasming asshole.";
		WaitLineBreak;
		say "     Your entire body shakes and tenses against the forceful intrusions, but your bindings make it impossible to move even an inch. The amorous herms hold their throbbing bestial dicks deep inside, forcing you to become accustomed to their more-than-generous sizes. The cock in your throat is blocking your windpipe, while your nose is pressed into her furry pelvis causing you to lose oxygen as you struggle harder. With the blackness creeping in at the edges of your vision, your arms and legs lose strength, and you slump limply into the bindings. Immediately the thick dong in your gullet is withdrawn and you gratefully inhale deep lungfulls of air. 'Now that you're a little more relaxed cutie, we can enjoy some fun!' You hear from the gryphoness above you.";
		say "     Slowly and more gently this time, the amorous avian slides her long black pecker back into your mouth. This time you have a moment to enjoy the salty taste of her pre spilling onto your tongue and lubricating your oral passage. Seeing that you've relaxed, the herm behind you slowly drags her thick rod from your asshole, leaving an empty feeling in its wake. This is quickly filled as she hammers herself back in to the knot which presses insistently at your outer sphincter. The eager gryphoness keeps a solid pace as she fucks you, rubbing all the right spots with each deep pounding, and causing you to release a deep groan of satisfaction around the cock in your gullet.";
		WaitLineBreak;
		say "     The horny blue gryphon in your mouth starts to thrust more insistently into your throat as her slick pre mixes with your saliva to create a lubricated passageway for her pleasure. The thick ebony cock digs deeper into your face with each forward thrust, burying itself further and further into your gullet while her knot parts your aching jaw wider than is comfortable. Your body has accepted the two virile beasts with an eagerness that makes you blush, and the avian herms are enjoying every second of it. Every thrust comes faster on the heels of the last. There is a potent musk coming from the herm in your mouth, rising hotly from what must be a sweltering pussy. Both rigid herm-dicks are pushing themselves inside you with a fierce intensity and you know they must be getting close.";
		say "     The fat cock at your asshole hammers hard, attempting to bury its knot into your wanton hole. Every forceful thrust pushes it just a little further into your gradually relenting sphincter. Each moan encourages the cock in your mouth, causing your oral mate to attempt to knot with your face. Your eyes bulge as you jaw stretches painfully, but thankfully the lusty beast can't quite force her wide base into your mouth. With one last fierce thrust, the thick knot behind you gapes your anal ring and pops inside. With your sphincter now clenched tightly around the base, the grateful gryphon has buried the full length of her fat monster cock into your spasming asshole. The ecstatic blue avian releases an ear splitting cry as she begins to cum powerfully inside your knotted rectum. The intensity of the penetration is too much for your helpless body to take, and you too begin to orgasm with intensity. Your lower half is soaked, and you groan at the feeling of the liquid lust pouring down your thighs.";
		WaitLineBreak;
		say "     Your own orgasmic exultations stimulate the cock in your face, and with a frustrated cry of ecstasy the wild herm pushes herself as deep as she is able and cums straight into your waiting stomach. She holds your lips taught against her bulging knot, shuddering and thrusting throughout her orgasm. The gryphoness behind you is still shooting thick ropes of cum deep into your colon as your rippling rectum milks her for more semen. She strokes your back with surprisingly gentle hands to show her appreciation for your willingness as a breeder slut. Your stomach has begun to round out from all the cum being packed into your body, and you groan in pleasure to think of the semen from both herms pooling in your belly.";
		say "     When the softening cock is finally pulled from your mouth, your stomach feels bloated and taught. You can't imagine you'll need to worry about eating for a while. The gryphoness leans down to kiss you once more, tasting the hot cum still in your mouth with her slippery tongue. With one final peck she stretches her wings and flies off, leaving you knotted on the cock still lodged firmly in your ass. The break in the intensity of the fucking allows you to truly enjoy the fullness provided by the thick rod inside you as well as the belly-full of semen. You clench your sphincter tightly around the base of the cock, enjoying another little spurt from the already-drained balls of your partner. The gryphoness responds with a grateful cooing as her knot slowly deflates enough to slip from your abused anal cavity. This is followed closely by a mess of cum that pours down your thighs. Just as she flies off there is a click in the stocks and you are freed once more. You stand gingerly, cradling your bloated stomach as a semen-flavored burp escapes your mouth. Gathering your gear you pause to take one more glance at the stocks. Although you know it isn't possible to be trapped there, the thought of being a permanent fixture of the post sends a tingle down your spine.[mimpregchance]";
		PlayerEat 10;

to say Behemoth Event:
	setmonster "Behemoth";
	say "[Hitching Scene Start]";
	say "     Looking straight ahead of you, a small speck on the horizon quickly becomes recognisable as a behemoth heading towards you. Your heart begins to hammer in your chest, as you are unsure what a creature that size will do to your vulnerable body. Your question is soon to be answered however as the beast is upon you in a matter of minutes. The hulking brute stands panting over you but you are unable to crane your neck upwards to see what it has planned. The heavy musk from its sweaty balls, and the sheer arousal from its musty cunt hang warmly over your naked body. A smack of warm sex fluid splats heavily onto your head, soaking your hair and filling your nostrils with the potent odour of beastly sex as the liquid slides slickly down the sides of your face.";
	WaitLineBreak;
	say "     The behemoth's monstrous calves are either side of your head just about a meter in front of you, but it is too tall to make out what it is doing. A squelching noise makes you think it must be rubbing its massive front paw into a sweltering pussy. Large globs of steaming juices splat down on the ground in front of you and another glut of fluid, that you believe must be precum, splashes warmly over your back soaking you entirely. [if player is male]Your cock is hard and dripping pre[else if player is female]Your cunt is practically gushing[else]Your crotch sends pleasurable tingles through your pelvis[end if] from the sheer arousal caused by the fluids coating your body. The huge creature has begun to make inhuman grunts and growls as it pleasures itself above you. You can see the massive spiked tail, swishing back and forth and it's legs move in a more agitated fashion as it eagerly pleasures itself in pursuit of release.";
	say "     With a creaking noise as that of a trees bending in the wind, the behemoth bends it's legs to bring it to its knees before you. The monstrous cock of this terrifyingly powerful giant now stares you right in the face. Your heart pummels wildly in your chest at the sight of the mammoth member before you. Nearly six feet in length and one foot across, its pre-spurting urethra alone is just wider than your mouth. The hulking creature continues to rub at its cunt just behind its ball sack, causing the huge black cock-head to jerk and slap against the ground sending swathes of pre everywhere, drenching you even further in salty cock slime.";
	WaitLineBreak;
	say "     The colossal herm's erratic movements send the cock slapping painfully into your face, forcing a visible shudder of pleasure down the creatures member. It begins to hump the beastly black rod towards your face as your eyes widen with trepidation at the creatures urgent thrusting. With minimal movement you are unable to move your head out of the way as the winking urethra presses firmly against your face, slipping over your forehead and pressing your head back against the board of your stocks. A surge of pre spurts up over your head as the behemoth pushes urgently against you in an attempt to stimulate its pleasure centre. You take in a huge lungful of air as you feel the opening of the tight urethra stretch wider with the lubrication provided by all the precum.";
	say "     Lucky that you did, as the monster takes this opportunity to press forward, spreading the tight urethra open over your face to engulf your whole head as it begins to shake in orgasm. The stocks groan and creak under the pressure but hold firm thanks to its tough iron reinforcements. Outside the sound-dulled walls of the cock head, your hear the brute roar in pleasure and your heart hammers in terror as you know what is to come, literally. In the darkness of the behemoths tight urethral walls, all you feel is the forceful splat of hot cum hitting your face. Your eyes are closed tight as is your mouth, but the pressure behind the fist surge of semen hikes further as the beast grinds forcefully against your trapped head.";
	WaitLineBreak;
	say "     Suddenly the highly pressurized fluid forces its way into your nasal passage and down your throat. Unable to hold back your gag reflex you open your mouth to cough, only to provide the sealed member with a wider sluice for the cum to gush into. The beastly cum-fountain stretches your jaw wide and surges into your lungs and belly! The only thing you can think of is air as the pressure forces more and more of the monstrous load into your helpless form. Your stomach bulges painfully and your lungs scream for oxygen. Just as you feel you might explode from the pressure, the gargantuan herm collapses, slipping the still spurting meat rod off your head.";
	say "     Behemoth cum streams from your open mouth in a cascade of white. Your body heaves as you attempt to free your sponge-like lungs of the cum basting they have just received. Eventually, thankfully, you are able to draw in breath once more. Your body shakes and heaves as lungfuls of air provide your brain with its much needed oxygen. Your stomach is bloated and hanging heavily beneath you, and the whole picnic area has been painted white by the behemoths mighty issue. Panting, the brute lumbers off in search of some other poor soul to destroy. You realize the whole ordeal lasted only about half an hour, and you are forced to hang limply in your bonds until the stocks release you. Thankfully no other creatures disturb your waiting. You practically collapse out of the stocks, lying naked in the gradually cooling soupy baby-batter as the nanites absorb the sheer volume of semen you were forced to ingest. Eventually you redress and get on your way, thankful to have come out of that harrowing ordeal relatively unscathed.";
	PlayerEat 10;

to say Hyena Gang Event:
	setmonster "Herm Hyena";
	say "[Hitching Scene Start]";
	say "     You haven't been waiting long when your ears pick up a faint rumble in the distance, growing steadily louder. It doesn't take you very long to realize the rumble is unmistakably that of a motorcycle. Or more precisely, multiple motorcycles! As the rumbling slowly becomes a thunder, you are also able to pick up a cackling laughter and you realize you are about to be beset by a gang of hyenas. You shake in your stocks in anticipation of what is to come. Hyenas are not known for their gentle treatment of those that so willingly submit to be used. It is going to be a rough hour.";
	WaitLineBreak;
	say "     Sure enough you are immediately surrounded by motorcycle riding hyenas, making you dizzy as they drive circles around your vulnerable, trapped body. You can't exactly count them but there are at least four gang members about to have their way with you. They eventually stop circling their prey and park off to the side as the dust swirls around you. Three of them approach you through the haze directly, but more cackle behind you out of sight. The leader of the group approaches you directly and pulls your chin up to look her in the eye, which is still difficult considering how tall she is. She wears a bikers' leather jacket, open at the front to reveal her massive jugs, and a pair of crotchless leather chaps through which her wide looking sheath protrudes. The other herms are dressed similarly, but this one is more heavily decorated.";
	say "     'Well well well, what have we here?' she snickers. 'Another submissive slut trussed up and ready to be fucked!' The other hyenas cackle loudly all around you. In front of you the three herms['] sheaths have begun to distend as their dripping red hyena cocks slip free. Sweat covers your brow as your realize you are in for a good hard dicking. The leader of the gang points her hardening ramrod at your face, the slippery herm cock now fully erect and beginning to drip with clear precum. 'Open up beta bitch,' she snarls and you open your mouth wide in readiness to accept the dominant bitch's musky smelling hyena cock.";
	WaitLineBreak;
	if player is female: [female + herm]
		say "     The hot herm's slick tip penetrates your maw and your taste buds are inundated with her powerful salty flavor, and her juicy pre fills your eager mouth. The other two bikers sidle up either side of you, stroking their stiff cocks and spraying small spurts of pre at your face to coat your skin with their slick lust juices. A heavy weight falls between the crack of your ass cheeks, sliding down past your taint and catching at the ring of your eager vaginal canal. At the same time you feel another herm cock slapping against your pliant butt. So five bikers then. This is going to be fun. Your heart is pounding in your chest as both dominant creature press forward unrelentingly at the same time. Both cocks are thick, stiff, and hot as they claim you from both ends.";
		say "     You groan around the pre-spraying member in your mouth as it pushes to the back of your throat, running your tongue along the underside of the dominant herm's delicious cock to stimulate her as best you can. You can feel a slickness permeate your welcoming cunt as the thick rod practically gushes pre into you. The sensation causes your opening to give an involuntary squeeze around the stiff shaft inside you, which illicits a high pitched cackle of satisfaction from your tail gunner. Both powerful alphas start moving at the same time, having just allowed you a few seconds to become accustomed to their girth. They saw their thick members in and out of you at a steady pace as the other three horny bitches jack their red peckers off at you or slap your exposed body to place wet splats of precum on your reddening flesh.";
		WaitLineBreak;
		say "     The whole situation has you intensely aroused. Your cock-holster is slowly becoming used to the thick hyena dong forcing its way deep into your cervix, while your jaw aches from the cock attempting to pry its way into your stomach! Your lips have begun to stretch painfully every time the herm tries to bottom out in your throat, due to the thickening knot demanding entry into your mouth. Your cockpit is dealing with much the same, your pliant ring gradually permitting a little more with each forceful thrust into you.";
		say "     The hyena to the left of your face has started to shake and cackle with pleasure, clearly reaching the peak as the premature herm cries out in orgasmic bliss. The lusty beast aims the pointed red pecker straight at your face as a torrential spray of semen gushes towards you. You close your eyes just before the salty deluge covers your face, but you are unable to stop the stream from going up your nose and into your mouth between alternating thrusts from the matriarch in your maw. The torrent of jizz can only be described as delicious, but the salty treat is slick too, providing just enough lubrication for the powerful bitch at your face to thrust the thankfully manageable knot into your mouth while you are distracted. You yell out in surprise as the invader is trapped behind your teeth, providing the furry gang leader with even more stimulation and encouraging her knot to swell up and lock with your face.";
		WaitLineBreak;
		say "     The distraction at your face provides the hyena behind you with her own opportunity to thrust the full might of the large slick tool into your thoroughly stretched minge as she too cums powerfully. The pain of being stretched so wide is only fleeting, and is soon replaced by an intense feeling of pleasure as the bitch breaker balloons inside you. You body is wracked by the most deliciously full sensation as she throbs deep inside you and you are unable to control your own orgasm. Your soaked muff squirts its liquid lust down your thighs, orgasmic contractions only intensifying the shuddering herms passionate orgasm, encouraging the lusty creature to pump more and more of her seed into you.";
		if anallevel is 3:
			say "     With the large hyena knotted with your spasming cunt, you barely notice her pull back slightly as the other hyena throws a leg over your back, and lines her cock up with your twitching asshole. Your eyes shoot wide open as she forces the thick member through your ring and into your aching anal cavity. The feeling of that second hyena cock claiming your unsuspecting asshole causes you to scream around the cock in your mouth as a second orgasm racks your body and scatters all thoughts from your mind. The surprise herm shoves her cock in and out of your sphincter, causing the most fantastic sensations as it rubs forcefully against the knot in your already stretched canal. Thankfully she doesn't last long either, nor does she attempt to knot you as that would likely split you in half. With an exultant cackle she unloads in your asshole, filling your colon with hot seed before collapsing on your arched back.";
			WaitLineBreak;
			say "     At your face the gang leader is gripping your hair and has your face pressed tight against her pelvis as she too unloads in your gullet. You are both saddened and aroused by the fact that the delicious cock is so deep you can't even taste the eruption of ejaculate. Instead it pours straight into your hungry belly. The remaining gang member at your face cums at the sight of your dominated and used body, choosing to spend her warm seed all over your hair and face. You relish the feeling of the hot ropes of semen that cover your beta bitch body, soaking you in powerful alpha cum as you bask in the afterglow of your orgasmic high. As the endorphin release subsides, you become more aware of your aching jaw, pussy and rectum. However you can do nothing but wait for the swollen knots to deflate and eventually pull free.";
			say "     By the time the herms pop out of your well used holes the stocks have already opened. Cum leeks from your abused orifices and your muff seems unable to stem the tide after it's thorough reaming. You swallow the residual semen in your mouth, relishing the salty flavor as the gang cackles at your beta behaviour. Some them suggest putting you back in the stocks and taking you for another ride, but thankfully the leader keeps them in line. They jump back on their road hogs and ride off to find some other victim to terrorise. Sticky, sore and thoroughly fucked, you gather your belongings and head on your way.[fimpregchance]";
		else:
			say "     At your face the gang leader is gripping your hair and has your face pressed tight against her pelvis as she too unloads in your gullet. You are both saddened and aroused by the fact that the delicious cock is so deep you can't even taste the eruption of ejaculate. Instead it pours straight into your hungry belly. The remaining gang members at your face and back cum at the sight of your dominated and used body, choosing to spend their seed all over you. You relish the feeling of the hot ropes of semen that cover your beta bitch body, soaking you in powerful alpha cum as you bask in the afterglow of your orgasmic high. As the endorphin release subsides, you become more aware of your aching jaw and rectum. However you can do nothing but wait for the swollen knots to deflate and eventually pull free.";
			WaitLineBreak;
			say "     By the time the herms pop out of your well used holes the stocks have already opened. Cum leeks from your abused orifices and your ass seems unable to stem the tide after it's thorough reaming. You swallow the residual semen in your mouth, relishing the salty flavor as the gang cackles at your beta behaviour. Some them suggest putting you back in the stocks and taking you for another ride, but thankfully the leader keeps them in line. They jump back on their road hogs and ride off to find some other victim to terrorise. Sticky, sore and thoroughly fucked, you gather your belongings and head on your way.[fimpregchance]";
	else:
		say "     The hot herm's slick tip penetrates your maw and your taste buds are inundated with her powerful salty flavor, and her juicy pre fills your eager mouth. The other two bikers sidle up either side of you, stroking their stiff cocks and spraying small spurts of pre at your face to coat your skin with their slick lust juices. A heavy weight falls between the crack of your ass cheeks, sliding down between your buns and catching at the ring of your eager anus. At the same time you feel another herm cock slapping against your pliant butt. So five bikers then. This is going to be fun. Your heart is pounding in your chest as both dominant creature press forward unrelentingly at the same time. Both cocks are thick, stiff, and hot as they claim you from both ends.";
		say "     You groan around the pre-spraying member in your mouth as it pushes to the back of your throat, running your tongue along the underside of the dominant herm's delicious cock to stimulate her as best you can. You can feel a slickness permeate your colon as the thick rod in your rear practically gushes pre into you. The sensation causes your sphincter to give an involuntary squeeze around the stiff shaft inside you, which illicits a high pitched cackle of satisfaction from your tail gunner. Both powerful alphas start moving at the same time, having just allowed you a few seconds to become accustomed to their girth. They saw their thick members in and out of you at a steady pace as the other three horny bitches jack their red peckers off at you or slap your exposed body to place wet splats of precum on your reddening flesh.";
		WaitLineBreak;
		say "     The whole situation has you intensely aroused. [if cocks of player > 0]Your own cock feels painfully under stimulated, rock hard and completely ignored between your legs[else]Your sexless crotch tingles in arousal as it rubs sensually against the wool covered post[end if]. Your asshole is slowly becoming used to the thick hyena dong forcing its way deep into your guts, while your jaw aches from the cock attempting to pry its way into your stomach! Your lips have begun to stretch painfully every time the herm tries to bottom out in your throat, due to the thickening knot demanding entry into your mouth. Your asshole is dealing with much the same, your rectal ring gradually permitting a little more with each forceful thrust into your eager cock-holster.";
		say "     The hyena to the left of your face has started to shake and cackle with pleasure, clearly reaching her peak as the premature herm cries out in orgasmic bliss. The lusty beast aims the pointed red pecker straight at your face as a torrential spray of semen gushes towards you. You close your eyes just before the salty deluge covers your face, but you are unable to stop the stream from going up your nose and into your mouth between alternating thrusts from the matriarch in your maw. The torrent of jizz can only be described as delicious, but the salty treat is slick too, providing just enough lubrication for the powerful bitch at your face to thrust her knot into your mouth while you are distracted. You yell out in surprise as the invader is trapped behind your teeth, providing the furry gang leader with even more stimulation and encouraging the knot to swell up and lock with your face.";
		WaitLineBreak;
		say "     The distraction at your face provides the hyena behind you with her own opportunity to thrust the full might of her pulsing pole into your thoroughly stretched asshole as she too cums powerfully. The pain of being stretched so wide is only fleeting, and is soon replaced by an intense feeling of pleasure as the bitch breaker balloons inside you. You body is wracked by the most deliciously full sensation as she throbs deep inside you and you are unable to control your own orgasm. [if cocks of player > 0]Your cock squirts its salty mess to the ground, wasted and useless[else] Your lower abdomen tenses up and send spikes extreme pleasure radiating outwards from your pelvis and into the rest of your body[end if]. The anal contractions only intensify the shuddering herms passionate orgasm, encouraging the lusty creature to pump more and more of that hot seed into you.";
		say "     At your face the gang leader is gripping your hair and has your face pressed tight against her pelvis as she too unloads in your gullet. You are both saddened and aroused by the fact that the delicious cock is so deep you can't even taste the eruption of ejaculate. Instead it pours straight into your hungry belly. The remaining gang members at your face and back cum at the sight of your dominated and used body, choosing to spend their seed all over you. You relish the feeling of the hot ropes of semen that cover your beta bitch body, soaking you in powerful alpha cum as you bask in the afterglow of your orgasmic high. As the endorphin release subsides, you become more aware of your aching jaw and rectum. However you can do nothing but wait for the swollen knots to deflate and eventually pull free.";
		WaitLineBreak;
		say "     By the time the herms pop out of your well used holes the stocks have already opened. Cum leeks from your abused orifices and your ass seems unable to stem the tide after it's thorough reaming. You swallow the residual semen in your mouth, relishing the salty flavor as the gang cackles at your beta behaviour. Some them suggest putting you back in the stocks and taking you for another ride, but thankfully the leader keeps them in line. They jump back on their road hogs and ride off to find some other victim to terrorise. Sticky, sore and thoroughly fucked, you gather your belongings and head on your way.[mimpregchance]";

Hitching Post ends here.
