Version 2 of Koballoon by Song begins here.
[ Version 1.0 - Creature basis and defeat scenes - Stripes                  ]
[ Version 2.0 - Expanded defeat scenes, victory scenes, and bad ends - Song ]
[ Version 2.1 - Removed extraneous LatexList check - Song                   ]

"Adds a Koballoon creature to Flexible Survival's Wandering Monsters table"

Section 1 - Creature Responses

[ Use 'to say xxxxx' for overlong text boxes or complex situations, using '[xxxxx]' (in square brackets) within a say statement to execute them. Typically, these are needed if there are a lot of cock/species/cunt checks. ]

KoballoonMet is a number that varies. KoballoonMet is usually 0.
KoballoonLossCounter is a number that varies. KoballoonLossCounter is usually 0.
KoballoonSexBadEnd is a number that varies. KoballoonSexBadEnd is usually 0.

to say KoballoonDesc:
	if KoballoonMet is 0:
		say "     From one side, you hear a faint but increasing sound, like that of a large ball bouncing toward you. As you warily look that way, the bouncing is joined by another from a different direction, and then again from several others still. Surrounded, you take a wary stance and await whatever their sources are, but you aren't quite ready for just what has found you.";
		say "     Bounding up comes a small gang of colorful, lizard-like creatures with rubbery hides, and they are definitely among the most extreme transformations you've seen. These little guys are each only about three feet tall, but rather than walk, they sit their very plush bottoms upon their massively inflated ballsacks. They use the latter like space hoppers and bounce in leaps of a several feet at a time. To go with these giant balls, they have equally big cocks that flop and slap against their rubbery pouches with each bound, keeping them semi-hard from the stimulation.";
		say "     While individually, these odd kobolds don't look like they'd be much trouble to deal with given their size, there are about a half-dozen of them in their group. Their numbers and the fact that they've encircled you [if level of Player < 10]puts them at an[else]does give them some[end if] advantage. You try to sound confident, telling them that you don't want any trouble and to let you pass, but they pay your words no heed.";
		WaitLineBreak;
		if mdasslevel > 0:
			say "     'Yes, this is the one I'd spotted with our former mistress. She has taken a liking to this one. We could use [ghim],' one says as he bounces in place.";
			say "     Another grins and bounds in a ring around you from a couple yards away. 'I can see why she has. Looks like a fun ride, I'd say.'";
		else:
			say "     'This one looks promising. What do you think?' one says with a happy laugh as he bounces in place.";
			say "     'Just the sort of thing that she likes,' another replies as he bounds in a ring around you from a couple yards away. 'Looks like a fun ride, I'd say.'";
		say "     'Shall we give [ghim] a test bounce, boys?' a third asks. Not waiting for a response, he springs toward you with a lustful grin. The others all follow suit, trying to mob you beneath their bounding rubber bodies.";
		increase KoballoonMet by 1;
	else if KoballoonMet is 1:
		say "     You hear the sounds of approaching bouncing, again coming from several directions at once. You're not sure how these rubbery kobolds have managed to home in on you, as they certainly seem too noisy to have snuck up and surround you. Regardless, you are soon encircled by a little group of the horny hoppers. You [if weapon object of Player is journal]raise your fists[else]ready your weapon[end if] while looking the strange mob of mutants over, taking this opportunity to get a better look at them.";
		say "     The small lizard-like creatures are each only about three feet tall, but sit upon their inflated ballsacks. Their scrotums are so big that their three-toed feet barely touch the ground when leaning in one direction to do so. They hardly do though, seeming to prefer to remain bouncing in place rather than stay still, and from the way their big cocks keep slapping pleasurably against those air-filled orbs with every bounce, it's easy to see why.";
		say "     Tearing your eyes away from that strangely tempting sight, you look over the rest of their forms. On the whole, they're small, spindly creatures with a mix of draconic features. While it seems that they have a scaly hide at an initial glance, it's actually made of thick rubber that's lightly textured, somewhat like a sports ball. They come in a variety of colors - reds, yellows, oranges, blues, and greens being the most common among those you've seen. Their muzzles come in a variety of draconic shapes with lizard-like tongues, frilled ears, and short horns. These horns have a slight backward curve to them and seem just the right size to grab as handholds. Speaking of hands, theirs have only four nimble digits. Their butts are quite plump, probably as padding for bouncing on their balls, and they have a thick lizard tail attached above their stretchy assholes.";
		increase KoballoonMet by 1;
	else:
		say "     You hear the familiar sound of bouncing balls approaching [one of]from all around you[or]from several directions[or]toward you en masse from behind before spreading out[as decreasingly likely outcomes]. You ready yourself for another encounter with those rubber kobold creatures, raising your [if weapon object of Player is journal]fists[else]weapon[end if] while looking the strange mob of mutants over.";
		say "     The colorful rubber kobolds bounce about on their inflated ballsacks, using them as space hoppers. Their large cocks slap against those hyper balloon balls of theirs as they bound around you, further arousing them. Some giggle, some joke with one another, and one even licks his lizard-like tongue [one of]across his dribbling glans[or]across his draconic muzzle[or]along a finger lewdly[or]under his dick's rubbery foreskin[at random] while they amuse themselves before attacking. Again, you find yourself being mobbed by about ten or so bouncing, laughing koballoons.";

to say LoseToKoballoon:
	if SkinName of Player is listed in infections of LatexList and a random chance of 1 in 3 succeeds and KoballoonLossCounter > 2: [Player is fucked and inflated into a perverted balloon. Potential bad end!]
		if HP of Player > 0:
			say "     Unwilling to resist these lascivious creatures, you give in to temptation and allow them to take hold of your unresisting body. The koballoons start to undress you, tugging away any obstructive gear or clothing to expose your yearning flesh. One of them spreads your thighs to draw a firm, snaking sweep of his bright blue tongue across your pelvis, his cool saliva sending shivers up your spine. Another rubs his small, sleek muzzle against your neck while his tail-tip tickles your crack. Myriad rubbery hands stroke and caress your form, their tantalizing touch exciting you while the heady aroma of rubber and sex clouds your mind.";
		else:
			say "     Unable to endure the koballoon's assault, your vision begins to blur from the myriad arms, cocks, and balls wailing away at you from every direction. Eventually, you stumble on some unsure footing and crumple to the ground before these bare-naked creatures, your mind still reeling from the beleaguering beating. You're pinned beneath the weight of a monstrous scrotum, a supple latex sack that smothers your chest while the koballoons snicker and jeer at your loss.";
			say "     'Should have just given in!' one of them laughs as he tears away your clothing.";
			say "     'Now we gotta teach you a lesson that you won't soon forget,' another replies in a voice filled with malice, prodding and groping your battle-worn body.";
			say "     'A shame that we can't corrupt your flesh any further,' a third kobold muses. His initial disappointment is quickly dispelled when an idea crosses his mind. 'What do you say we give [ghim] the blimp treatment instead?' he suggests, a notion met with a stir of hasty nodding before the creatures are upon you.";
		WaitLineBreak;
		say "     A particularly rapacious reptile begins to grind the full firmness of his swollen shaft against you, its heft atop your back reminding you of the task at hand. For a moment, you simply stare at the domed head of a monstrous member, every throb of that torso-length meat leaking more of its lube-like pre. Your mounting arousal soon gets the better of you and you lift its drooping bulk to meet your lips, the slavering cockhead poised for worship. You lick your lips hungrily, looking up for a nod of approval, before taking a long, slit-circling sweep of the tongue across its flaring urethra. The potent, musky flavor suffuses your palate, followed by a warm rush of tingles as the transformative essence seeps into your tainted flesh. You take another languid lick before attacking that elastic hole in earnest, tongue worming partway within the stretchy lining, swirling and sweeping across the supple material while you moan against his pulsing pole.";
		say "     You give a disappointed groan when your well-endowed lover pushes you back, a string of seed-streaked pre drooping down between the gap. 'You'll get your treat soon, eager one,' the kobold teases with a twinkle in his eye. He then turns to address the gang with a lecherous grin, 'What do you say we give this one the royal treatment, boys?' The colorful creatures around you cheer at the suggestion, crudely groping your curves while slathering your flesh in a heady sheen of seminal fluid. You can only moan absentmindedly when the mutants lower you down onto your back, entirely too turned on by their attentions to question what they have planned.";
		WaitLineBreak;
		say "     At first, you expect the familiar pressure of their dicks pressed to your form, preemptively craning your head back and lifting your legs to provide them with easy access to your every yearning hole. You're instead met with the surprisingly sensual contact of their lips against your body, a series of butterfly kisses along your throat leading up your chin until they culminate in a demanding, tongue-filled embrace. Another playful kobold draws several slow, spit-slick sweeps across the crack of your ass before sealing a kiss to that winking star, tongue worming deep into your jealously clenching colon. [if Player is male]A third dips down over your rock-hard shaft, his maw forming a warm and cozy cocksheath that ripples and squeezes skillfully around your dick. [end if][if Player is female]You shiver when a long, dexterous tongue slithers into your slavering pussy, that tapering muscle sweeping along the walls of your hot and needy cunt. [end if]The sensual assault on your senses sends you down a spiral of sinful pleasure, each smart lash of their tapering tongues driving you ever closer to the mind-shattering release that you crave.";
		say "     Your writhing body is kept pinned to the floor, given no chance to escape or squirm free from their oral attentions. While you're kissed and tongue-fucked with practiced expertise, you're also treated to lungfuls of mind-eroding aphrodisiacs, their every breath tainted with an arousing array of chemicals. Subdued as you are beneath the pack of lustful lizards, you pose no objections when they switch to blowing into your proffered holes, a cool rush of arousing gas being forced into your form. The air-tight seal of their lips means that none of their intoxicating breath escapes, and the steady outpour forces your elastic rubber flesh to stretch and expand.";
		WaitLineBreak;
		say "     Your stomach begins to ripple as it grows, swelling and rounding out until it protrudes in a huge, bloated dome before you. Your arms and legs broaden until you can scarcely move your limbs, thighs brushing together slickly in a brief moment of panic. Your rear, too, plumps up as the twisted creatures['] breath inflates you from within, leaving you aroused and yearning, your stretchy asshole lusting for a fat rubber cock. Before long, you're left with an obscenely oversized body, a parade float of latex flesh that feels taut around the sheer volume of tainted air inside of you. Groaning weakly, you accept your role as their lustful, helpless plaything, and your air-filled body begins to rise from the ground.";
		say "     The sudden ascent would surprise you, but you're far too gone to care. Why should you when this feels so good? A pair of hands take hold of your ankles while another hook around your shoulders, tethering you from simply floating away. A smart lick across your anal rim sends a fresh surge of arousal through your achingly needy ass, followed swiftly by the teasing contact of his tongue's tip probing your entrance. You moan softly when a dripping cockhead smears across your cheek, tilting your head to brush against that immaculate meat while that long and tapered tongue bores into your asshole. ";
		if Player is male:
			say "You shudder when [if Cock Count of Player > 1]their cum-slick hands caress your dangling cocks, giving weak little bucks into each[else]a cum-slick hand caresses your dangling cock, giving weak little bucks into that[end if] softly pumping vise as the heat and scent of bestial sex invigorates your lusts. ";
		if Player is female:
			say "Your entire body grows tense when [if Cunt Count of Player > 1]more nimble tongues are stuffed into your achingly needy cunts, swirling and sweeping within your drenched and eager depths[else]another nimble tongue is stuffed into your achingly needy cunt, swirling and sweeping along your drenched and eager passage[end if]. ";
		say "Your mind shuts off completely when the writhing mass of tongue in your rear is joined by a fat, throbbing dick that pushes into you body without warning, spearing your asshole in tandem with the other's swirling lashes. ";
		if Player is female:
			say "Your [if Cunt Count of Player > 1]needy cunts are stuffed with more of their colossal kobold cocks, distending your body further with every pulsing length until you're physically unable to take more of them[else]needy cunt is stuffed with another colossal kobold cock, distending your body further with its smooth and intensely pleasurable presence[end if]. ";
		say "Each koballoon seems to find their own niche in assaulting your hovering body, asynchronous jolts of pleasure leaving you sharply attentive to their every teasing touch.";
		say "     Soon, any pretense of foreplay is tossed aside in favor of taking turns brutalizing your hungry holes. Feverish thrusts pound into your throat, that towering pillar pushing aside internal organs to make room for its conquest, the dull thud of bouncy balls slapping against your chin as demeaning as it is exciting in your hyper-aroused state. The reptilian tongue charting your ass is replaced by a second dribbling dick, your inflated rear double-fucked by those ludicrously large lengths[if Player is not neuter] while you cum repeatedly across the ground beneath you[end if]. You're surprised that you can take those monstrous members with as much ease as you are, but the logistics of your reaming are of little concern to you now as you drool around copious rubber cockflesh, only faintly aware of your surroundings in your sex-induced daze. You're stuffed with load after load of thick, musky seed while the creatures take turns ravaging your helpless form, a cock occasionally replaced with an elongated tongue or dexterous digits to probe your insides, gauging your elasticity in practiced motions that draw moans and giggles from their air-headed catch.";
		WaitLineBreak;
		say "     Eventually, the seemingly unending attack on your senses becomes too much for your weary form to handle. ";
		if Player is herm:
			say "You're pushed to one last, mind-rending climax, clenching tight around their cum-slathered cocks and loosing a muffled scream around the meat stuffing your throat. Your twitching shaft is furiously masturbated to drain every last drop, and your gaping [if Cunt Count of Player > 1]cunts clench and squirt around the cocks stuffing them[else]cunt clenches and squirts around the cock stuffing it[end if] as you orgasm. Thoughts numbed by the intensity of your dual-sexed climax, you can only gurgle wetly when another kobold begins massaging your churning orbs, milking you for all you're worth. Your copious output is not left to waste, the lizard pumping your shaft[smn] all too happy to kneel down in front of those strained blasts and open wide, sealing his snout around [if Cock Count of Player > 1]one of your cockheads[else]your cockhead[end if] to ravenously swallow every last drop.";
		else if Player is male:
			say "You're pushed to one last hard, mind-rending climax, clenching tight around their cum-slathered cocks and loosing a muffled scream around the meat stuffing your throat. Your twitching shaft is furiously masturbated to drain every last drop, and you can only gurgle wetly as another kobold begins massaging your churning orbs, milking you for all you're worth. Your copious output is not left to waste, the lizard pumping your shaft[smn] all too happy to kneel down in front of those strained blasts and open wide, sealing his snout around [if Cock Count of Player > 1]one of your cockheads[else]your cockhead[end if] to ravenously swallow every last drop.";
		else if Player is female:
			say "You're pushed to one last, mind-rending climax, clenching tight around their cum-slathered cocks and loosing a muffled scream around the meat stuffing your throat. Your gaping [if Cunt Count of Player > 1]cunts clench and squirt around the cocks stuffing them[else]cunt clenches and squirts around the cock stuffing it[end if] as you orgasm, your thick honeys splattering across the ground as you buck and writhe helplessly between your squeakily rutting lovers.";
		else:
			say "Without genitalia, your neuter form is deprived of release, the pleasure of being used by all these sexy kobolds only rising until it becomes almost unbearable. You release a muffled scream around the meat stuffing your throat, your asshole twitching as you writhe and buck helplessly, aching for more and yet desperate to get away before your mind snaps from the sensory overload of it all.";
		say "     Once [if Player is neuter]they're finally finished using you for their own pleasure[else]your orgasm tapers to an end[end if], your captors pull back to admire their well-fucked plaything. 'Hope you enjoyed that, sweetheart!' one of them laughs with a satisfied smirk. 'Yeah, you're a real good lay,' another teases, drawing a harmless rubber claw along your leaking anal rim[if Player is female] and tender folds[end if]. 'See you again soon!' a third calls out, and before you can protest, the kobolds let go of your obscenely over-inflated form. Still lost in the haze of the afterglow, you don't quite register what's happening at first, but you soon realize that your swollen form has begun to float up into the sky, farther and farther away from the waving koballoons until they're naught but bouncing silhouettes in the distance, seeking out another lucky victim to harass and corrupt.";
		WaitLineBreak;
		say "     You remain adrift, hovering far above the fairgrounds. You should by all accounts be concerned, but all you can muster are pleasured moans as your air-headed mind drifts back to the encounter. Their ample cum serves as a natural adhesive, plugging their breath deep within you, some of their seed trickling down your rubber flesh before dripping to the ground below. You giggle absently at the thought of an innocent survivor being caught off-guard, only to lapse into a long and sordid fantasy of transforming them into another sexy, well-hung koballoon to fuck you senseless. Growing aroused all over again, you reach back to finger-fuck your anus with slick, slurping thrusts, daydreaming of endless rubbery sex as an inflated mascot for their group.";
		if humanity of Player < 20: [Bad end]
			say "     Distracted as you are with nothing but your nanite-laced thoughts to keep you company, your already fragile mind snaps. Smiling placidly, you can't help but giggle at how foolish you once were, thinking that you weren't meant to be a happy, airheaded plaything for those sexy rubber lizards. Why would you ever reject such a wonderful gift? You laugh softly, ";
			if Player is male:
				say "rubbing your fingers against your prostate and pumping your achingly needy cock[if Cock Count of Player > 1]s together[end if], mindlessly masturbating until you bring yourself to a relaxing, stimulating climax that sends thick ropes of rubbery seed to splatter across the fairground below.";
			else:
				say "continuing to lazily thrust your fingers back and forth in your sordid rear, focusing only on the pleasure roaring through you as their slimy seed soaks into your latex flesh.";
			say "     After a while, enough air has escaped from the imperfect seal of the koballoons['] seed to disrupt the equilibrium keeping you afloat, leaving you to less-than-gracefully descend again until, at last, you make contact with the fairground floor. Once settled, you take several long, deep breaths of their potent sexual aroma before embarking toward their last known location. As you walk, you leave a trail of mixed seed in your wake, the sensation of that cool, damp trickle sending a fresh surge of arousal through your form. A hand strays back to dig into your well-stretched ass, swirling around your cum-soaked insides while ";
			if Player is herm:
				say "your cunt[sfn] drip[sfv] all over the ground beneath you your length[smn] throb[smv] and twitch[esmv] ";
			else if Player is male:
				say "and length[smn] throb[smv] and twitch[esmv] ";
			else if Player is female:
				say "your cunt[sfn] drip[sfv] all over the ground beneath you ";
			else:
				say "you moan ";
			say "with wanton need. You shudder, putting all your focus into staying on course and not just breaking down in a fit of masturbatory bliss.";
			WaitLineBreak;
			say "     After what feels like hours of stumbling through the fairgrounds, you finally spot the gang again. Unthinkingly, you move towards them, primal urges suppressing what small part of you screams to resist. When one spots you, the whole gang releases their newest conquest and rushes to greet you, all too eager to welcome you into their ranks. The transforming, cum-bloated woman takes advantage of their lapse in focus to crawl away from her aggressors, moaning feebly as rubbery seed leaks from her every gaping orifice.";
			say "     'We knew that you'd come back!' one of the bouncing [']bolds exclaims proudly, his half-hard cock slapping across his scrotum with loud, wet splats. 'It's just a shame that it took you so long,' another adds with a sinister chuckle, the cum-slick caress of his fingers sending a cool shiver down your spine. Almost immediately, you're pushed down on all fours by the welcoming party and presented with a bevy of delicious latex dicks from all directions. Salivating hungrily, you take hold of one particularly enticing cock and stuff it down your throat, delighting in the potent musky flavor and the prominent bulge it leaves in your distended neck. You briefly wonder how you managed to take that thing so easily, only to lose your train of thought again when a firm, possessive buck leaves a dick-shaped impression in your chest, a thick slurry of pre draining directly into your gullet. Moaning hotly around sordid cockflesh, you curl your tongue around that thick slab of dark, slick meat to worship it with the subservient reverence it deserves. While your face is being pounded, the others take turns cheering and teasing you, their ample cocks smearing across your sides and back, reducing you to nothing more than a horny bitch at the center of the gangbang.";
			WaitLineBreak;
			say "     'You make for such a fine butt-slut,' a kobold laughs merrily, his dull claws raking tenderly along your seizing rim, making you push back against his touch in a wordless plea for more. Your eyes roll back into your head when two fingers sink into your loose, unresisting sphincter, wriggling and sweeping along your tainted depths to stimulate your every aching nerve. That sensual stroking tickles your prostate, only increasing your need to be fucked by these irresistible mutants. As if sensing your submission, the kobold toying your asshole balls his hand into a fist and sinks it all the way to the elbow in your greedily suckling passage, his knuckles dragging roughly across your anal lining. Sawing his forearm back and forth in your horny rear end, it's only a matter of time until ";
			if Player is male:
				say "a clever rub of the prostate pushes you right over the edge, your screams of climax muffled by towering cockflesh as thick ropes of seed splatter across the ground. Writhing and bucking helplessly, your intensely powerful orgasm is only prolonged by the guiding hand of a helpful kobold, squeezing your twitching shaft in his grasp with firm, milking pumps.";
			else if Player is female:
				say "a clever rub against the back of your vaginal wall pushes you right over the edge, your screams of climax muffled by towering cockflesh as your femcum squirts across the ground. Writhing and bucking helplessly, your intensely powerful orgasm is only prolonged by a pair of fingers pumping into your gripping depths, drawing out your spasms of bliss.";
			else:
				say "your gripping anus relaxes enough to allow him deeper entry, sinking all the way to the shoulder inside your colon to stroke across those hard-to-reach nerves with practiced expertise.";
			say "     [if Player is neuter]As the wild sex continues, you forget about your old self[else]When that wonderful high comes to an end, you can't help but feel somewhat dazed, drooling around the hot, slick dick stuffing your throat in absent reverie. You've forgotten your old self, your recent climax having extinguished the last flickering light of your humanity in a cool deluge of cum[end if], overwhelmed by the lustful urges that infect your every thought. Relaxing your throat, you swallow down each rubbery blast fed to you. Reaching back to spread your asshole, you wring that cum-stuffed chasm around every length that throbs and pulses in your accommodating backside. What follows is a haze of cycling partners, filling your [if Player is female]every yearning orifice[else]ass and mouth[end if] until it all blurs into the natural order of things, breaking you fully into your role as the shared receptacle for their seed, no more than a moaning, pleading onahole to fuck and stuff to your limits.";
			say "     Once the gang of koballoons has had their fill reaming you, your body is left to slide to the ground in a sore, oversexed heap. Shakily, you push your fist into your gaping sphincter, your knuckles effortlessly sliding past the rim. You swirl it around in the seemingly bottomless, cum-stuffed chasm that is your ass, marveling at just how tender and sensitive every inch of your ravaged colon feels. [if Player is male]You roughly drag your knuckles against your thrumming prostate, twitching and throbbing hard with every shiver-inducing rasp, milking thick gobs of pre from your swollen, churning orbs. [end if][if Player is not neuter]Soon, another messy orgasm overtakes you, and you realize with a horny giggle that your refractory period has all but vanished, leaving you lusting to be fucked at all times. [end if]You draw your cum-slathered hand out before plunging it back in again, over and over, tirelessly fisting yourself to slake this new, burning need that has become your whole word until you finally black out in exhaustion.";
			WaitLineBreak;
			say "[KoballoonSexBadEnd]";
		else: [Standard end]
			say "     Distracted as you are with nothing but your nanite-laced thoughts to keep you company, you scarcely notice that you're starting to lose altitude. Enough air has escaped from the imperfect seal of their seed to disrupt the equilibrium keeping you afloat, leaving you to less-than-gracefully descend again until, at last, you make contact with the fairground floor. Struggling to find your composure, you eventually find the strength of will to retrace your steps and retrieve your gear, still shuddering from the intense carnal experience. Even after redressing, you remain tempted to return to the gang, to give in completely to their twisted, seductive influence.[fimpregchance][mimpregchance]";
	else:
		say "     [if HP of Player > 0]Tempted at all sides, you give in and allow yourself to be pulled to the ground by one of the bouncing guys[else]Pestered at all sides, you get knocked down by one of the bouncing guys[end if]. Soon, several others pile atop you, burying you in rubbery flesh. Giggling merrily at their success, the kobolds grope [if HP of Player > 0]you[else]their prize[end if] all over. One mashes his big, rubber balls down onto your face, grinding his inflated scrotum onto it. The creature's arousing scent fills your senses, [if HP of Player > 0]further [end if]serving to turn you on. As soon as he moves off, he's replaced by another, and then another still. Next comes a big, rubbery wang that drools and dribbles latex lube onto your head.";
		say "     You find yourself kissing and licking at the bulging packages pushed your way, even if you can only barely see the recipient. There's rubber flesh, throbbing cocks, and inflated balls always within reach. The playful kobolds seem quite pleased as you get more involved in the fun.";
		if Player is male:
			say "     Shifted onto your side by an enterprising pair, one takes the front and the other the back, sliding muzzle over cock and tongue into ass[if Player is female]. Another squirms his way in there, moving in to lick at your dripping cunt[sfn][end if][if a random chance of 2 in 5 succeeds and anallevel > 1]. You find your face sat on by another bouncy butt, wedging it between those rubbery buns. With your lips mashed up to the kobold's stretchy pucker, you set to kissing and licking at it[else]. A nearby kobold swings his big dick into position, pressing his drooling glans to your lips. With it right there, you start licking and kissing at that drooling cum-slit[end if].";
			if SkinName of Player is listed in infections of LatexList and a random chance of 1 in 2 succeeds: [1/3th chance of happening. Above, we use the same conditionals and 1/3 rarity. That leaves 2/3 left. Half of that is also 1/3, meaning that each scene has equal weighting]
				say "     You're tongue-fucked, cock-sucked, and otherwise toyed with by the horny reptiles to orgasm. Having drained your balls, the kobolds continue their fun in a new way. The one on your dick swaps from sucking to quite literally blowing you. The one tonguing your ass switches to blowing as well. The strange sensation of having air forced into you is only compounded when a third kisses you and then turns that into another means to inflate you[if Cock Count of Player > 3]. Your other dicks are given a similar treatment, increasing your rate of inflation[else if Cock Count of Player is 2]. Your other dick is given a similar treatment, increasing your rate of inflation[end if]. You swell and bulge in all directions, though hardly evenly. Your cock[smn], balls, ass, and thighs get the worst of it. Your body swells as well, making you feel full and tight, your head and limbs restricted by the size of it until it's difficult to do little more than jiggle them impotently.";
				say "     Only once they relent do you realize how much you've grown. Released by the mocking kobolds, you float upward. The little lizards look all the smaller now, tiny compared to your parade-balloon-scale body. Even as you float up, you try to release all of the excess air inside of you, but they've done something to you and you can't seem to let it out. You slowly rise higher and end up drifting over the fairgounds like some lewd parade float, much to the amusement of many of the other denizens of the midway. You do eventually start going down and come back to the ground. It is quite some time before you deflate properly and return more or less to normal.";
			else:
				say "     After all of this teasing has gotten you good and horny, you're rolled over right atop another kobold. Resting on his chest means that his plump ass is raised and ready when you're put over him. Your dick sinks right into his welcoming hole. You're only allowed to enjoy this for a moment before hearing a series of [']bold ball bounces bearing down on you. With cheers from the others, including the one under you, a horny kobold bounds right onto your butt, driving his inflated rod fully into you. You're rapidly humped between the pair of rubber creatures as every impact from the one on top is reflected into the one on the bottom.";
				say "     The one atop you blasts a torrent of cum into your ass, [if scalevalue of Player > 4]stuffing your [Body Size Adjective of Player] belly with hot, gooey spunk[else if scalevalue of Player > 2]over-stuffing your belly with hot, gooey spunk[else if scalevalue of Player > 1]overloading your [Body Size Adjective of Player] body with hot, gooey spunk[else]bloating and rounding your [Body Size Adjective of Player] body with hot, gooey spunk to the point of overflowing[end if]. In the end, you can only moan and groan as this vigorous fucking and filling pushes you over the top. You cum hard into the eager bottom, pumped for all you'll give. The semen you're giving is more than returned to you from the other surrounding kobolds as they masturbate messily onto the rocking trio. You're bathed in sloppy streams of their seed, left sore, sticky, and sated by the fuckfest. They leave you there for now, exhausted and flat on your back in a pool of their mixed cum.[mimpregchance]";
		else if Player is female:
			say "     Shifted onto your side by an enterprising pair, one takes the front and the other the back, sliding muzzle between thighs and buns. Wriggling tongues slide across and then squirm into your dripping cunt[sfn] and relaxing pucker[if a random chance of 2 in 5 succeeds and anallevel > 1]. You find your face sat on by another bouncy butt, wedging it between those rubbery buns. With your lips mashed up to the kobold's stretchy pucker, you set to kissing and licking at it[else]. A nearby kobold swings his big dick into position, pressing his drooling glans to your lips. With it right there, you start licking and kissing at that drooling cum-slit[end if].";
			if SkinName of Player is listed in infections of LatexList and a random chance of 1 in 2 succeeds: [see above for true chance of occurring]
				say "     You're double-tongue-fucked and otherwise toyed with by the horny reptiles to orgasm. Having [if HP of Player > 0]overwhelmed your resistance[else]gotten their prize to cum[end if], the kobolds continue their fun in a new way. The tongue in your still-quivering cunny is withdrawn and those rubbery lips lock with yours in a lewd kiss before the creature starts blowing into your cunt. The one tonguing your ass switches to blowing as well. The strange sensation of having air forced into you is only compounded when a third kisses you and then turns that into another means to inflate you[if Cunt Count of Player > 3]. Your other cunts are fingered and teased during their process[else if Cunt Count of Player is 2]. Your other cunt is fingered and teased during this process[end if][if Nipple Count of Player > 0 and Breast Size of Player > 0]. Other kobolds soon latch onto your nipples, at first sucking on them to perk them up before pinching and blowing into them like air nozzles. The sensation of air being forced into your bosom is strangely arousing as your breast size grows and grows[end if]. You swell and bulge in all directions, though hardly evenly. Your [if Breast Size of Player > 0]tits, [end if]ass, and thighs get the worst of it. Your body swells as well, making you feel full and tight, your head and limbs restricted by the size of it until it's difficult to do little more than jiggle them impotently.";
				say "     Only once they relent do you realize how much you've grown. Released by the mocking kobolds, you float upward. The little lizards look all the smaller now, tiny compared to your parade-balloon-scale body. Even as you float up, you try to release all of the excess air inside of you, but they've done something to you and you can't seem to let it out. You slowly rise higher and end up drifting over the fairgounds like some lewd parade float, much to the amusement of many of the other denizens of the midway. You do eventually start going down and come back to the ground. It is quite some time before you deflate properly and return more or less to normal.";
			else:
				say "     After all of this teasing has gotten you good and horny, you're rolled over right atop another kobold. Several groping hands guide your hips down onto his swollen dick, pushing your wet cunt down over the pulsing cock[if Cunt Depth of Player < 24]. Your vagina, prepped by the earlier kobold's slick slobber, stretches like rubber to accommodate this massive pole[end if]. You're only allowed to enjoy this for a moment before hearing a series of [']bold ball bounces bearing down on you. With cheers from the others, including the one under you, a horny kobold bounds right onto your butt, driving his inflated rod fully into you. You're rapidly humped between the pair of rubber creatures as every impact from the one on top is reflected into the one on the bottom.";
				say "     The one beneath you cums first, though not by a great margin. His inflated balls, mashed beneath those of the other, are forced to give up their seed - forcing it all into you. As you [if scalevalue of Player > 3]fill[else]swell[end if] from the mighty output, the one atop you blasts a torrent of cum into your ass as well. Between the two of them, your belly and womb are [if scalevalue of Player > 4]overstuffed with hot, gooey spunk[else if scalevalue of Player > 1]overloaded with hot, gooey spunk[else]bloated and rounded until they can take no more and the rest overflows from your mouth, cunt, and ass[end if]. In the end, you can only moan and groan as this vigorous fucking and filling pushes you over the top. You cum repeatedly through the process as your fall into a daze of orgasmic bliss. This shameful display is made all the lewder as the other surrounding kobolds masturbate messily onto the rocking trio. You're bathed in sloppy streams of their seed, left sore, sticky, and sated by the fuckfest. They leave you there for now, exhausted[if scalevalue of Player < 3] and ballooned out by all the semen filling your once [Body Size Adjective of Player] body[else if scalevalue of Player < 5]and rounded by all the semen stuffed into your well-fucked holes[else]and plumped by all the semen stuffed into your well-fucked holes[end if].[fimpregchance][mimpregchance]";
		else:
			say "     Shifted onto your side by an enterprising pair, one takes the front and the other the back, a muzzle locking to your lips in a passionate kiss while a tongue burrows deep inside of your ass. Eager for more, the kobold before you pulls away to present his [if a random chance of 2 in 5 succeeds and anallevel > 1]bouncy butt, wedging your face between those rubbery buns. With your lips mashed up to the kobold's stretchy pucker, you set to kissing and licking at it[else]large and throbbing dick, pressing his drooling glans to your lips. With it right there, you start licking and kissing at that drooling cum-slit[end if].";
			if SkinName of Player is listed in infections of LatexList and a random chance of 1 in 2 succeeds: [see above for true chance of occurring]
				say "     You're groped, tongue-fucked, and otherwise toyed with by the horny reptiles. Having [if HP of Player > 0]overwhelmed your resistance[else]teased you long enough[end if], the kobolds continue their fun in a new way. The cock stretching your throat to distention is withdrawn and those rubbery lips lock with yours in a lewd kiss before the creature starts blowing into your form. The one tonguing your ass switches to blowing as well. You swell and bulge in all directions, though hardly evenly, your ass and thighs getting the worst of it. Your body swells as well, making you feel full and tight, your head and limbs restricted by the size of it until it's difficult to do little more than jiggle them impotently.";
				say "     Only once they relent do you realize how much you've grown. Released by the mocking kobolds, you float upward. The little lizards look even smaller now, tiny compared to your parade-balloon-scale body. Even as you float up, you try to release all of the excess air inside of you, but they've done something to you and you can't seem to let it out. You slowly rise higher and end up drifting over the fairgounds like some kind of lewd parade float, much to the amusement of many of the other denizens of the midway. You do eventually start going down and come back to the ground. It is quite some time before you deflate properly and return more or less to normal.";
			else:
				say "     After all of this teasing has gotten you good and horny, you're rolled over right atop another kobold. Several groping hands guide your hips down onto his swollen dick, pushing your ass down over the pulsing cock. You're only allowed to enjoy this for a moment before hearing a series of [']bold ball bounces bearing down on you. With cheers from the others, including the one under you, a horny kobold bounds right against your face, driving his inflated rod fully into you. You're rapidly humped between the pair of rubber creatures as every impact from the one on top is reflected into the one on the bottom.";
				say "     The one beneath you blasts a torrent of cum into your ass, [if scalevalue of Player > 4]stuffing your [Body Size Adjective of Player] belly with hot, gooey spunk[else if scalevalue of Player > 2]over-stuffing your belly with hot, gooey spunk[else if scalevalue of Player > 1]overloading your [Body Size Adjective of Player] body with hot, gooey spunk[else]bloating and rounding your [Body Size Adjective of Player] body with hot, gooey spunk to the point of overflowing[end if]. In the end, you can only moan and groan as this vigorous fucking and filling devolves into a haze of squeaky lovemaking, the other surrounding kobolds masturbating messily onto the rocking trio. You're bathed in sloppy streams of their seed, left sore, sticky, and sated by the fuckfest. They leave you there for now, exhausted and flat on your back in a pool of their mixed cum.[mimpregchance]";
	infect "Rubber Drake";
	increase KoballoonLossCounter by 1;

to say BeatTheKoballoon:
	say "     You manage to drive off the bouncing pests. Before they can all escape, you pin one of them underfoot, keeping him from getting away. The [one of]cherry red[or]canary yellow[or]pumpkin orange[or]cyan blue[or]lime green[or]cream-colored[at random] koballoon writhes about and calls you various colorful obscenities, but it's clear that the oversexed creature is only feigning protest from the way his gargantuan shaft throbs against the ground. If the lewd grin he creases is any indication, he's even looking forward to being violated.";
	now sextablerun is 0;
	blank out the whole of table of fucking options;
	[]
	if Player is male and anallevel > 1:
		choose a blank row in the table of fucking options;
		now title entry is "Fuck his ass";
		now sortorder entry is 1;
		now description entry is "Claim that taut latex tailhole";
	[]
	if Player is male:
		choose a blank row in the table of fucking options;
		now title entry is "Make him fellate you";
		now sortorder entry is 2;
		now description entry is "Stretch that rubber neck around your cock";
	[]
	if Player is female:
		choose a blank row in the table of fucking options;
		now title entry is "Vaginal ride";
		now sortorder entry is 3;
		now description entry is "Ride the creature's obscenely oversized dick";
	[]
	if Player is female:
		choose a blank row in the table of fucking options;
		now title entry is "Cunnilingus";
		now sortorder entry is 4;
		now description entry is "Command the koballoon to service your cunt orally";
	[]
	if anallevel > 1:
		choose a blank row in the table of fucking options;
		now title entry is "Anal ride";
		now sortorder entry is 5;
		now description entry is "Spread your ass wide around that huge rubber phallus";
	[]
	choose a blank row in the table of fucking options;
	now title entry is "Fellate him";
	now sortorder entry is 6;
	now description entry is "Wrap your mouth around that massive uncut cock";
	[]
	sort the table of fucking options in sortorder order;
	repeat with y running from 1 to number of filled rows in table of fucking options:
		choose row y from the table of fucking options;
		say "[link][y] - [title entry][as][y][end link][line break]";
	say "[link]0 - Let him go[as]0[end link][line break]";
	while sextablerun is 0:
		say "Pick the corresponding number> [run paragraph on]";
		get a number;
		if calcnumber > 0 and calcnumber <= the number of filled rows in table of fucking options:
			now current menu selection is calcnumber;
			choose row calcnumber in table of fucking options;
			say "[title entry]: [description entry]?";
			if Player consents:
				let nam be title entry;
				now sextablerun is 1;
				if (nam is "Fuck his ass"):
					say "[KoballoonBeaten1]";
				if (nam is "Make him fellate you"):
					say "[KoballoonBeaten2]";
				if (nam is "Vaginal ride"):
					say "[KoballoonBeaten3]";
				if (nam is "Cunnilingus"):
					say "[KoballoonBeaten4]";
				if (nam is "Anal ride"):
					say "[KoballoonBeaten5]";
				if (nam is "Fellate him"):
					say "[KoballoonBeaten6]";
		else if calcnumber is 0:
			say "     Rather than stoop to the lecherous creature's level, you release his form and step away, much to his dismay. 'Aww, well you're no fun!' the koballoon pouts. He blows a raspberry at you before saddling up and bouncing away on his bountiful sack, likely in search of the group that he was separated from. A trail of sticky pre follows his wake, leaving the strong scent of rubber and arousal to remember him by.";
			now sextablerun is 1;
		else:
			say "Invalid Option. Pick between 1 and [the number of filled rows in the table of fucking options].";
	wait for any key;
	clear the screen and hyperlink list;

to say KoballoonBeaten1: [Player fucking the koballoon anally]
	say "     Eager to make use of your latex plaything, you bowl him over onto all fours and peruse his bountiful buttocks. A snug, smooth pucker rests square between those heavy cheeks, tightly clenched with anticipation. His tail flags up and out of the way across his slender, curving back, exposing himself fully for his captor. 'Well, what are you waiting for?' the creature asks impudently, sashaying his generously proportioned derriere, his corrupted body yearning for nothing more than to be a cocksleeve for your [Cock of Player] dick.";
	say "     Unwilling to deny such a tempting offer, you slide in against the strange rubber creature, leaning down over the sleek, thick expanse of his tail as you align your cockhead with his rim. The koballoon shudders beneath you, his claws digging into the ground as he pushes his sumptuous curves back against your crotch. 'Mmh, that's more like it,' he moans hotly against the fairground floor. His latex skin squeaks to the touch as you stroke, squeeze, and pinch your twisted fucktoy, savoring the moment just a little while longer, bare cockflesh sandwiched sensually between the ample globes of his ass.";
	WaitLineBreak;
	say "     In one smooth stroke, you bury your aching manmeat within his rippling confines, biting down on the creature's neck as pleasure overwhelms you. His ass, while obscenely oversized, proves tight and gripping, shifting and distending just right to support the shape and size of its intruder. Smooth anal lining contracts to squeeze hungrily around your length when you pull back - a slight prolapse of elastic flesh all that contains your cockhead. You push back to the hilt inside of his luxurious behind, gliding smoothly along his flawless latex colon, the material adapting expertly to accommodate your girth. 'Stop teasing and fuck me!' the koballoon all but begs beneath you, his tapering tail coiling around your form, squeezing you and pulling you tight against him in a primal, wordless plea.";
	say "     Lust roiling in your loins, you rope your arms under the diminutive toy and set to pounding him in earnest, your hips slapping against his own in a wet, sloppy concerto. The reptile's gargantuan cock and balls sway sluggishly beneath his twisted form as you ream him for all that he's worth, not even pulling out halfway before driving deep into his well-practiced bowels. The delicious tension of his rear never slackens as you rail him without pause or care, violating the little guy with lust-fueled gusto, each clap against his ample rear sending shocks of pleasure through you both.";
	WaitLineBreak;
	say "     Just as your mind begins to grow hazy, the creature releases a weakened cry brought on by the constant onslaught against his sensitive prostate. He orgasms powerfully beneath you, thick splatters of nanite-tainted seed sullying the ground, those high-pressured jets met with rippling, squeezing contractions of his entire body. The feeling in turn sets you off, balls churning as you fill the raunchy reptile with your [Cum Load Size of Player] load. His tongue hangs out of his muzzle as you paint his insides white, delighting in the way he squirms and writhes in your embrace, his feeble little moans the sweetest music to your ears as you drain all you can give into the mutant's rapacious rear.";
	say "     Spent and satiated, you pull back to allow the koballoon to slump to the ground. He lies limply in a small pool of his own seed, throbbing cock pinned beneath his fore as he reaches back to finger-fuck his cock-hungry hole. Grinning lewdly at the little guy, you give a final grateful spank to his rear that makes it wobble before you saunter away, stumbling here and there from the aftershocks of your expertly milked climax.";

to say KoballoonBeaten2: [Player being fellated by the koballoon]
	say "     Your attention is drawn to the kobold's muzzle, slightly agape as he rests on the ground with soft, needful breaths. You relinquish your grasp of the no longer struggling mutant and walk around to his fore, quickly undressing to make use of his yearning body. 'Oh, is that what you're in the mood for?' the rubbery reptile teases, his tongue flicking over his lips as you expose your [cock size desc of Player], half-erect shaft. He rises up to his feet, only to tip back on the plush pliancy of his monstrously swollen ballsack, stroking the sensitive skin of his orbs. Hands coming together, the koballoon helpfully slings his flaccid cock around his waist, giving you an idea of what he has in mind. 'Mmh, sit down. Let me take care of that for you,' the kobold all but purrs with a come-hither look.";
	say "     Not wanting to keep him waiting, you sidle up to the well-endowed creature and settle atop his improvised seat. Remarkably, the latex flesh proves supple, yet firm enough to support your combined weight without sagging or straining. The koballoon smiles in response, then leans in close to draw a sensual lick up your [if Breast Size of Player > 0]cleavage[else]chest[end if], leaving a streak of cool saliva in his wake. His claw-tipped hands come to rest around your waist in a gentle and surprisingly sweet embrace, the relaxing touch helping slough away whatever inhibitions remain. 'I'm going to take my time enjoying you,' he says, soft and enticing.";
	WaitLineBreak;
	say "     The fun-sized kobold leans down, peppering gentle little kisses along your stomach before settling on his prize. He presses a supple kiss to the head of your pre-dribbling dick, tongue flicking out to catch a dollop of salty anticipation. His latex breath blows down across your flesh in warm pulses, a stimulating heat that only serves to arouse you further. He relishes the opportunity to brush his sleek, boyish muzzle along the sides of your [Cock of Player] pole, smooth latex texture making you throb hard against his countenance. He licks and kisses along the underside of your length, his smooth and tapered tongue maneuvering in all the right ways to excite you. Shuddering, you wrap your hands around the creature's horns and give them a gentle tug, encouraging him to get on with it already.";
	say "     Without further delay, the playful reptile sinks his maw over your length, a warm and wet vise that squeezes deliciously around your aching cockflesh. Elastic latex lips come together around the base of your girth, forming a snug seal that sucks and tugs at your sensitive skin, all while his flexible tongue slithers down your maleness in a sensual spiral. Hot breath blows out against your groin, washing over your [Skin of Player] skin, each inhale squeezing his rubbery cheeks around you. The kobold's half-lidded eyes look up at you from between your thighs as you strain to maintain your balance on your lover's mighty sack, your grip faltering as you're teased and toyed with by the creature.";
	WaitLineBreak;
	say "     Aching with need, you set to pulling the kobold's head down against your crotch, roughly pumping back into his throat like a glorified onahole. Your captive toy moans and rumbles around your mast, the vibrations of his voice sending tingles through your increasingly needy cock. The mutant's claws dig harmlessly into your rear as you violate his muzzle, a thick slurry of pre-cum drooling down his gullet, soon bouncing in the seat of his orbs to drive hard and fast into his masterfully milking maw. Frantically fucking his face now, it's only a matter of time until bliss overwhelms you and heat comes to a roil in your groin.";
	say "     You arch your back and grit your teeth as you pump your [Cum Load Size of Player] load down the koballoon's throat, deep into his rubbery form. Your cock remains perpetually hard as you climax, turgid flesh aching from the intensity of your output, yet more squeezed out by the continued curling and thrashing of the mutant's muscular tongue. Only once you've settled to weak throbs does the reptile's muzzle ascend, lips sliding free with a pronounced wet 'pop' before he licks his muzzle of any remaining cum. 'Mmh, that's the stuff,' the koballoon says with a sweet little giggle, leaning up to press a cum-filled kiss to your lips. He playfully pushes you off of his scrotum, then masturbates his previously neglected cock until he erupts in hot ropes of sticky, sordid seed, tainted fluid splattering across the fairground floor. 'Come again soon!' the well-hung mutant calls as he bounces away in search of his gang.";

to say KoballoonBeaten3: [Player riding the koballoon vaginally]
	say "     Against more prudent judgement, you decide that you want that tremendous cock inside of you - now. You push the uppity mutant onto his back, sidestepping the mountain of smooth scrotum between his legs to straddle his form, wedging yourself down against his lap. 'Hey now, careful with the goods!' the kobold teases. You lick your lips as you slide the arousal-slick folds of your labia against his massive manhood, shuddering at the thought of that monstrosity buried in your folds. Up close, the creature's cock seems even more obscenely oversized for the male's diminutive form, pre-cum leaking liberally from his uncut crown. You swallow, feeling a little unsure now with that imposing spire poised before you, but a hard, primordial throb against your mound causes your arousal to soar and your resolve to return.";
	say "     Thighs quivering as you slide up the creature's humanoid cock, you can't help but boggle at how much of that impressive pillar your cunt would have to consume. The thought both horrifies you and arouses you further, the heady mix of sterile synthetics and musky animal lust having warped your perception. Steeling yourself, you take hold near the head of the kobold's cock and align your slit with that drooling glans, slickened foreskin peeling back easily to expose more of the glossy, lubricated head. 'Well, what are you waiting for?' the mutant laughs, only to crease a lecherous grin as you hover atop that eagerly pulsing pole.";
	WaitLineBreak;
	say "     You lower yourself down, slowly at first, shuddering at the feeling of that length easing past your gate, its cockhead flaring rhythmically with every beat of the creature's heart. The stimulation is almost unbearable, a constant barrage of pleasure and discomfort that joins together as one powerful surge of carnal desire. You'd orgasm here and now if you weren't so determined to take the entirety within you, eyes fluttering closed by the time only half of that perverse pillar is buried within you. Inch after inch of rubbery cockmeat disappear inside of your cunt, your body somehow able to accept the inhumanly large intrusion, though the contours of his spire remain apparent through your [Skin of Player] flesh.";
	say "     The nanites ease whatever pain you might have felt, and all too soon, you've reached the hilt on the monster's colossal cock, your mind a haze of lustful urges. 'See? That wasn't so bad. You'd do well as one of us,' the mischievous kobold teases, his hands reaching up to brush across the impression of his monstrous dick[if Nipple Count of Player > 0 and Breast Size of Player > 0] while the other gropes a breast, thumb rubbing roughly against the nipple[else if Breast Size of Player > 0] while the other gropes a breast[end if]. Your only response is a soft moan, followed by a nod. The slow, rhythmic throbbing of his meat within you emolliates whatever fears or trepidations you might have had and replaces them with unfiltered arousal.";
	WaitLineBreak;
	say "     Carefully, you begin to rock above the kobold's lap, looking down in awe at the bulge in your belly and midriff. Your partner shudders at the feeling of your drenched vaginal walls squeezing tightly around his mast, squirming and giving soft bucks from beneath you. 'Mmh, that's the ticket. Just keep going. Let your mind empty out. Good, good...' the well-hung critter murmurs. 'Doesn't that feel nice? Don't you want to feel that every day and every night? Don't you want to be filled with all the wonderful cum you could ever want? So warm, so full... Mmh, of course you do.' Your lust-addled mind can't help but agree with every sexy insinuation as you set a rhythm of bouncing and bucking atop that intensely pleasurable pillar, more than eager to be filled to the brink by your virile latex lover.";
	say "     Soon, you're fucking the koballoon in earnest, your every motion slickened by your wrenching cunt's juices. Your partner hangs his head back and lolls his tongue out as you ride him, burying the entirety of his multi-foot cock into your depths before sliding back up until only the pulsing glans remains within you. Your mind would question how you managed to accept the entirety of the creature's cock if it hadn't already succumbed to the white-hot pleasure coursing through every fiber of your being, moaning in hazy delirium as you slam home against his crotch with wet, squirting squelches.";
	WaitLineBreak;
	say "     Quaking from the constant influx of cervix-spreading stimulation, it's not long before you're forced to bury your face against the mutant's neck to stifle a groan of carnal ecstasy. Fluid gushes wetly from your aching nethers, a maelstrom of feminine nectar that soaks your partner's crotch and drenches his latex prick in your juices. The added sensation is all he needs to unload the contents of his monstrous orbs. Pulse after pulse of hot, sticky seed blast deep into your womb, your tunnel squeezing rhythmically to milk him for all he can give. The koballoon's digits clench firm around your hips as he fills you to distending with a powerful climax that swells your stomach with his output. What little that escapes his cock's snug seal splashes off to the side in a growing puddle of rubbery seed. Your every shallow breath treated to the miasma of sex, you eventually collapse in a well-fucked heap atop the creature, his gargantuan shaft still buried to the hilt in your overfilled depths as his hands stroke over your form. Seconds fade to minutes in this peaceful, soothing afterglow, and soon, you lapse into a deep and restful slumber, completely at ease in the arms of this strange, virile creature.";
	say "     Coming to an uncertain time later, the koballoon is nowhere to be seen. Instead, you find yourself lying in a pool of tainted seed, drenched in your erstwhile lover's cum. You do your best to clean yourself off, shuddering at the grim realization that your labial lips have still not fully recovered from the unnatural penetration. You find yourself hoping to have another go at the odd little mutant soon, and you absently stroke your gaping entrance, even wriggling your fingers into the cum-sullied depths to probe your elastic walls. The warmth in your womb lingers pleasantly, making you tingle now and then as you redress and set off.[fimpregchance]";

to say KoballoonBeaten4: [Player receiving cunnilingus from the koballoon]
	say "     Deciding to put the creature's pouty face to good use, you stroll up to its front and begin to undress. The kobold's eyes widen at your forward approach, tongue flicking curiously across its rubbery muzzle. Once you've strewn aside your gear, you bowl the well-endowed mutant over with a decisive push of the foot, making him groan in pleasure and discomfort. You kneel down on top of its head, careful to avoid its nubby little horns, then reach below to part your petals and present the juicy folds within. 'If that's all you wanted, why didn't you just ask please?' the fun-sized kobold mutters, its thick reptilian tail flicking to and fro as he basks in your fertile aroma.";
	say "     Not wanting to be kept waiting, you lower your weight down atop the impish beast's muzzle, earning a muffled groan. He concedes without a word, his long, draconic tongue extending to lap wetly across your flesh. Its warm, slightly bumpy texture proves as soothing as it is arousing, drawing a pleasured sigh from your lips as your thighs sag further apart around the koballoon's smooth muzzle. Your hands find themselves settling on the mutant's massive balls, using the sleek expanse as support while you rock your hips around his slippery, wriggling tongue, yearning to take more of that dexterous muscle within you. Your feral lover even tilts his muzzle to attack your g-spot directly, his grubby rubber claws finding purchase in your hips to pull you firm against his ravenous feasting.";
	WaitLineBreak;
	say "     Pleasure begins to erode whatever will to resist this alien pleasure you might have had, your body growing slack as you relinquish control to the koballoon and his wonderful latex tongue. The mouthwatering scent of male musk wafts over you from his hard and twitching member, its pre-slick expanse drawing your eyes as you gyrate weakly atop your partner below. His arousing aroma overwhelms your inhibitions, and you can't help but dip down your head to lick along the slippery crevice between the base of his cock and those huge, supple orbs, breathing in more of that exciting reptilian musk as he tongue-fucks your clenching depths. The taste of his blemish-free dick clings to your palate, corrupting your every breath with more of his intoxicating essence.";
	say "     All of a sudden, the koballoon leans back, leaving a cruel emptiness in your muff that aches to be filled once more. You moan wetly against his towering cock, desperate for your release by this point, only to feel those slender latex lips seal around your clit in a lewd, forceful kiss, tongue grinding roughly against that flaring nub. Bliss blossoms through your body, only amplified by the nimble digits being pushed into your slavering pussy, jilling you mercilessly with curling, sweeping, and finally thrusting motions, attacking the spots his tongue mapped out all at once. You can only drool across the smooth latex flesh of the koballoon's cock, feeling his balls churn below as you writhe and shudder helplessly around the mutant's masterful ministrations.";
	WaitLineBreak;
	say "     Being violated by the playful little creature, it's only a matter of time before an earthshaking climax wracks your tensing body. You groan into the kobold's beach ball-sized orbs as jolts of pleasure ripple and arc within your overextended body, eventually leaving you bucking and drooling weakly as he chains your euphoric high into myriad little successive peaks, each met with another wet squirt around the mutant's pumping fingers. Soon, the pleasure makes you collapse in a well-fucked heap over your talented partner, labored breath interspersed only with the odd moan and curse as the sensation lingers. 'See, that wasn't so bad now, was it?' the koballoon asks slyly, drawing a claw-tipped digit from your depths to sensually suckle. A teasing little lick of your clit draws another breathless moan from you before your strength gives out entirely, slumping limply atop him.";
	say "     Reduced to placid passivity, it's all too easy for the oversexed kobold to roll you onto your back, panting and groping yourself as your vision blurs. You lazily fish a finger inside of your damp, dripping passage, eyes rolled back into your head. Your back arches as you feel echoes of bliss where this monster's tongue once swept, nanite-laced saliva tingling insistently along your clenching inner walls. 'See you later for seconds, sweetie,' the playful kobold says slyly, sounding arrogantly sure of himself, before he happily hops away on his titanic pair of testicles, leaving only the sticky puddle of femcum beneath your thighs to remember him by.";

to say KoballoonBeaten5: [Player riding the koballoon anally]
	say "     That towering ramrod of flesh couldn't possibly fit inside of your rear... could it? Curious to find out, you tentatively release the kobold from your iron grasp, allowing the little creature to scramble up on his rear with an annoyed look in his eyes. 'Well, what's the hold up?' he asks brusquely, thick rubber tail thrashing about. He watches you undress as he rests on his oversized scrotum, the cushy padding of his rear perfectly suited for that sumptuous seat. Throwing your last article of clothing aside, you step closer to the impatient mutant and sidle up in his lap, leaning in close to part his muzzle in a sheepish, horny kiss. His torso-length pole is wedged between your yearning bodies as you make out with the diminutive male, slickly smearing its pre-coated heft against your abdomen and chest.";
	say "     'How about a taste?' the koballoon teases, and before you can respond, his pre-drooling glans is forced between your parted lips with a short, hard buck. His musky flavor spreads across your palate, and soon, you feel your entire body go slack in submission to that strong, virile aroma. You moan around the girth, your cheeks bulging around that impossibly huge intrusion, then begin to suckle on the leaky, flaring tip, tongue flitting beneath its stretchy foreskin to chase after more of the exotic mixture of musk and sterile synthetics. He permits you this luxury for mere moments before a scrawny arm reaches up to pry your head back, making you gasp for breath as you watch your partner with half-lidded eyes. 'I'm going to enjoy making you mine,' the kobold murmurs with lust burning in his voice.";
	WaitLineBreak;
	say "     Leaning in close to share another firm, albeit brief, kiss with you, the kobold slides his smooth little hands down to squeeze your hips, making you squirm at the prospect of being his well-fucked plaything. He spins you around and pulls you back, letting that hard, pulsing length press up against the curve of your spine. It would be imposing if you weren't so dead-set on taking that monstrous member in your aching rear end, chest heaving with mounting excitement. Surprisingly strong for his size, the mutant's digits splay as he hefts you upward, drooling glans smearing his pre in a snaking line down the arch of your back. Soon, you feel your naked, [Skin of Player] buns cradling his slippery cockhead, anus clenching tight as his domed tip presses against your too-small rim. Pressure mounting as the big-dicked koballoon grinds you down atop his massive spire, you try in vain to find some kind of stable foothold atop his squeaky latex flesh, but it's no use - you'll have to relax and let him skewer you at his own pace.";
	say "     At first, you fear that this will prove a fruitless endeavor, your pre-smeared flesh seeming to glide right off of that immaculate rubber glans, but the more you allow him to handle your desperately needy body, the more your anus relaxes to spread for that colossal kobold cock. Taking a deep breath of the musk-laced air, you release it all again with a soft, feeble moan, finally feeling your wringing rectum give as you exhale, the domed tip slowly gliding into your quivering asshole. Even with your ass spread to distention, every inch of sordid cockflesh proves a challenge for your unprepared body, only able to tremble and groan as you're lowered over his pulsing prick like a too-tight cocksleeve. The kobold leans in to lick wetly at your spine, his cool, smooth tongue and sweltering breath only enhancing the experience. Eventually, after what feels like an eternity of wrestling your internal organs aside, you feel the spread cheeks of your buns grind down against your ample lover's waist, his paws wrapping around you to caress the prominent bulge running all the way from your pelvis to your chest. His sleek claw's touch is remarkably tender as he relishes the moment, sliding over the pronounced, rhythmic flare of his crown through your stretched flesh and the subtly veinous impression below, every little ticklish stroke sending sparks of arousal through your obscenely overstuffed form.";
	WaitLineBreak;
	say "     Bloated beyond any reasonable capacity, you can only emit feeble, yet intensely pleasured moans as the kobold's hands lift you up again, your asshole reflexively clenching around his man-splitting mast. With your anal rim squeezing jealously around the parting pillar of flesh, his ample pre proves cold comfort to the intense heat of friction inside of you, the latex doing little to ameliorate the white-hot ascent. You're guided up by the kobold's smooth, groping hands until only the uncut head of his cock remains within you, every sluggish throb against your anal lining visible in your bloated abdomen. Gravity guides you back down this time, the deep, profoundly filling penetration seeming blissfully easy compared to your earlier struggles. Resting, hilted, in the corrupted kobold's lap again, you give in completely to these powerful sensations, the pre-slickened squelches of his short, tense thrusts met with gurgling moans of euphoric delight.";
	say "     You feel your internal organs being pushed aside to make more room for his massive spire, filling you impossibly full as you bounce in his lap. The elastic scrotum below allows the kobold to push back into your deepest reaches on every rebound. Short of breath, you're forced to gasp between moans as his grasp holds you firm, cinching you tight against his lap in a relentless pursuit of pleasure. The brutal treatment leaves your insides aching, raw nerves only pronouncing the pleasure this virile mutant brings. Your snug, gripping walls strain to contain the sheer volume of latex dick cleaving you apart, but you're far too gone to care, only lusting to be fucked and filled by the virile koballoon as your tract is spread into a wide, hollow chasm of sore, sensitive flesh.";
	WaitLineBreak;
	say "     Being fucked without pause by the energetic mutant, you eventually lose track of time, focused only the inhuman bliss this twisted toy provides. You lapse into a haze of wanton desires, weakly cupping your stomach to palpate the undulating bulge beneath your stretched flesh. At first, you try to keep count of how many times the little creature drives you over the edge, but even that fades into the miasma of frenzied fucking as your colon's violated over and over, an unending procession of sharply pronounced pleasure that your lust-fogged mind wishes would simply last forever. Your vision blurs from the lack of oxygen and overload of sexual stimuli, and you can only release dazed, breathy moans as you bounce on that gargantuan rubber dick, beginning to feel just as empty and airheaded as the mutant that's fucking you.";
	say "     At last, the koballoon reaches his peak, his muzzle slung to the sky as he screams in orgasmic delight. His rubbery cum blasts inside of you in a constant deluge of tainted fluid, the pressure of all that backed-up seed forcing the wind from your lungs as it fills what little room is left in your aching tract. What doesn't dome your stomach spills out from your mouth, streams of dark, thick cum trickling down across your chin, throat and [if Breast Size of Player > 0]breasts[else]chest[end if] as you gurgle in absent ecstasy. You sink back against your virile lover, letting his cool tongue draw sweeps across your shoulders as you're filled beyond any logical limits, a seemingly endless stream of nanite-enriched cum filling your hollowed-out form. Trembling, speechless, you wait for the flow to trickle and taper, your vision swimming as you drool across your own distended stomach, breathing deeply of the scent of rubber and sex.";
	if humanity of Player < 10: [Bad end]
		say "     You lie there for a good, long while, enjoying the pleasant tenderness with which your feral lover licks and strokes your aching form, his touch only seeming to arouse you all over again in spite of your recent exertions. He eventually lifts you off of his massive cock, and you release an airheaded giggle as you slide into a puddle of rubbery cum, reaching back to finger your gaping fuckhole while you wallow in that sticky fluid, dipping your head down to slurp up as much of it as you can. When you roll onto your back to lick at your cum-slathered fingers, the koballoon creases a smirk and begins to pump his heavy, half-hard cock with both hands, drawing your eyes to its glistening flesh. 'You're ready to accept your fate as one of us, aren't you?' he teases, letting his tongue flick across his lips as you stare up at him. Unthinkingly, you respond with a vacant nod, your tongue lolling out of your mouth as you smear all of that wonderful latex seed across your body. 'That's all that I needed to hear,' the creature rumbles, and without further word, he mounts his trusty sack again and bounces away in springy bounds, leaving you to pleasure yourself while he's away.";
		say "     You wait patiently, contenting yourself with the fantasy of being fucked for all eternity, each passing moment without a thick, sleek cock stuffing your holes making you yearn more and more to be a proper rubber toy that gets passed around and filled like a living condom. Soon enough, the koballoon returns, but he's not alone - the rest of his group are in tow, laughing amongst themselves as they bounce on their mighty ballsacks toward your proffered body. All these sexy creatures, here to welcome you into their fold? Your mind is alight with pride and simple joy as you rise on wobbly feet, still coated in the warm, musky essence of your recent fun. 'Are you sure that they're ready?' one of them asks, bouncing around you with faux-scrutiny as he strokes his ample cock. 'I'm not convinced,' another muses before pulling you back against his turgid length, smearing its slickened rubber flesh across your spine. 'We'll just have to do some penetrative testing,' a third says with bubbly laughter, making you giggle in response as your lungs fill with their combined aroma, a potent promise of sex that you're in no position to refute.";
		WaitLineBreak;
		say "     With the sounds of raucous kobolds coming from all directions, you're manhandled onto all fours for the group to play with. Your broken mind accepts this willingly, spreading your legs and opening your mouth wide. As soon as you do, you feel the smooth hands of a sexy koballoon slide around your neck, his wonderful cock pressed to your lips. You're about to sink your mouth around that huge, domed crown before you're suddenly shoved forward, forcing the massive dick down your throat as another koballoon thrusts harshly into your bowels. You purr around the succulent latex dick in your mouth and squeeze your ass around the ponderous pillar pressed deep inside of your rear, your stretched colon taking that warm, slick spire with ease. Pushing all the way to their hilts, the immaculate cocks frot together in your obscenely stretched passage, their asynchronous throbbing massaging your deepest reaches. Soon, the couple begin to fuck you in earnest, thrusting hard into your corrupted body while kissing each other with loud, lustful moans.";
		say "     When one orgasms, the other's motions are only slickened by the lube-like cum swelling your body. Your partners swap in and out as you're stuffed again and again, brutally fucked by all of these virile, well-endowed creatures. Those recovering from their peaks relish the opportunity to grind their spent dicks across your back or simply fellate each other, many hands and mouths occupied with a variety of colorful lengths that dribble and spurt liberally throughout the orgy. The insatiable kobolds cover you from head to toe in a lather of transformative seed, each fresh deluge only aiding your descent into instinctual feral bliss, corrupting you both mentally and physically. Your mind continues to unravel from the constant, earth-rending pleasure until you're nothing more than a well-filled rubber toy, any semblance of your former self washed away beneath the seemingly endless procession of cock and cum.";
		WaitLineBreak;
		say "[KoballoonSexBadEnd]";
	else: [Humanity is 10 or greater, so avoided the bad end]
		say "     You lie there for a good, long while, enjoying the pleasant tenderness with which your feral lover licks and strokes your aching form, helping you relax from the recent exertions. He eventually slides you off of his massive cock, making you realize just how empty your gaping hole is without him as you lie naked on the floor. He leans over your trembling body to finger your empty rear and whisper how much more fun you'll have once you give in completely, promising endless nights of scintillating pleasure for a fine, obedient plaything. Part of you aches to scramble back into the mutant's lap, to let him fuck you into a stupor until you're nothing more than a happy, horny toy, but you manage to pull yourself together enough to resist the temptation. 'You'll change your tune soon enough,' the koballoon teases, and with that, he mounts his trusty sack again and bounces away in springy bounds, leaving you to slowly gather your bearings and belongings.[mimpregchance]";

to say KoballoonBeaten6: [Player fellating the koballoon]
	say "     You find your gaze drawn to the koballoon's smooth, thick meat and the full, heavy orbs nestled snugly beneath his form. You pull your foot back to maneuver the well-hung creature into position, but as soon as you release him, his fat-assed figure scrambles back atop the bouncy spring of his balls. Fearing that he might be trying to escape, you reach for his tail, but a swift swing of his ponderous pillar swipes your hand away. 'Mmh, so eager! You'll make a fine toy for our gang,' the mutant teases impudently, wrapping both hands around his half-hard cockmeat to maneuver it upright and lick wetly across his pre-drooling glans. That long, slender tongue draws a slavering spiral down his throbbing latex dick, jaw stretching obscenely to fit the flaring crown while half-lidded eyes observe you with mischievous intent. Soon enough, the kobold pulls away again with several spurts of white-streaked pre, nimble hands smearing the fluid across his hard and pulsing spire. He looks back at you with a sultry, sticky smile, crooking a finger to invite you closer and oblige your lewd little lover.";
	say "     Unable to resist your baser urges, you approach the diminutive male and his truly titanic cock. You climb up onto the smaller creature's lap and rest your hands atop his shoulders, taking a firm hold to steady yourself on your wobbly scrotal seat. Positioned as you are, that torso-length shaft rests mere inches from your lips, his masculine aroma wafting over you in mind-numbing waves. The kobold traces circles around his slavering cumslit before two claw-tipped digits spread it wide, flaunting his body's twisted elasticity. A lascivious smirk greets you past the dome of his uncut dick, and the kobold offers, 'Go on. Have a taste,' with lurid promise in his voice. By this point, you find yourself more than eager to wrap your mouth around that massive rubbery dick, his perpetual teasing stimulus eroding any remaining inhibitions.";
	WaitLineBreak;
	say "     A scrawny hand finds its way to the back of your head as your face descends, drawn in against the pre-slick latex flesh below. Your lips part, and your mouth is swiftly filled with the potent, heady aroma of sex and sterile synthetics that swirl together in an exotic concoction, only exciting you further. You wrap your arms around that ponderous pillar and hug it close to your [Skin of Player] form, your jaw straining to take more than an inch of musky manmeat. Your tongue swirls around the mutant's pulsing glans, its tip flitting beneath the flesh of his foreskin to chase after more of that intoxicating flavor, sweeping and curling across sensitive skin. These eager ministrations draw a long, low moan from your corrupted lover, whose grip on your head tenses while he rocks his hips into your welcoming maw. Spurts of rubbery pre wash over your palate throughout, a delicious treat of transformative fluid that you happily gulp down in your lust-addled state.";
	say "     Those steady rolls transition into short, firm bucks as your partner grows increasingly excited, impatiently pumping his thick, throbbing dick down the clenching tube of your throat. At first, you struggle to accept the battering rams of his colossal cock, each thrust met with a surge of dull pain that makes you groan around his member. After enough of the brutal treatment, however, your body begins to grow used to the kobold's rough, incessant motions, throat going slack and jaw unhinging to take more of that wonderful rubber cock into your body, your head skewered atop that inhumanly huge prick while wet, gurgling moans sound out around his musky manmeat. A hand strays down to tickle the underside of your lover's monstrous cock while the other palpates the bulge of his dick in your throat, every vein and pulse felt through the stretched flesh of your increasingly distended form, your hazy mind taking perverse enjoyment in the ways your body bloats to accommodate him.";
	WaitLineBreak;
	say "     As more and more of that warm, wet ramrod of latexified flesh slides down your gullet, the bewildering question of how such a massive length could even fit inside your form is replaced by a burning animal lust that only this handsome koballoon and his wonderful cock can sate. Your lips form a snug, squeezing seal while your tongue sweeps and lashes in its cramped confines, doing what little you can to service your hyper-endowed partner as he fucks your face with unrelenting zeal. You feel a sudden pressure around your legs, only to balk in surprise when the playful kobold pulls you upside down, letting gravity aid him with every firm thrust down your stretched and straining throat. The rush of blood to your head only compounds your already debilitating lusts, reducing you to feeble, helpless moans as you're drawn closer and closer to the hilt of the mutant's inhumanly large maleness. Your vision begins to grow dark, both from your fading consciousness and the impression of the creature's figure blotting out the light around you.";
	say "     When your lips kiss the kobold's crotch, you can only drool around the profoundly filling cock splitting you open, the full pungency of its aroma assaulting your senses. Your legs rest limply atop the mutant's shoulders, his claw-tipped digits stroking teasingly along your inner thighs as you're left to suckle and salivate on that burgeoning log of dick, wanting nothing more than to stay here for hours on end as the kobold's lustful plaything. 'There, there,' the creature chides with a voice drenched in malice. 'Just let go of those petty human thoughts and enjoy this. You'll be one of us, soon enough.' His long, sleek tongue rolls wetly from his muzzle, that saliva-slick muscle brushing deftly across your inner thighs. It then snakes closer to your pelvis, flicking and curling in a gesture that's just as much teasing you as it is tasting you. 'Empty your mind, and let us fill you instead,' the kobold all but whispers as his dexterous tongue glides across the sensitive rim of your anus, its tip circling your wanton star in gentle, deliberate motions that relax your clenching sphincter. Hot breaths sear your skin in scintillating waves, your eyes shuttering closed as his dull rubber teeth nibble lustfully on your rear.";
	WaitLineBreak;
	say "     Without warning, the kobold buries the elongated mass of his tongue into your yearning asshole, dragging the smooth taper of his slick, warm muscle across your anal lining. You tense at the sensation of his skillful ministrations, that dexterous tonguework lashing and grinding inside of your yearning depths, smearing his transformative saliva across every sensitive nerve. His rubber muzzle kisses your tongue-stretched rim, hot breath pouring into your spread confines to wash over your spit-soaked walls and leave them awash in a flash-fire of tingling bliss. You'd writhe around his experienced touch, but the massive lance buried deep within you prevents much more than wet, gurgling moans around his supple latex cockflesh. Eyes rolling back into your head, you give in completely to the ethereal pleasure coursing through every inch of your well-fucked body, savoring the mutant's ravenous exploration on your unresisting colon and the fullness of that fat, pulsing dick buried inside of you.";
	say "     Just when you think that you're about to pass out from a lack of oxygen and the overwhelming bliss of being used like a toy, your lover surprises you with several hard, urgent thrusts into your lust-addled body, ramming his hips against your face with renewed vigor while eating out your ass without pause or mercy. The kobold's frenzied fucking beleaguers your already weary mind, and you drool absently atop his shiny lap while he prods at your innermost reaches, navigating your rippling insides with practiced expertise. Several rugged, arrhythmic thrusts follow, and with a scream that's muffled between the cheeks of your ass, the mutant unloads the contents of his balls within you, blasting a veritable deluge of cum into your overstimulated body, each fresh jet sending sparks of ecstasy through your form. Your stomach swells from the kobold's prodigious output, warmth suffusing your insides with every primordial throb of that heavy latex dick. It seems like the maelstrom of cum will never end, stuffing and bloating your overfilled colon with rope after rope of tainted alabaster seed. At last, the flow begins to ebb, and you sag limply atop his skewering spire, basking in the blanketing bliss of the afterglow while your well-hung partner slowly sweeps his tongue across your clenching anal walls.";
	WaitLineBreak;
	say "     You rest there for a while, spent and satisfied from your recent exertions. You lick and nibble along the base of his titanic dick, goading strained throbs from the creature while his hands squeeze and grope your unresisting body. You breathe deeply of his heady reptilian musks, the potent aphrodisiac keeping you at a constant baseline of arousal. You lose yourself in a daydream of being stretched and deformed by these sexy, exotic creatures, passed around from one to the next as cum splatters wetly from your greedy, wringing holes. It takes all of your willpower to not beg for more when your lover's tongue slides free of your asshole, leaving a cool, empty void in its wake that aches to be filled by his ravenous ministrations.";
	say "     Eventually, the koballoon tires of your idle revelry and pushes you off of his monstrously oversized member, letting you slide to the ground with a wet splat as you shiver and squirm with powerful aftershocks of pleasure. 'That was fun! Maybe we'll turn you into a proper toy yet,' the little guy teases with a lustful, predatory grin, a hand sliding across his cum-slick spire while his tail thrashes about behind him. Then, the diminutive creature saddles up again and bounces away on his trusty sack, giving you precious time to rise and recuperate before another fairground feral can fuck you into mindless oblivion.";

to say KoballoonSexBadEnd:
	say "     When you finally come to countless hours later, you stir against the slick rubber bodies that surround you from all sides. The koballoons welcome you with lustful gropes and grinding, pleasing you with their smooth and practiced touch. Catching a glimpse of yourself in a reflective pool of cum, you realize through your dim, hazy thoughts that you've been transformed while you were being passed around, now a ";
	if mdasslevel > 0:
		say "[if Breast Size of Player > 0]perfect[else]similar[end if] rubber counterpart to the nine-foot tall drake that you've met in the city, complete with ";
	else:
		say "twisted facsimile of a nine-foot tall drake, your ";
	say "[if Breast Size of Player > 0]heavy, swollen breasts and [end if]ample curves wrapped in a flawless expanse of jade-green rubber. ";
	if "Herm Preferred" is listed in feats of Player:
		say "Your [if Cock Count of Player > 1]cocks have become truly monstrous, sleek green pillars that give several hard, slow throbs as they leak[else]cock has become truly monstrous, a sleek green pillar that gives several hard, slow throbs as it leaks[end if] lube-like pre onto the ground below. Your cunt[sfn] constantly drool[sfv] a warm, odorless lubricant, the runny liquid trickling down your inner thighs.";
	else if "Female Preferred" is listed in feats of Player:
		say "Your cunt[sfn] constantly drool[sfv] a cool, odorless lubricant, the runny liquid trickling down your inner thighs.";
	else if Player is male:
		say "Your [if Cock Count of Player > 1]cocks have[else]cock has[end if] become truly monstrous, [if Cock Count of Player > 1]sleek green pillars that give several hard, slow throbs as they leak[else]a sleek green pillar that gives several hard, slow throbs as it leaks[end if] lube-like pre onto the ground below.";
	else if Player is female:
		say "Your cunt[sfn] seem[sfv] to have vanished, replaced by a sleek green pillar of a cock that gives several hard, slow throbs as it leaks lube-like pre onto the ground below.";
	else:
		say "You've also grown a monstrous cock, a sleek green pillar that gives several hard, slow throbs as it leaks lube-like pre onto the ground below.";
	if Player is submissive: [Bad end for players with the submissive perk]
		say "     Yet, in spite of your larger stature, you just can't find yourself taking the dominant role over all of these sexy rubber creatures. Your hesitation does not go unnoticed, a lustful lizard maneuvering behind you to frot his thick, dripping dick against your backside, slickly smearing his pre-cum across your latex flesh. Your knees begin to shake as the diminutive mutant aligns his cockhead with your flexing rim, your aching entrance longing for nothing more than to take that monstrous phallus within you. He savors the moment, taking hold of that fat log of dick to encircle your clenching hole, slow pulses of tainted seed slathering your rear in his essence. Unable to resist your strong submissive urges, you break down completely and beg the kobold to fuck you, your slutty ass seizing with unrestrained desire.";
		say "     As if on command, the creature sinks his heavy cock inside of you in one long, unbroken stroke. More and more of that massive rubber dong fills your gripping bowels until his hips clap wetly against your rear. Huge as you may be, that pulsing pillar proves sufficiently stuffing, stretching you around its smooth, slick flesh and leaving a visible impression in your belly. You shiver helplessly around that supple skewer, pushing back with a long, low moan for more. Soon, the kobold's sliding back and forth along your sensitive anal lining, his hands groping the pliant buns of your rear while his long tongue slithers across your spine. Lost in the hazy delights of sex, you readily accept another presented cock into your mouth, your own large, tapered tongue drawing a sensual spiral down its impressive length while you lick and suck on your tasty treat. Your thick, draconic tail instinctively fills a third koballoon's asshole, the writhing protrusion burying deep inside of the horny mutant's sphincter. ";
		if Player is herm:
			say "Your ass is reamed, your face is rammed, your cunt[sfn] [isfv] claimed, and your cock[smn] [ismv] pumped ";
		else if Player is male:
			say "Your ass is reamed, your face is rammed, and your cock[smn] [ismv] pumped ";
		else:
			say "Your ass is reamed, your face is rammed, and your cunt[sfn] [isfv] claimed ";
		say "through countless powerful peaks, each orgasm more amazing than the last, your weary body struggling to stay conscious amidst this parade of primal pleasure.";
		say "     You continue to be passed around for what feels like hours on end, completely obliterating any last traces of your former humanity and cementing your new lease in life. By the time you collectively tire of your orgiastic frenzy, the area has been drenched in a pool of sticky white goop, several of the kobolds splashing in the mess without a care in the world. You can only smile vacantly for a moment, fingering your gaping ";
		if Player is female:
			say "cunt[sfn] and asshole[if Breast Size of Player > 0] while groping your heavy breasts[end if]";
		else:
			say "asshole[if Breast Size of Player > 0] and groping your heavy breasts[end if]";
		say ", daydreaming of your bright new future as a sex-crazed slut. When the koballoons set out in search of fresh meat, you follow your new masters without hesitation, all too happy to assist them in whatever way they please.";
		now KoballoonSexBadEnd is 1;
		now BodyName of Player is "Rubber Drake";
		now humanity of Player is 0;
		end the story saying "You have given in to the koballoons and become a Rubber Drake sextoy, serving as their eternal plaything.";
	else: [Bad end for players without the submissive perk]
		say "     After a brief bit of foreplay, the group descends into a whirlwind of squeaky, messy sex. Your broken mind quickly realizes its place as their leader, a grin spreading across your draconic muzzle as a cute blue [']bold licks obediently at your ";
		if Player is male:
			say "balls. You twist him around without thinking and sheathe your massive spire inside of your familiar's asshole, stuffing that squirming male almost all the way through";
		else:
			say "slit[sfn]. You push him down without thinking and straddle his lap, driving that ponderous cock deep within the stretchy vise of your folds";
		say ". You capture another nearby toy and hook a pair of digits inside of his stretchy tailhole, rubbing vigorously at his prostate. When he moans for more, you curl your hand into a ball to fist the poor thing, driving him to a loud and messy orgasm. Once spent, you order the still-shaking koballoon to eat out your asshole while you set to fucking the first one in earnest, that long red tongue sweeping expertly across your rear. He laps at your sensitive rim, then presses his tongue deep inside of your elastic tunnel, exploring your anal lining with ravenous hunger. Those skillful strokes keep you ";
		if Player is male:
			say "rock hard in your azure-blue lover, and a deft lash against just the right spot drives you over the edge, erupting with a torrential outpour of tainted cum, much of it spilling out from the submissive toy's maw as he gurgles and moans for more, so excited to be of service to his [if Breast Size of Player > 0]mistress[else]master[end if].";
		else:
			say "squirting around your azure-blue kobold's length, and a deft lash against just the right spot drives you over the edge, your femcum splattering wetly over your lover's bucking loins. As your folds squeeze around his maleness, the koballoon shivers and climaxes, his rubbery seed rushing deep into your womb.";
		say "     You continue to swap partners for what feels like hours on end, cementing your new lease in life as the leader for these playful mutants. By the time you collectively tire of your fucking frenzy, the area has been drenched in a pool of sticky white goop, several of your underlings splashing in the mess without a care in the world. You can only smile vacantly for a moment, stroking your massive cock and groping your heavy breasts, before your new instincts direct you forward. You lead your group away in search of more fresh meat to conquer and convert, a constant urge to expand your ranks that only grows with each new member.";
		now KoballoonSexBadEnd is 2;
		now BodyName of Player is "Rubber Drake";
		now humanity of Player is 0;
		end the story saying "You have given in to the koballoons and become their Rubber Drake leader.";

Section 2 - Creature Insertion

Table of Random Critters (continued)
NewTypeInfection (truth state)	Species Name	Name	Enemy Title	Enemy Name	Enemy Type	Attack	Defeated	Victory	Desc	Face	Body	Skin	Tail	Cock	Face Change	Body Change	Skin Change	Ass Change	Cock Change	str	dex	sta	per	int	cha	sex	HP	lev	wdam	area	Cock Count	Cock Length	Ball Size	Nipple Count	Breast Size	Male Breast Size	Cunt Count	Cunt Depth	Cunt Tightness	Libido	Loot	Lootchance	Scale (number)	Body Descriptor (text)	Type (text)	Magic (truth state)	Resbypass (truth state)	non-infectious (truth state)	Cross-Infection (text)	DayCycle	Altcombat (text)	BannedStatus (truth state)
--	--	--	--	--	--	--	--	--	--	--	--	--	--	--	--	--	--	--	--	--	--	--	--	--	--	--	--	--	--	--	--	--	--	--	--	--	--	--	--	--	--	--	--	--	--	--	--	--	--	--;

When Play begins:
	Choose a blank row from Table of Random Critters;
	now NewTypeInfection entry is false;
	now Species Name entry is ""; [name of the overall species of the infection, used for children, ...]
	add "Koballoon" to infections of ReptileList;
	add "Koballoon" to infections of HumorousList;
	add "Koballoon" to infections of FurryList;
	add "Koballoon" to infections of LatexList;
	add "Koballoon" to infections of MaleList;
	add "Koballoon" to infections of BipedalList;
	add "Koballoon" to infections of TailList;
	add "Koballoon" to infections of TailweaponList;
	now Name entry is "Koballoon"; [ Infection/Creature name. Capitalized. ]
	now enemy title entry is ""; [name of the encountered creature at combat start - Example: "You run into a giant collie." instead of using "Smooth Collie Shemale" infection name]
	now enemy Name entry is ""; [specific name of unique enemy]
	now enemy type entry is 0; [0 = non unique enemy; 1 = unique (unknown name); 2 = unique (known name) | Used to disqualify unique enemies from Vore/UB and showing the enemy name in encounters]
	now attack entry is "[one of]One of the koballoons bounces up behind you swings his mighty cock, knocking you over![or]Disoriented by the koballoons['] constant bouncing, you're caught off-guard by one of them tackling you from the side![or]One of the twisted kobolds strokes its cock until unloading with a loud moan. You barely dodge the blast, only to be caught in the arms of another latex creature and pushed back and forth between their ranks for a while.[or]A koballoon spins as it bounces and laughs. His massive, swinging prick slams against your chest, nearly knocking the wind of you![or]The koballoons push and shove at you while laughing at your predicament. You're left feeling dizzy and disoriented by their playful assault![or]One of the over-endowed kobolds manages to grapple you, holding you tightly to his fore as he bounces around energetically, his massive cock rubbing against your back all the while. By the time he releases you, you're left slick with his lube-like pre, your will to fight faltering.[or]Growing dizzy in the flurry of movements, a koballoon seizes the opportunity to bounce behind you and wrap his arms around your midriff. He grinds his stiff cock against your back, smearing his heady pre into your flesh and nibbling on your neck. After having his fun, you're passed between several other lustful kobolds, who grope and play with you until you finally wrench free.[at random]"; [ Successful attack message ]
	now defeated entry is "[BeatTheKoballoon]";
	now victory entry is "[LoseToKoballoon]";
	now desc entry is "[KoballoonDesc]";
	now face entry is "non-infectious";
	now body entry is "non-infectious";
	now skin entry is "non-infectious";
	now tail entry is "non-infectious.";
	now cock entry is "non-infectious";
	now face change entry is "non-infectious";
	now body change entry is "non-infectious";
	now skin change entry is "non-infectious";
	now ass change entry is "non-infectious";
	now cock change entry is "non-infectious";
	now str entry is 9; [ These are now the creature's stats... ]
	now dex entry is 15; [ ...and are only altered onto the player via Shifting or the Mighty Mutation feat ]
	now sta entry is 12; [ These values may be used as part of alternate combat. ]
	now per entry is 16;
	now int entry is 16;
	now cha entry is 8;
	now sex entry is "Male"; [ Infection will move the player towards this gender. Current: 'Male' 'Female' 'Both' ]
	now HP entry is 85; [ The monster's starting HP. ]
	now lev entry is 7; [ Monster level. (Level x 2) XP for victory. (Level / 2) XP for losing. ]
	now wdam entry is 5; [ Monster's average damage when attacking. ]
	now area entry is "Fair"; [ "Outside" "Mall" "Park" "Beach" etc... Check an existing creature in the area. ]
	now Cock Count entry is 1; [ Number of cocks the infection will try to cause if sex entry is 'Male' or 'Both'. ]
	now Cock Length entry is 12; [ Length in inches infection will make cock grow to if cocks. ]
	now Ball Size entry is 2; [ Cock width, more commonly used for ball size. ]
	now Nipple Count entry is 2; [ Number of nipples the infection will give a player. ]
	now Breast Size entry is 10; [ Size of breasts the infection will try to attain (corresponds to letter cup size). ]
	now Male Breast Size entry is 10; [ Breast size for if Sex="Male", usually zero. ]
	now Cunt Count entry is 0; [ The number of cunts the infection will try to cause if sex entry is 'Female' or 'Both'. ]
	now Cunt Depth entry is 0; [penetratable length in inches; some minor stretching allowed, or more with Twisted Capacity]
	now Cunt Tightness entry is 0; [size 1-5, generates adjectives of extremely tight/tight/receptive/open/gaping]
	now libido entry is 65; [ Target libido the infection will rise towards. ]
	now loot entry is ""; [ Dropped item, blank for none. Case sensitive. ]
	now lootchance entry is 0; [ Percentage chance of dropping loot, from 0-100. ]
	now scale entry is 2;
	now body descriptor entry is "[one of]plump[or]pudgy[or]rubbery[or]inflatable[or]curvaceous[or]girly[or]feminine[at random]";
	now type entry is "[one of]draconic[or]inflatable[or]kobold[at random]";
	now magic entry is true;
	now resbypass entry is false;
	now non-infectious entry is true;
	now Cross-Infection entry is ""; [infection that this infection will give the player when they lose; can be left empty if they infect with the monster's own]
	now DayCycle entry is 0;
	now altcombat entry is "default";
	now BannedStatus entry is false;

[
Table of New Infection Parts (continued)
Species Name	Name	Body Weight	Body Definition	Androginity	Head Change	Head Description	Head Adjective	Head Skin Adjective	Head Color	Head Adornments	Hair Length	Hair Shape	Hair Color	Hair Style	Beard Style	Body Hair Length	Eye Color	Eye Adjective	Mouth Length	Mouth Circumference	Tongue Adjective	Tongue Color	Tongue Length	Torso Change	Torso Description	Torso Adjective	Torso Skin Adjective	Torso Adornments	Torso Color	Torso Pattern	Breast Adjective	Breast Size	Male Breast Size	Nipple Count	Nipple Color	Nipple Shape	Back Change	Back Adornments	Back Skin Adjective	Back Color	Arms Change	Arms Description	Arms Skin Adjective	Arms Color	Locomotion	Legs Change	Legs Description	Legs Skin Adjective	Legs Color	Ass Change	Ass Description	Ass Skin Adjective	Ass Color	Ass Width	Tail Change	Tail Description	tail skin adjective	Tail Color	Asshole Depth	Asshole Tightness	Asshole Color	Cock Change	Cock Description	Cock Adjective	Cock Color	Cock Count	Cock Girth	Cock Length	Ball Description	Ball Count	Ball Size	Cunt Change	Cunt Description	Cunt Adjective	Cunt Color	Cunt Count	Cunt Depth	Cunt Tightness	Clit Size
--	--	--	--	--	--	--	--	--	--	--	--	--	--	--	--	--	--	--	--	--	--	--	--	--	--	--	--	--	--	--	--	--	--	--	--	--	--	--	--	--	--	--	--	--	--	--	--	--	--	--	--	--	--	--	--	--	--	--	--	--	--	--	--	--	--	--	--	--	--	--	--	--	--	--	--	--	--	--;

When Play begins:
	Choose a blank row from Table of New Infection Parts;
	now Species Name entry is ""; [name of the overall species of the infection, used for children, ...]
	now Name entry is ""; [matching infection name to Table of Random Critters]
	now Body Weight entry is 5; [scale of 1-9 for body weight, grouped into low weight (1-3), mid weight (4-6) and high weight (7-9)]
	now Body Definition entry is 5; [scale of 1-9 for body definition, grouped into low muscle (1-3), mid muscle (4-6), high muscle (7-9)]
	[Body Adjective is generated out of the body weight and body definition and can be used in scenes - one word descriptive adjective depending on weight and definition groups: low weight group: skinny/slender/lithe; mid weight group: average/fit/muscled; high weight group: pudgy/husky/jacked]
	now Androginity entry is 5; [1-9 scale of hypermasculine to hyperfeminine]
	[Gender Adjective is generated out of androginity 1-9: hypermasculine/masculine/effeminate/somewhat effeminate/androgynous/feminine butch/tomboyish/feminine/hyperfeminine]
	now Head Change entry is ""; [partial sentence that fits in: "Your head and face [one of]tingle[or]go flush[or]vibrate with odd pleasure[or]go cold[or]feel oily[at random] as [head change entry]."]
	now Head Description entry is ""; [partial sentence that fits in "Your face and head resemble that of [Head Description of Player]. You have [Eye Adjective of Player], [Eye Color of Player] eyes and an overall [Gender Adjective of Player] appearance."]
	now Head Adjective entry is ""; [one word descriptive adjective (avian/canine/...)]
	now Head Skin Adjective entry is ""; [one word descriptive adjective]
	now Head Color entry is ""; [single word color adjective for the dominant color of the skin/fur/feathers/scales]
	now Head Adornments entry is "";[partial sentence that fits in "Before moving on from your head, you give your [head adornments of Player] a proud glance followed by a light caress."]
	now Hair Length entry is 2; [hair length in inches]
	now Hair Shape entry is ""; [one word shape descriptor (curly/straight/...)]
	now Hair Color entry is ""; [one word color descriptor]
	now Hair Style entry is ""; [one word style descriptor (ponytail/mohawk/buzzcut/...) to fit "On top of your head you have [Hair Length of Player] inch long, [Hair Shape of Player] [Hair Color of Player] hair in the [Hair Style of Player] style."]
	now Beard Style entry is ""; [short beard style (goatee/3-day stubble beard/porn stache/mutton chops beard/...) to go into "You have a [Hair Color of Player] [Beard Style of Player]."]
	now Body Hair Length entry is 0; [numerical value, 0-4 (no body hair/light/moderate/heavy/furry) - only set to > 0 if the infection does not have fur/scales/etc. !]
	now Eye Color entry is ""; [one word color descriptor]
	now Eye Adjective entry is ""; [one word descriptive adjective (slitted/round/...)]
	now Mouth Length entry is 3; [inches deep for face fucking; maximum possible will be double this number (when deep throating)]
	[Mouth Length Adjective is generated by a function and can be used in scenes too - "petite, shallow, average, deep, bottomless"]
	now Mouth Circumference entry is 3; [mouth circumference 1-5, see Mouth Circumference Adjective]
	[Mouth Circumference Adjective is generated by a function and can be used in scenes too - "tiny, small, normal, wide, gaping"]
	now Tongue Adjective entry is ""; [one word descriptive adjective (wide/slobbery/...)]
	now Tongue Color entry is ""; [one word color descriptor]
	now Tongue Length entry is 3; [length in inches]
	now Torso Change entry is ""; [partial sentence that fits in: "Your torso [one of]tingles[or]goes flush[or]vibrates with odd pleasure[or]goes cold[or]feels oily[at random] as [Torso Change entry]."]
	now Torso Description entry is ""; [partial sentence, fitting in "Looking down at yourself, you appear [Gender Adjective of Player] with a [Body Adjective of Player] build. Your torso is [Torso Description of Player][if Body Hair Length of Player > 1], covered in [Torso Color of Player] skin and [Body Hair Description of Player][else if Body Hair Length of Player is 1], covered in smooth, [Torso Color of Player] skin[end if]."]
	now Torso Adjective entry is ""; [one word descriptive adjective (avian/canine/...)]
	now Torso Adornments entry is ""; [(pouch/udders/...); partial sentence to fit: "You take a moment to feel your [torso adornments of Player]."]
	now Torso Skin Adjective entry is ""; [one word adjective (feathered/furred/scaly/...); EMPTY "" for creatures with just skin]
	now Torso Color entry is ""; [single word color adjective for the dominant color of the skin/fur/feathers/scales]
	now Torso Pattern entry is ""; [single word color adjective for the dominant pattern of the skin/fur/feathers/scales]
	now Breast Adjective entry is ""; [adjective(s) example: round, pointy, perky, saggy, bouncy. This would serve as either a general appearance of a infections breasts or possibly something that may be effected by a item or NPC.]
	now Breast Size entry is 0; [cup size as number, counting Flat Pecs = 0, A = 1, B = 2, ...]
	now Male Breast Size entry is 0; [cup size as number, counting Flat Pecs = 0, A = 1, B = 2, ...]
	now Nipple Count entry is 2; [count of nipples]
	now Nipple Color entry is ""; [one word color descriptor]
	now Nipple Shape entry is ""; [shape example: any shape will do as long as it has a baseline with a current infection or item]
	now Back Change entry is ""; [partial sentence that fits in: "Your back [one of]tingles[or]goes flush[or]vibrates with odd pleasure[or]goes cold[or]feels oily[at random] as [Back Change entry]."]
	now Back Adornments entry is ""; [partial sentence to fit: "Your back tickles with the feeling of movement caused by [back adornments of Player]."]
	now Back Skin Adjective entry is ""; [one word adjective (feathered/furred/scaly/...); EMPTY "" for creatures with just skin]
	now Back Color entry is ""; [single word color adjective for the dominant color of the skin/fur/feathers/scales]
	[Limbs Adjective is generated by a function and can be used in scenes too - "rail-thin, slender, sinewy, average, firm, muscular, flabby, meaty, rippling"]
	now Arms Change entry is ""; [partial sentence that fits in: "Your arms [one of]tingle[or]go flush[or]vibrate with odd pleasure[or]go cold[or]feel oily[at random] as [Arms Change entry]."]
	now Arms Description entry is ""; [partial sentence to fit: "Your [Limbs Adjective of Player] arms are [Arms Description of Player]."]
	now Arms Skin Adjective entry is ""; [one word adjective (feathered/furred/scaly/...); EMPTY "" for creatures with just skin]
	now Arms Color entry is ""; [single word color adjective for the dominant color of the skin/fur/feathers/scales]
	now Locomotion entry is ""; [one word adjective: (bipedal/quadrupedal/octapedal/serpentine/sliding)]
	now Legs Change entry is ""; [partial sentence that fits in: "Your legs [one of]tingle[or]go flush[or]vibrate with odd pleasure[or]go cold[or]feel oily[at random] as [Legs Change entry]."]
	now Legs Description entry is ""; [partial sentence to fit: "As your inspection goes even lower, you come to the two [Body Adjective of Player] legs supporting you. They are [legs description of Player]."]
	now Legs Skin Adjective entry is ""; [one word adjective (feathered/furred/scaly/...); EMPTY "" for creatures with just skin]
	now Legs Color entry is ""; [single word color adjective for the dominant color of the skin/fur/feathers/scales]
	now Ass Change entry is ""; [partial sentence that fits in: "Your ass [one of]tingles[or]goes flush[or]vibrates with odd pleasure[or]goes cold[or]feels oily[at random] as [Ass Change entry]."]
	now Ass Description entry is ""; [partial sentence to fit: "Using your hands you feel your behind enjoying the sensation of your [Ass Width Adjective of Player], [Ass Shape Adjective of Player] [Ass Description of Player]." (For players with skin, instead of the period: ", covered in [Ass Color of Player] skin and [Body Hair Description of Player]"]
	now Ass Skin Adjective entry is "";  [one word adjective (feathered/furred/scaly/...); EMPTY "" for creatures with just skin]
	now Ass Color entry is ""; [single word color adjective for the dominant color of the skin/fur/feathers/scales]
	now Ass Width entry is 3; [ass width from 1-5]
	[Ass Width Adjective generated by function out of ass width: dainty/small/round/huge/enormous]
	[Ass Adjective generated by function out of body definition and ass width]
	now Tail Change entry is ""; [partial sentence that fits in: "Your rear [one of]tingles[or]goes flush[or]vibrates with odd pleasure[or]goes cold[or]feels oily[at random] as [if HasTail of Player is true]your existing tail is changed into a [Tail Description entry][else][Tail Change entry][end if]."]
	now Tail Description entry is ""; [partial sentence to fit: "Just below your lower back sprouts a [tail description of Player], which you move back and forth with glee."]
	now Tail Skin Adjective entry is ""; [one word adjective (feathered/furred/scaly/...); EMPTY "" for creatures with just skin]
	now Tail Color entry is ""; [single word color adjective for the dominant color of the skin/fur/feathers/scales]
	now Asshole Depth entry is 7; [inches deep for anal fucking]
	[Asshole Depth Adjective is generated by a function and can be used in scenes too - "petite (< 3), shallow (< 5), average (< 9), deep (< 15), bottomless (15+)"]
	now Asshole Tightness entry is 3; [asshole tightness 1-5, "extremely tight, tight, receptive, open, gaping"]
	[Asshole Tightness Adjective is generated by a function and can be used in scenes too - "extremely tight, tight, receptive, open, gaping"]
	now Asshole Color entry is ""; [one word color descriptor]
	now Cock Count entry is 0;
	now Cock Girth entry is 0; [thickness 1-5, generates the Cock Girth Adjective]
	[Cock Girth Adjective is generated by a function and can be used in scenes too: thin/slender/average/thick/monstrous]
	now Cock Length entry is 0; [length in inches]
	now Cock Adjective entry is ""; [one word adjective: avian/canine/...]
	now Cock Change entry is ""; [partial sentence that fits in: "Your cock [one of]tingles[or]goes flush[or]vibrates with odd pleasure[or]goes cold[or]feels oily[at random] as [Cock Change entry]."]
	now Cock Description entry is ""; [partial sentence to fit: "You have a [Cock Girth Adjective of Player], [Cock Length of Player]-inch-long [cock adjective of Player] [one of]cock[or]penis[or]shaft[or]maleness[at random] that [cock description of Player]."]
	now Cock Color entry is ""; [one word color descriptor]
	now Ball Count entry is 0; [allowed numbers: 1 (uniball), 2 or 4]
	now Ball Size entry is 0; [size of balls 1-7: "acorn-sized", "dove egg-sized", "chicken egg-sized" "goose-egg sized", "ostrich-egg sized", "basketball-sized", "beachball-sized"]
	[Ball Size Adjective is generated by a function and can be used in scenes too]
	now Ball Description entry is ""; [partial sentence to fit: "Underneath it hangs a pair of [Ball Size Adjective of Player] [ball description of Player]."]
	now Cunt Count entry is 0;
	now Cunt Depth entry is 0; [penetratable length in inches; some minor stretching allowed, or more with Twisted Capacity]
	now Cunt Tightness entry is 0; [size 1-5, generates adjectives of extremely tight/tight/receptive/open/gaping]
	[Cunt Tightness Adjective is generated by a function and can be used in scenes too: extremely tight/tight/well-used/open/gaping]
	now Cunt Adjective entry is ""; [one word adjective: avian/canine/...]
	now Cunt Change entry is ""; [partial sentence that fits in: "Your pussy [one of]tingles[or]goes flush[or]vibrates with odd pleasure[or]goes cold[or]feels oily[at random] as [Cunt change entry]."]
	now Cunt Description entry is ""; [partial sentence to fit: "You have a [Cunt Tightness Adjective of Player] [one of]cunt[or]pussy[or]vagina[or]cleft[at random] that [cunt description of Player]."]
	now Cunt Color entry is ""; [one word color descriptor]
	now Clit Size entry is 0; [size 1-5, see Clit Size Adjective]
	[Clit Size Adjective is generated by a function and can be used in scenes: very small/small/average/large/very large]
]



Section 3 - Endings
[See 'Magic Drake' and 'Rubber Drake' files.]

Koballoon ends here.
