Version 1 of Hyena Hideout by Stripes begins here.
[ Version 1.4 - Hyena Gang WS scene for gang bitch ]
[Version 2 - Small adjustment to Gina for Matriarch Vore scenes]
[- Originally Authored By: Sarokcat -]

"Adds a Hyena den to Flexible Survival with a dominance challenge and some smexing."

Section 1- Hyena Hideout

Table of GameRoomIDs (continued)
Object	Name
Hyena Hideout	"Hyena Hideout"

Hyena Hideout is a room. It is fasttravel. It is private.
earea of Hyena Hideout is "Outside".

The description of Hyena Hideout is "This large open building was obviously once a warehouse at one point, though much of whatever was once stored in here has long since been cleared out to make room for the hyena gang to set up shop. There are still several large crates and cargo containers scattered throughout the area, mostly used to divide the large space up into several smaller areas and semi private rooms. The open space hasn't been left empty however, and numerous couches, mattresses, and rough tables scatter the area, most having obviously seen better days and looted to make the area more comfortable. The heady musk of numerous hyenas and sex permeates the area with its own unique perfume, making you feel both excited and strangely comfortable just from breathing it in. Though obviously the large building could hold a large number of hyenas, you only see a moderate number of gang members here, most of the rest obviously wandering the city looking for new converts in their continuing membership drive.".

instead of sniffing Hyena Hideout:
	say "     This place smells strongly of hyenas. There have been many through here, much more than those you can see here right now.";

Table of GameCharacterIDs (continued)
object	name
Gang members	"Gang members"

Gang members is a man.
The description of Gang members is "A number of hyena gang members are lounging around the large open area, some of them lounging on the couches or the mattresses, while others move around chatting or showing off their hyena fur patterns. Several of the gang members have obviously gone mostly feral though, and their cackling laughter from the other rooms provides an almost comforting background to the noise of the area.".
The conversation of gang members is { "Yap!" }.
Gang members is in Hyena hideout.

instead of sniffing Gang members:
	say "The gang members smell like hyenas[if matriarchdefeated > 0 and matriarchowned is 0]. Their strong, dominant scents make you want to submit to them[end if].";

instead of conversing the gang members:
	if matriarchowned is 1:
		say "     [one of]The gang members all nod and acknowledge your dominance as you walk around the area, keeping an eye on your subjects[or]Several of your gang take the opportunity to fill you in on recent events in the city[or]You find several of the hyenas using the former matriarch like the whore you turned her into. A large, hyena-like grin crosses your face as you walk away, leaving them to their fun[or]Running across some of your scouts in an animated conversation, you pause to listen. Seeing your interest, they quickly fill you in on the military's activity in and around the city[or]Finding some of your scouts in an urgent discussion, you check in to see if anything is wrong. They quickly reassure you that things are proceeding quite well, and they are still working on securing several more routes out of the city just in case[or]Seeing your interest, a number of your hyena pack take this opportunity to chat with their matriarch, getting to know you and what's expected of them better[at random]. Walking away from the gang members, you realize that just being in their proximity has helped reinforce your hyena status.";
		hyenaify;
	else if matriarchdefeated is 1:
		say "     The other members of the hyena gang ignore you as you try to talk to them, obviously uninterested in whatever someone of your lowly status might have to say.";
	else if matriarchdefeated is 2:
		say "     The other hyenas grin as you try to talk to them, seemingly amused at your attempt to talk to them. One of them grabs you and forces you down onto your hands and knees. 'Good little breeding hyenas should know better than to walk around like the rest of us and try to talk to their betters without being asked,' he tells you as the rest laugh at your situation. 'Good little breeders go around on all fours with their ass up in the air just in case someone wants to fill them up.' The rest of the gang nod in agreement. You blush and find yourself nodding along as well, feeling vaguely guilty and embarrassed for having made such a basic mistake. You quickly trot away before you can make any more mistakes and embarrass yourself further. You only realize several minutes later that you have been walking around on all fours ever since you talked to them, your ass sticking up in the air eagerly, attracting approving looks from the nearby gang members. Blushing, you manage to force yourself to stand upright again, although it actually takes a surprising amount of effort to make yourself do so, the encounter reinforcing your hyena-like tendencies.";
		hyenaify;
		decrease humanity of Player by 10;
	else:
		say "     [one of]The gang members stare at you for a minute before going back to what they were doing.[or]'You sure you're hyena enough for this place?'[or]'Welcome to the den, newbie,' one of the gang members calls out.[or]'This is the best gang I've ever been in.'[or]One of the hyenas nods and smiles at you, obviously eyeing your attributes lewdly.[or]'Personally I think becoming a hyena is the best thing that ever happened to me,' one of the gang members says, while several other nearby ones nod in agreement.[or]'What do you think is eventually going to happen to the city?'[or]You come across a spirited conversation on whether or not the military is going to come to the rescue, or is actually behind the infection somehow. After listening for a while, you eventually move on.[or]Several hyenas are talking about seeing some sheep wandering around and wondering if they can be domesticated, or at least dominated into usefulness.[or]Several of the gang members are talking about their lives before the gang. To your surprise, you find that the gang has a lawyer, several cops, and an engineer among its many other recruits.[or]'Have you seen those moving giant trees out there? Creepy, that's all I have to say about it.'[or]Seeing several of the hyena scouts in deep conversation, you go over to listen. Noticing your interest, however, they all stop the discussion and stare at you until you leave, wondering what was so important.[at random]";


instead of fucking the gang members:
	if lastfuck of Gang Members - turns < 4:
		say "     While several of the hyena gang members seem interested in what your offering, it seems most of the ones still hanging out here in the den are still recovering from their last romp, perhaps you should try to excite them later.";
	if matriarchowned is 1:
		if Player is neuter:
			say "     There's little point in finding a partner among the gang while you have no proper gender of your own. While several of the gang have become aware of this, being blatant about it might entice one of the more ambitious members to try deposing you. Without anything to offer, you would be deposed without a contest of dominance.";
		else if Player is submissive and a random chance of 3 in 5 succeeds:
			now lastfuck of Gang Members is turns;
			say "     While you may be the strong matriarch of the gang, your submissive tendencies still exist and urge you to let the others have their way with you. In the mood for a good fuck, you move over to a pack of the gang members that Gina reports have been particularly useful of late and offer them a proper reward for their efforts. Eager, the group laughs and pats one another on the back even as they start stroking their cocks, knowing what you have in mind. Grinning at their eagerness, you give your hips a swish and order them to follow you.";
			say "     Allowed entrance to your chambers, they move in around you and start lavishing attention upon you, competing for the opportunity to be the first to earn your favor. Eventually you pick a particularly [one of]dashing[or]well-hung[or]horny[or]aggressive[at random] one while the others start pairing up into groups of two or three while they wait their turn";
			if Player is female:
				say ". After the hyena's lavished sufficient attention upon you, you move onto all fours and put your juicy cunt on display for your chosen suitor.";
				say "     Surprised at such good fortune, the hyena's atop you within moments, driving her cock into your needy cunt and fucking you wildly. While this is going on, you moan for the others to come and you swap between sucking a pair of them off while they're fucked from behind. Giving yourself over to several of the hyenas at once helps satisfy your more submissive tendencies while maintaining control of the gang[if Player is male]. And after all this has gotten you really aroused and worked up, you move on to fucking several of them, filling their wombs with your dominant seed to breed more strong members for your gang[end if]. Once you're satisfied, you have them sent away and head back out into the main area yourself a little later.[impregchance]";
			else:
				say ". After the hyena's lavished sufficient attention upon you, grab another member of the group and pull them roughly onto your bed. Driving your throbbing cock into her cunt, you shake your ass and tell your chosen suitor to stick her cock in you while you fuck the others.";
				say "     A little surprised, but not one to waste such an opportunity, she moves in behind you. After a [if anallevel is 3]good, long rimming that has her tongue playing around in your asshole[else]quick rimming[end if], you feel that pulsing meat at your asshole and pushing into you. Still wanting more, you moan for the others to come and you swap between sucking a pair of them off while they're fucked from behind. Giving yourself over to several of the hyenas at once helps satisfy your more submissive tendencies while maintaining control of the gang. And after a creamy load in your ass has gotten you really aroused and worked up, you move on to fucking several of them while you're getting fucked in the ass, filling their wombs with your dominant seed to breed more strong members for your gang. And to make sure your suitor doesn't get any ideas, you finish off the fun by fucking her as well[if anallevel is 3] while others lick the leaking cum from your sticky asshole[end if]. Once you're satisfied, you have them sent away and head back out into the main area yourself a little later.[mimpregchance]";
			hyenaify;
			hyenaify;
		else:
			now lastfuck of Gang Members is turns;
			say "     The other hyenas gather around you as you show an interest in them, quickly competing with each other to see who can catch your favor, as you move amongst them. An orgy beginning to break out around you as your aroused and dominant scent begins to send the hyenas around you wild with need. You find yourself amused and aroused by their submissive need to please you, and when one of them catches your eye, you enjoy forcing them down as they cry out underneath you. The orgy grows even more intense around you, as the sight makes all the other hyenas wild, and you enjoy the feel of their fur surrounding you and the fur of the hyena of the moment underneath you. Soon you throw back your head and a hyena-like laugh of ecstasy comes from you as you explode within your partner. Panting with pleasure as you withdraw, you leave the rest of the pack to the orgy, many of them obviously envious of the partner you blessed with your dominant seed.";
			hyenaify;
	else if matriarchdefeated is 2:
		now lastfuck of Gang Members is turns;
		say "     'Hey, it's our favorite slut!' one of the hyenas calls out as you approach, making you flush as they quickly surround you, their obvious intentions causing your body to clench in anticipation as you automatically drop down on all fours. The surrounding gang members waste no time in taking advantage of your obvious invitation, as they begin to grope and molest your all to eager body. Soon a cock is presented in front of your muzzle and you need no encouragement to open wide and begin licking and sucking it with abandon. You moan as you give yourself up to the pleasure of being used by all the hyenas around you.";
		if Player is submissive and a random chance of 3 in 5 succeeds:
			say "     As the hyenas continue to use and abuse you, your submissive instincts have you moaning for more, wanting all that they can give[if Player is male]. Felt unwanted and undeserving of use by both you and the gang members, your cum is left to spray out onto the ground or onto yourself as the lustful hyenas pound away at you[end if]. You're sucking cocks, eating pussies and getting cum upon while they fuck you over and over";
			if Cunt Count of Player > 1:
				say ". Having several juicy cunts for them to fill only lets more of them share you at once as your pussies[if anallevel > 1] and stretched asshole[end if] are filled over and over again. Whenever a hole is freed, there's another hyena eager and ready to fill it. Your mind, a haze of submissive hyena instincts, wants nothing more than to fulfill your purpose as a breeding bitch for the gang. These instincts tell you that you're meant to be fucked and bred full of fresh pups for the gang to help it grow stronger. These stronger, dominant hyenas deserve a reward for their work for the gang and fucking you is that reward. Lost in your lustful state, that's all you feel you are - a breeding slut, a reward, a prize to be shared.";
			else if Cunt Count of Player is 1:
				say ". Even as your dripping pussy is being stuffed with hyena cock, you're crying out for more. At times, your cries are silenced by a fresh cock being stuffed into your mouth[if anallevel > 1] and into your asshole[end if], but sometimes another of the well-hung members will push his cock in alongside his compatriot's, wedging a second cock into your abused hole[if Cunt Tightness of Player < 6]. And while this may be rather painful the first few times it happens, it also feels wonderful to your needy hole[else if Cunt Tightness of Player < 10]. Your accommodating cunt takes this double-fucking with only a little added stretching, but also feels wonderful to your needy hole[else]. Your wide cunt, built to take bigger lovers, welcomes the additional meat filling you, wanting more hyena cum in it faster[end if]. Your mind, a haze of submissive hyena instincts, wants nothing more than to fulfill your purpose as a breeding bitch for the gang. These instincts tell you that you're meant to be fucked and bred full of fresh pups for the gang to help it grow stronger. These stronger, dominant hyenas deserve a reward for their work for the gang and fucking you is that reward. Lost in your lustful state, that's all you feel you are - a breeding slut, a reward, a prize to be shared.";
			else:
				say ". While some of the gang members are disappointed that you don't have a proper breeding hole for them, they're not one to pass up an opportunity to fuck one of the gang's prize bitches either. Whenever either end if freed, there's another hyena eager and ready to fill it. With you always moaning for more, eventually some of them laugh and decide to give it to you. Holding you up between them, a pair of sexy hyena herms drive their thick, bestial rods into your abused hole at the same time. Bouncing up and down on these twin shafts, you moan, pant and whimper as the rough treatment, your slutty nature loving it. When one of them finishes, another hyena replaces them in your stretched out, creamy hole to plug you right up again. You lose track of how many take you in this manner, but eventually the group tires of that fun and drop you back down to the ground on the puddle of cum that's been leaking out of you. From there, it's right back to taking cocks from both ends, though a few ambitious pairs move in to share you side by side to double-stuff you.";
				say "     Throughout all this, your mind is a haze of submissive hyena instincts, wanting nothing more than to fulfill your purpose as a fucktoy bitch for the gang. These instincts tell you that you're meant to be fucked [if Player is mpreg_ok]and bred full of fresh pups for the gang to help it grow stronger[else]by your betters and you give as much of yourself as you can[end if]. These stronger, dominant hyenas deserve a reward for their work for the gang and fucking you is that reward. Lost in your lustful state, that's all you feel you are - a [if Player is mpreg_ok]breeding[else]fucktoy[end if] slut, a reward, a prize to be shared.";
			say "     And shared you are. Swapping positions or swapping out, you are filled again and again from both ends and in every hole. Much to your delight, it just seems to go on and on, more gang members appearing as others finally finish up, spreading the word that you're at the center of a slutty fucking binge. They continue to use you, cumming onto and into you until your stretched, overused holes can't hold in their semen and it's running out of you each time more is pumped into you. And even then, you keep moaning weakly for more. It doesn't stop until you pass out, and even then, you can't be sure if they don't keep using your unconscious body. Certainly when you awaken later, you find yourself in a large, sticky pool of hyena cum that clings to your body, marking you all over the myriad scents of the gang, further reinforcing the fact that you are the property of them all.[impregchance][impregchance][impregchance]";
			hyenaify;
			hyenaify;
			now lastfuck of Gang Members is turns - 2;
		else if wslevel is 3 and a random chance of 1 in 4 succeeds:
			say "     As the hyenas move in around you, they start to chuckle and exchange a nod. You feel one of them grab your ass tightly while the one whose cock you're sucking latches her paws onto your head. A hot, acrid rush fills your mouth, flowing across your tongue and down your throat. The others surrounding you unleash their bladders as well, pissing across your [bodydesc of Player] body. You squirm and briefly try to pull away, but don't stop drinking the hot urine despite the strong taste, your bitch body responding instinctively to being marked by the more dominant members of the pack.";
			if Player is female:
				say "     The one behind you purposefully shoots her stream across your loins, sending a rush of heat through you. Your [if Player is male]cock[smn], balls, [end if]cunt[sfn] and asshole get sprayed down. The others laugh louder at your wet moans and submissive whimpers as [if anallevel is 3 and a random chance of 2 in 7 succeeds]she presses her glans to your tight pucker and forces some of her stream right into you, marking you inside and out as the gang's property[else if Player is male and a random chance of 2 in 5 succeeds]your unwanted manhood is coated in the piss of your betters[else]she presses her glans to your wet pussy and forces some of her stream right into you, marking you inside and out as the gang's property[end if]. Your hips quiver and you cum, adding your female juices[if Player is male] and semen[end if] to the mess dripping off of you.";
			else if Player is male:
				say "     The one behind you purposefully shoots her stream across your loins, sending a rush of heat through you. Your cock[smn], balls and asshole get sprayed down. The others laugh louder at your wet moans and submissive whimpers as [if anallevel is 3 and a random chance of 3 in 5 succeeds]she presses her glans to your tight pucker and forces some of her stream right into you, marking you inside and out as the gang's property[else]your unwanted manhood is coated in the piss of your betters[end if]. Your hips quiver and you cum, adding your semen to the mess dripping off of you.";
			else:
				say "     The one behind you purposefully shoots her stream across your bare crotch and asshole, sending a rush of heat through you. The others laugh louder at your wet moans and submissive whimpers as [if anallevel > 1 and a random chance of 2 in 3 succeeds]she presses her glans to your tight pucker and forces some of her stream right into you, marking you inside and out as the gang's property[else]you're mocked for your lack of genitals even as your featureless crotch is being pissed all over by the hyena behind you[end if].";
			say "     When they're done, you're made to lick all their cocks clean, having to taste the piss from all of them. You can't help but blush as you do so, humiliated by your actions, but loving it as well, knowing that you belong to them all. That done, you're left laying in the messy puddle of their urine. Their scent soaks into your flesh and clings to you.";
			hyenaify;
			now lastfuck of Gang Members is turns;
		else:
			if Player is male:
				say "     Your cock dangles uselessly underneath you as they use your all too willing body, spurting its worthless submissive seed on the ground beneath you, as you are thoroughly used like the happy little breeding slut you know deep down you really are.";
				if Player is female:
					say "     At some point several of the gang members thrust themselves into your willing cunt, causing you to groan in pleasure as your breeding hole is filled, knowing you will soon be fulfilling your true purpose as a breeding hyena and being filled with loads of wonderful cub making batter. You find yourself sandwiched between them as you are taken from both ends, their thrusting moving you helplessly between them as you moan wantonly. As soon as one of them shoots their load into you, another hard cock is right there to take its place in whichever hole is open, you soon lose track of the number of loads shot into your eager mouth or your horny pussy, and find yourself only caring about the next cock you can cram into yourself. Eventually you pass out, your body still being used by several of the gang members, only to wake up later, stuffed with their fertile cum and the taste of their delicious seed coating your tongue.[impregchance][impregchance]";
				else:
					say "     At some point one of the gang members discovers your empty asshole, and takes care to remedy the situation by filling it with his hard cock. You find yourself sandwiched between them as you are taken from both ends, their thrusting moving you helplessly between them as you moan wantonly. As soon as one of them shoots their load into you, another hard cock is right there to take its place in whichever hole is open, you soon lose track of the number of loads shot into your eager mouth or your aching ass and eventually find yourself not even caring. Eventually you pass out, your body still being used by several of the gang members, only to wake up later, coated in dried cum and the taste of their seed in your mouth.[mimpregchance][mimpregchance]";
			else:
				say "     At some point several of the gang members thrust themselves into your willing cunt, causing you to groan in pleasure as your breeding hole is filled, knowing you will soon be fulfilling your true purpose as a breeding hyena and being filled with loads of wonderful cub making batter. You find yourself sandwiched between them as you are taken from both ends, their thrusting moving you helplessly between them as you moan wantonly. As soon as one of them shoots their load into you, another hard cock is right there to take its place in whichever hole is open, you soon lose track of the number of loads shot into your eager mouth or your horny pussy, and find yourself only caring about the next cock you can cram into yourself. Eventually you pass out, your body still being used by several of the gang members, only to wake up later, stuffed with their fertile cum and the taste of their delicious seed coating your tongue.[impregchance][impregchance]";
			hyenaify;
	else if matriarchdefeated is 1:
		now lastfuck of Gang Members is turns;
		say "     Several of the gang members pause as you approach, hyena grins spreading across their muzzles as they scent your obvious need, soon you are surrounded by amorous hyenas. You open your mouth to speak, only to have one of them grab you from behind and shove you down onto your hands and knees. You stare around in surprise as you find yourself suddenly at crotch level, and it is obvious just how excited the hyenas around you are, before you can do anything one of the gang members has taken advantage of your open mouth to shove his hard rod in. The thick wonderful tasting hyena meat causes you to gag slightly for a second, before your throat adapts to his large cock, you consider biting down, but something about the situation makes you so very horny. He begins to thrust himself into your mouth, and the amazing taste of his meat coating your tongue, sends you wild, licking and working his cock as best you can. You can feel the hands of the other members on your body as they begin to play with you as well, but you find it hard to focus on anything more than the cock in front of you. Soon enough his cock explodes its salty deliciousness into your mouth, forcing you to swallow as fast as you can, some still dribbling out the edge of your mouth. The first gang member pulls himself out of your mouth and steps back, but before you can miss him, another cock is shoved in front of your mouth, and you find yourself opening wide for your next treat.";
		if Player is male:
			say "     Your cock dangles uselessly underneath you as they use your all too willing body, spurting its worthless submissive seed on the ground beneath you, as you are thoroughly used by the more dominant hyenas.";
			if Player is female:
				say "     At some point several of the gang members thrust themselves into your willing cunt, causing you to groan in pleasure as both of your holes are filled at once. You find yourself sandwiched between them as you are taken from both ends, their thrusting moving you helplessly between them as you moan wantonly. As soon as one of them shoots their load into you, another hard cock is right there to take its place in whichever hole is open, you soon lose track of the number of loads shot into your eager mouth or your horny pussy, and find yourself not even caring. Eventually you pass out, your body still being used by several of the gang members. Only to wake up later, with cum leaking out of your pussy, and the taste of their seed coating your tongue.[impregchance][impregchance]";
			else:
				say "     At some point one of the gang members discovers your empty asshole, and takes care to remedy the situation by filling it with his hard cock. You find yourself sandwiched between them as you are taken from both ends, their thrusting moving you helplessly between them as you moan wantonly. As soon as one of them shoots their load into you, another hard cock is right there to take its place in whichever hole is open, you soon lose track of the number of loads shot into your eager mouth or your aching ass and eventually find yourself not even caring. Eventually you pass out, your body still being used by several of the gang members. Only to wake up later, coated in dried cum, and the taste of their seed in your mouth.[mimpregchance][mimpregchance]";
		else:
			say "     At some point several of the gang members thrust themselves into your willing cunt, causing you to groan in pleasure as both of your holes are filled at once. You find yourself sandwiched between them as you are taken from both ends, their thrusting moving you helplessly between them as you moan wantonly. As soon as one of them shoots their load into you, another hard cock is right there to take its place in whichever hole is open, you soon lose track of the number of loads shot into your eager mouth or your horny pussy, and find yourself not even caring. Eventually you pass out, your body still being used by several of the gang members. Only to wake up later, with cum leaking out of your pussy, and the taste of their seed coating your tongue.[impregchance][impregchance]";
		hyenaify;
	else:
		say "     While several of the hyenas seem interested in your hot body and taking what you're so eagerly offering, a swift glare or two from Gina has them moving on to play with each other instead. After a few minutes you are left relatively alone as one of the few gang members not rolling around on the floor enjoying themselves.";

Table of GameCharacterIDs (continued)
object	name
Gina	"Gina"

Gina is a woman.
The description of Gina is "The hyena who recruited you into the gang is lounging around on a pile of cushions nearby, you think her name was Gina.".
The conversation of Gina is { "Stare!" }.
Gina is in Hyena hideout.

instead of sniffing Gina:
	say "Gina smells like a strong, confident hyena herm. Her musky scent is quite arousing[if matriarchdefeated is 2], making you want to submit to her like the bitch you are deep inside[end if].";

instead of conversing the Gina:
	project the Figure of Gina_face_icon;
	if ginatalk is 0:
		say "     'Well this is the place hun, welcome to the pack hideout, though most of us just call it the Hyena Den nowadays,' Gina says with a lazy gesture at the cavernous space around you, filled with the low conversations and hyena laughter of some of the other gang members. 'We have a pretty nice setup here, if I do say so myself. Lots of room and a pretty good location in the city, too. Course there aren't a lot of modern amenities, but hey, there aren't many of those anywhere else in the city either,' Gina says with a shrug as she sprawls on her pile of cushions. 'Got a good thing going here though, with plenty of room for most of us to hang out, and we have a separate space next warehouse over for the breeders.' Seeing your look of puzzlement, she explains, 'That's what we call those who give in totally. All they want to do is fight, fuck, and feed. Really can't tell much difference between that and what the rest of us want though,' Gina says before breaking into a hyena-like chuckle. 'They make great fighters and hunters though, help us track down anyone entering the territory we don't invite.'";
		say "     Gina pauses for a minute before continuing, 'I think you'll like it here if you give it a chance. I'm pretty high up the pecking order right now cause I got a good eye for new recruits, so everyone should give ya the benefit of the doubt while you try to find your place around here. Well, at least until we finally get us a matriarch to take charge of things around here,' she says, a frown crossing her hyena muzzle. 'Once the dominants finally figure out who's on top of the pecking order, my status could change depending on the new matriarch. Hopefully you'll be all settled in by then. In the meantime, feel free to pull up a cot and bunk over here with me.'";
		add "cot" to invent of Hyena hideout;
		increase ginatalk by 1;
	else if matriarchowned is 1:
		say "     [one of]'Hey hun, who'd have imagined things turning out this well for ya, eh?'[or]'Aren't you glad you joined up now?'[or]'Got any orders for me, matriarch?' Gina says as she wiggles her rear in your direction.[or]'That was one of the best dominance fights I've ever seen.'[or]'So what do you have planned for the gang now?'[or]'Have you given any thought to picking lieutenants yet?'[or]'You should have some fun with the rest of the gang members sometimes - don't want them to feel neglected.'[or]'I saw the old matriarch earlier. Looks like she's adapted well to being a breeder.'[or]'Our numbers have been growing steadily ever since you took over. Things are looking up!'[or]'Several of the other hyenas found some military guys poking around the edges of the city... They apparently make great breeders,' she says with a smug look.[or]'The old matriarch had us finding lots of back ways out of the city just in case we needed them. We should be able to duck out of here pretty quick if we have to.'[or]'Feel good to be at the top of the best gang in the city?'[or]'We've managed to round up some more new recruits recently. They hardly put up a fight at all.'[at random]";
	else if matriarchdefeated is 1:
		say "     'Things are going pretty well under the new matriarch,' Gina says as you settle down to chat, 'There are still few mutters, but most of us think we got a pretty good thing going on right now, even heard she has some kind of plan to deal with the military when they come.' Gina grins at that thought. 'They won't know what hit [']em,' she says, her grin turning positively feral. '[']Course the matriarch is still accepting challengers if anyone wants to give it a shot, but after what happened with you, it doesn't look like anyone else is eager to step up,' she says, shooting you a sidelong look. 'Still looks like anyone can step up and try, even you could try taking her on again if you really wanted. But you wouldn't be crazy enough to try challenging her again, now would ya?' Gina says with a smirk.";
		if Player consents:
			if Player is male:
				say "     'You would?' Gina says with surprise. 'Well, if you're sure you want to try again, I won't stop you from trying,' Gina says as she leads you back once more to the matriarchs den. 'Be careful though, much more of the matriarch's brand of submissiveness training, and I doubt you would be able to be dominant to pretty much anyone here anymore,' she finishes before you once more find yourself before the curtained area with the crowd gathering. You brace yourself this time as one of the guards charges you and the fight is on again.";
				say "[hyenamat_challenge]";
				if matriarchowned is 1:
					say "[hyenamat_victorytf]";
					say "     Gina pads over to you carefully after the orgy is finished, picking her way through the piles of collapsed bodies and pools of sexual fluids that cover the floor. Reaching down she gives you a hand up as you survey your new subjects, you think you can see a new glint of respect and admiration for you in her eyes. 'That was amazing,' Gina says as she leads you back to your new quarters, leaving the former matriarch lying forgotten on the floor behind you. 'I knew you were special when I found ya, but I had no idea know just how tough you were,' she says with awe as she shows you the matriarchs chambers, a larger section of the warehouse with even more comfortable looking chairs and furniture... and your new home. 'If you ever need any help with running this place or anything, you know where to find me,' Gina finishes before she helps you settle in for a much-needed rest after the hard fight, and fuck afterwards.";
				else if HyenaMatVore is true:
					move Matriarch to Hyena Hideout;
				else:
					say "     Gina comes over to you as you recover from your exhausting ordeal, cum and other fluids covering you and leaking out of you as she drags you over to help clean you off. 'Can't say I didn't warn you,' Gina mutters as she helps you settle down for a much-needed rest. 'Though it definitely looked like you submitted pretty willingly there at the end. Guess you don't have to pretend to be a dominant anymore, it's pretty obvious how much you like being on the bottom instead,' Gina says with a smirk as you find yourself nodding almost automatically, an even stronger desire rising up in you to please the more dominant hyena by agreeing with whatever she wants.";
					move Matriarch to Hyena Hideout;
			else:
				say "     'Sorry hun,' Gina says as she gestures at your crotch. 'You kind of lack the equipment for that sort of challenge right now. Maybe you should hang out with us hyenas a bit more hmm?'";
		else:
			say "     'That's probably for the best hun,' Gina says with a nod of her furry head. 'After your last showing, if you ended up losing to her again you could be in deep trouble, unless of course you want to be a submissive little pet hyena,' Gina says as she cocks her head to look you over carefully, 'And if that's the case you can just let me know and Gina here will take good care of you,' she says with a leer";
	else if matriarchdefeated is 2:
		say "     'How are ya doing now? After your last couple showings the matriarch won't fight you again, and I can't really say I blame her after your last showing. The rest of the gang probably wouldn't stand for it either, not when you've proven yourself to be such a good submissive breeder for the gang. You should probably just give up and accept your place from now on, especially given how much you seemed to enjoy it,' Gina says with a bit of a leer. 'Though I think we could still have some fun together if you want, and the rest of the gang certainly wouldn't mind a few rounds with one of their favorite breeding sluts. But at least it looks like you've found your place here from now on,' Gina finishes up, causing you to blush as you remember your wanton and submissive actions underneath the matriarch.";
	else if ginaslut is 3:
		say "     'Hey big news,' Gina says as you talk to her this time, 'Looks like they finally got things sorted out back there, and we have ourselves a matriarch finally!' Gina grins happily, 'And I hear she has big plans for the gang too, should be good eh?' She pauses for a minute, before continuing. 'Still, been some muttering around, suppose there is always someone who thinks they have a better shot at it. So the matriarch is inviting anyone who thinks they can to challenge her publicly, course ya got to defeat a few of her guards first to prove yourself worth and all, still the winner would automatically become the new boss, so that's a pretty big incentive there.' Gina seems a bit impressed at the thought, before shaking herself slightly. 'Not for me though, I'm pretty happy where I'm at, you look kind of interested though,' she says as she notes your expression. 'You up to try taking her down?'";
		if Player consents:
			if Player is male:
				say "     'Well ok then hun,' Gina says, her expression growing slightly worried. 'If you're sure you want to give it a try, be careful though,' she warns you as she begins to lead you back into the deeper part of the warehouse. 'She didn't get to be where she is by being anything but the most dominant hyena around, and losing could really set you low on the pecking order.' Seeing your determined expression, she leads you to a curtained area with several other hyenas lounging around nearby, and announces your challenge to the area in general. As word spreads and gang members from all over the warehouse run over to watch, you hear a dominant voice growl out from behind the curtain 'Challenge accepted!' You have a second to reconsider as the largest hyena you have yet seen emerges from the curtain, her posture and musk reeking with dominance, before one of her hyena guards barrels into you and the fight is on!";
				say "[hyenamat_challenge]";
				if matriarchowned is 1:
					say "[hyenamat_victorytf]";
					say "     Gina pads over to you carefully after the orgy is finished, picking her way through the piles of collapsed bodies and pools of sexual fluids that cover the floor. Reaching down she gives you a hand up as you survey your new subjects, you think you can see a new glint of respect and admiration for you in her eyes. 'That was amazing,' Gina says as she leads you back to your new quarters, leaving the former matriarch lying forgotten on the floor behind you. 'I knew you were special when I found ya, but I had no idea know just how tough you were,' she says with awe as she shows you the matriarchs chambers, a larger section of the warehouse with even more comfortable looking chairs and furniture... and your new home. 'If you ever need any help with running this place or anything, you know where to find me,' Gina finishes before she helps you settle in for a much-needed rest after the hard fight, and fuck afterwards.";
				else:
					say "     Gina comes over to you as you recover from your exhausting ordeal, cum and other fluids covering you and leaking out of you as she drags you over to help clean you off. 'Can't say I didn't warn you,' Gina mutters as she helps you settle down for a much-needed rest. 'Things will be a bit different around her now that the matriarch has made you one of the gang sluts, I won't be able to keep you to myself anymore that's for sure. And it's definitely going to be harder for you to get much respect around here, plenty of fucking though if that's any consolation,' she finishes with a leer, causing you to blush as you recall your recent encounter, the thought of it making your loins heat up again almost against your will.";
			else:
				say "     'Sorry hun,' Gina says as she gestures at your crotch, 'you kind of lack the equipment for that sort of challenge right now. Maybe you should hang out with us hyenas a bit more, hmm?'";
		else:
			say "     'That's probably for the best, hun,' Gina says with a nod of her furry head. 'Things are a bit touchy right now with the new matriarch and all, and if you lost, she would probably end up making an example out of you.'";
	else:
		say "     [one of]'If ya need any help around here, just let me know,' she says with a wink.[or]'Better steer clear of the capitol building if ya head back out there. Even we aren't crazy enough to get involved in whatever is going on over there.'[or]'Wonder what's going on with people outside the city, I'd love to get my old family in the gang.'[or]'Saw a couple deer over near the park earlier, I know they used to be people to, but damn it made me hungry watching [']em prance around.'[or]'Did ya know regular hyenas aren't fully functional with both sets of equipment?' Gina says as she strokes herself slowly, 'Dunno why we're different, but I sure ain't complaining.'[or]'Their still fighting it out over who's more dominant, should have a matriarch soon though.'[or]'Careful if you go near the Trevor labs building, there's a dragoness in there that's pretty tough. Won't let anyone in to loot the place, kinda makes you wonder what she's hidin['].'[or]'Life as a hyena is just so much better than anything else, don't you agree?'[or]'There are some crazy things wandering around out there,' Gina says with a thoughtful look. 'I've seen latex dolls, giant cocks, and some of the others have even reported living stuffed animals out there. Makes me glad I ended up a hyena,' she finishes with a cackling laugh. 'We at least know how to have fun.'[at random]";

Ginatalk is a number that varies.
Ginaslut is a number that varies.
ginafucked is a number that varies. ginafucked is usually 0.


instead of fucking Gina:
	project the Figure of Gina_face_icon;
	if lastfuck of Gina - turns < 8:
		say "     'Sorry, hun. Still recovering from our last little romp,' she says with a wink.";
		stop the action;
	now lastfuck of Gina is turns;
	if matriarchowned is 1:
		say "     Gina smiles as you approach, before leading you back to the matriarchs quarters. 'I was wondering when you'd come ask me for some fun again,' she says as she lies back on the cushions, spreading herself and giving you a lovely view of her stiff cock and wet opening. You quickly move over her and cover her muzzle with your own, in a deep rough kiss, your tongues tangling as your bodies begin to grind against each other.";
		if Player is male:
			say "     You reach down and bury your hands in the spotted fur of her thighs, as you haul her into position, she moans wantonly under you in anticipation as you rub your cock along the edge of her folds. Unable to tease her for too long, you thrust into her roughly, giving her what you both want so badly as you quickly build up a rhythm of short fast thrusts. All too soon you groan in ecstasy as you explode within her, causing her to groan and laugh as well as you shoot yourself into her. Pulling your limp rod out of her, you relax on top of her for a minute as she brings one of her hands down to rub the fur over her belly, a pleased expression on her face at being full of your fertile seed.";
			if Player is female:
				say "     Gina smiles and reaches her hand down to stroke her hard cock, your eyes following her every movement as a drop of pre forms on its tip. 'Why don't you lie back now and let Gina give you what you need?' she says as she rolls you onto the bottom. You know you could force her to stop if you wanted, but right now you feel horny enough that you let her move over you, the heat between your thighs clenching in anticipation as she moves herself into position. She teases you with her hands as she rubs them over your sensitive nipples and along your sensitive [skin of Player] skin, her mouth worshipping your body as she licks you all over, before finally thrusting her hard cock into you. You growl and snap for a minute, reminding her who is boss as you demand she go harder, and faster, and when she complies, you find yourself laughing with euphoria as the sensations of being spread wide by her with every thrust surge through you. All too soon you both cry out together in ecstasy as she shoots her load into your waiting womb, her fertile seed calming the fires inside you as nothing else can. You collapse in the afterglow as Gina collapses beside you, her body completely spent, as you lie there enjoying the pleasant sensations radiating outwards from your well used loins.[impregchance]";
		else:
			say "     Gina smiles and reaches her hand down to stroke her hard cock, your eyes following her every movement as a drop of pre forms on its tip. 'Why don't you lie back now and let Gina give you what you need?' she says as she rolls you onto the bottom. You know you could force her to stop if you wanted, but right now you feel horny enough that you let her move over you, the heat between your thighs clenching in anticipation as she moves herself into position. She teases you with her hands as she rubs them over your sensitive nipples and along your sensitive [skin of Player] skin, her mouth worshipping your body as she licks you all over, before finally thrusting her hard cock into you. You growl and snap for a minute, reminding her who is boss as you demand she go harder, and faster, and when she complies, you find yourself laughing with euphoria as the sensations of being spread wide by her with every thrust surge through you. All too soon you both cry out together in ecstasy as she shoots her load into your waiting womb, her fertile seed calming the fires inside you as nothing else can. You collapse in the afterglow as Gina collapses beside you, her body completely spent, as you lie there enjoying the pleasant sensations radiating outwards from your well used loins.[impregchance]";
		hyenaify;
		stop the action;
	if matriarchdefeated is 2:
		say "     'Look who stopped by,' Gina says as you approach, grinning as she notes your obvious desires, 'And it looks like you need a little help from your old friend Gina,' she says as she reaches out and roughly drags you down onto the mattress beside her.";
		if Player is male:
			say "     'This little playtoy is pretty useless now, isn't it?' she says with a hyena-like grin as she pokes your flaccid member. 'After all, little breeding hyenas don't get to spread their submissive little seed.' She grins as she flips you over.";
			if Player is female:
				say "     'Now that you've found out what you are good for around here,' Gina says as she drags you underneath her on the mattress, 'We should put your slutty body to work. After all, it's not like you are good for anything else,' she says as she positions herself above you, her words causing your body to flush and if anything, causes your need to grow even greater. Gina thrusts herself into your folds roughly, your body opening itself up for her large cock eagerly, as you moan in pleasure, unable to help yourself from sinking back down to the submissive state the matriarch brought out in you. 'That's it,' Gina moans roughly into your ear as she continues to thrust into you, 'Moan for me my little slut. You can't hide how much you enjoy this from me, I can tell how much you want me to fuck you hard,' she growls as she gasps out her words in between thrusts, her dirty words exciting you even more in conjunction with her forceful thrusts as she takes possession of your body. 'You want me to mount you like the slut you are, to take you like an animal and fill your slutty little cunt up with my seed, why don't you just admit it.' She groans out as she gives a final harsh thrust, and then orgasms into you, filling you up as she said she would, the feel of her spurting into you causing you to convulse into orgasm as well, as she collapses panting on top of you. As you lie together on the mattress, you realize that her words may have had more than a small grain of truth in them, as even thinking about what she said makes you start to get horny again...[impregchance]";
			else:
				say "     'Such a shame you don't have a proper hole to use,' Gina laments with false sympathy. 'I guess we'll just have to use what's available,' she finishes as she thrusts herself into your ass roughly, causing you to cry out. She quickly begins thrusting into you, using you without a care for your own pleasure or feelings as she grunts roughly above you. Eventually she climaxes, into you, and withdraws with a sated smile to sprawl back on the mattress, leaving you feeling used, with your own needs unsatisfied. Yet somehow being treated as sex object seems to almost comforting to your totally submissive new needs.[mimpregchance]";
		else:
			say "     Now that you've found out what you are good for around here,' Gina says as she drags you underneath her on the mattress, 'We should put your slutty body to work. After all, it's not like you are good for anything else,' she says as she positions herself above you, her words causing your body to flush and if anything, causes your need to grow even greater. Gina thrusts herself into your folds roughly, your body opening itself up for her large cock eagerly, as you moan in pleasure, unable to help yourself from sinking back down to the submissive state the matriarch brought out in you. 'That's it,' Gina moans roughly into your ear as she continues to thrust into you. 'Moan for me my little slut. You can't hide how much you enjoy this from me, I can tell how much you want me to fuck you hard,' she growls as she gasps out her words in between thrusts, her dirty words exciting you even more in conjunction with her forceful thrusts as she takes possession of your body. 'You want me to mount you like the slut you are, to take you like an animal and fill your slutty little cunt up with my seed, why don't you just admit it.' She groans out as she gives a final harsh thrust, and then orgasms into you, filling you up as she said she would, the feel of her spurting into you causing you to convulse into orgasm as well, as she collapses panting on top of you. As you lie together on the mattress, you realize that her words may have had more than a small grain of truth in them, as even thinking about what she said makes you start to get horny again...[impregchance]";
		hyenaify;
		stop the action;
	if ginaslut is 3:
		say "     Gina gives you a lewd grin as you accept her implicit invitation to join her, before you can react she reaches out and hauls you down onto the mattress beside her, 'Oh good,' she says with a feral grin on her muzzle. 'This news of a new matriarch has been making me so damn horny lately. I was hoping you would stop by.'";
		if Player is male:
			say "     She grins as she reaches down to stroke your stiffening manhood, her musky scent flooding you with desire as she runs her rough paw-like palm along your shaft. 'Mmmm, I know what I want,' she mutters as she pushes your back into the mattress and climbs over you, one paw reaching behind your head and pulling you into a lewd wet kiss, while her other guides your cock into her hot folds. You moan into her muzzle as she begins to grind herself down on you, her cock rubbing up between you as her cunt massages you tightly. Her expert movements soon have you orgasming within her, your seed shooting up into her waiting canal, triggering her own body to shudder in orgasm. Her tight wetness clenching around your manhood as you orgasm together, and her cock explodes in orgasm as well, shooting its sticky hyena seed all over your chest and face, coating you in her fertile treasure. When you are both done with the intense orgasm, she rests for a second before pulling herself off of you with a wet sucking sound, before collapsing on the mattress next to you, her hands still roaming your bodies as she rubs her seed into your skin.'";
			if Player is female:
				say "     'Mmmm, that was good,' Gina says as she lies next to you, her hand reaching down to massage your wet cunt, before rolling herself back over on top of you. 'But it looks like you were left a little unsatisfied here, we can't have that now can we?' Gina says with a grin as she moves her quickly stiffening cock over your empty pussy. 'I think I have one more round left in me,' she says as she thrusts herself into you roughly. Gina thrusts into you hard and fast, making you groan with every thrust, she doesn't slow down at all as she forcibly brings you to orgasm again, your body shuddering underneath her triggering her own powerful orgasm as she spills her seed into your womb. Coating you on the inside as well as the outside this time, you can't help but feel a sense of belonging as you both collapse onto the mattress together, completely spent.[impregchance]";
		else:
			say "     Gina grins as she moves over you, her hands running up and down your sides as she massages your body, her musky scent flooding you with desire as she runs her rough paw-like palms over you. 'Mmmm, I know what I want,' she mutters as she pushes your back into the mattress and climbs over you, one paw reaching behind your head and pulling you into a lewd wet kiss, while her other guides her cock right into your hot body. You moan into her muzzle as she begins to grind herself into you, her rough tongue invading your mouth even as her cock invades your pussy. She thrusts herself into you hard and fast, making you groan into her muzzle with every thrust, she doesn't slow down at all as she fucks you like the beasts you both resemble. You moan and cry out as you are engulfed in a powerful orgasm, your body's shuddering underneath her triggering her own powerful orgasm as she spills her hot virile seed into your empty womb. Your eyes roll back in your head as she stays there for a minute, joined together by her strong male organ, and the feel of her seed tingling inside you. You can't help but feel a sense of belonging and happiness as you both collapse onto the mattress together, completely spent.[impregchance]";
		hyenaify;
		stop the action;
	else:
		say "     Gina gives you a lewd grin as you accept her implicit invitation to join her. Before you can react, she reaches out and hauls you down onto the mattress beside her.";
		if Player is male:
			say "     She grins as she reaches down to stroke your stiffening manhood, her musky scent flooding you with desire as she runs her rough paw-like palm over you. 'Mmmm, I know what I want,' she mutters as she pushes your back into the mattress and climbs over you, one paw reaching behind your head and pulling you into a lewd wet kiss, while her other guides your cock into her hot folds. You moan into her muzzle as she begins to grind herself down on you, her cock rubbing up between you as her cunt massages you tightly. Her expert movements soon have you orgasming within her, your seed shooting up into her waiting canal, triggering her own body to shudder in orgasm. Her tight wetness clenching around your manhood as you orgasm together, and her cock explodes in orgasm as well, shooting its sticky hyena seed all over your chest and face, coating you in her fertile treasure. When you are both done with the intense orgasm, she rests for a second before pulling herself off of you with a wet sucking sound, before collapsing on the mattress next to you, her hands still roaming your bodies as she rubs her seed into your skin.";
			if Player is female:
				say "     'Mmmm, that was good,' Gina says as she lies next to you, her hand reaching down to massage your wet cunt. 'Maybe next time I'll let you feel me come inside you instead, you'd like that wouldn't you?' Gina says as she relaxes next to you, surprisingly enough you find yourself actually looking forward to that possibility.";
		else:
			say "     'Let's play a little, shall we?' Gina says as her hand reaches down to massage your warm wetness, causing you to gasp in surprise and immediate arousal. She quickly takes advantage of your open mouth, covering it with her own rough muzzle in a very through and deep kiss, her tongue tangling with your own as the taste of her fills your mouth. You moan in pleasure as her fingers slip inside you, rubbing against your inner walls with her rough fingers as she begins to slowly rub them back and forth in you. You moan in desperation and need as she teases your clit with her thumb, and her coarse fur rubs against your naked body as she grinds herself against your side. Soon enough she brings you to the peak of orgasm, your body begging for just that last little bit of stimulation to push you over the edge. Gina stops for a minute, leaving you panting and right at the edge, as her other hand goes down to her stiff cock and begins stroking it. You're unsure what she is doing until she begins moving her hand into you again in time with each stroke of her cock. Within seconds you are crying out in orgasm, your tight folds gripping her wonderful fingers, even as she brings herself to climax with her hand, her hot seed shooting all over your body as you both shudder in orgasm together. You collapse bonelessly on the mattress as she snuggles up next to you, her hands idly rubbing her seed into your skin as you both curl up together for a time.";
		hyenaify;
		increase ginaslut by 1;


to say hyenamat_challenge:
	now inasituation is true;
	now fightoutcome is 100;
	Challenge "Herm Hyena";
	if fightoutcome >= 10 and fightoutcome <= 19:
		Challenge "Herm Hyena";
		if fightoutcome >= 10 and fightoutcome <= 19:
			Challenge "Hyena Matriarch";
			if fightoutcome >= 10 and fightoutcome <= 19:			[victory]
				increase score by 0; [do nothing extra]
			else if fightoutcome >= 20 and fightoutcome <= 29:	[lose to matriarch]
				increase score by 0; [do nothing extra]
		else if fightoutcome >= 20 and fightoutcome <= 29:		[lose to guard #2]
			say "     Beaten by the matriarch's guard, you are mockingly dragged in front of the matriarch. She strikes you several times while the other hyenas hold you before you are tossed to the ground at her feet.";
			say "[matriarch attack]";
			hyenaify; [second infect to match matriarch fight loss]
			decrease morale of Player by 5;
	else if fightoutcome >= 20 and fightoutcome <= 29:			[lose to guard #1]
		say "     Beaten by the matriarch's guard, you are mockingly dragged in front of the matriarch. She strikes you several times while the other hyenas hold you before you are tossed to the ground at her feet.";
		say "[matriarch attack]";
		hyenaify; [second infect to match matriarch fight loss]
		decrease morale of Player by 5;
	if fightoutcome >= 30:									[flee any fight]
		say "     Your attempt to flee results in the mocking laugh of the rest of the gang. Several of them grab onto you and you're dragged back in front of the matriarch, who strikes your several times while the other hyenas hold you. You are then tossed to the ground at her feet.";
		say "[matriarch attack]";
		hyenaify; [second infect to match matriarch fight loss]
		decrease morale of Player by 10;
		now HP of Player is 1;
	now inasituation is false;


to say hyenamat_victorytf:
	setmonster "Herm Hyena";
	choose row MonsterID from the Table of Random Critters;
	say "     As the hyena orgy goes on, you feel a growing sense of confidence and empowerment. Looking over yourself, you can see that the victory has not left you unchanged. Your hyena body's gotten larger and stronger with an improved physique. You gain several inches of height as well, making you all the more impressive for leading the gang. You've become a powerful figure suitable for your new role as the gang's matriarch.";
	now tailname of Player is "Herm Hyena";
	now facename of Player is "Herm Hyena";
	now skinname of Player is "Herm Hyena";
	now bodyname of Player is "Herm Hyena";
	now cockname of Player is "Herm Hyena";
	now tail of Player is tail entry;
	now face of Player is face entry;
	now skin of Player is skin entry;
	now body of Player is body entry;
	now cock of Player is cock entry;
	attributeinfect;
	now Cock Length entry is 15; [ Length infection will make cock grow to if cocks]
	now Ball Size entry is 8; [ Size of balls apparently ;) sneaky Nuku]
	now Nipple Count entry is 2; [ Number of Breasts infection will give you. ]
	now Breast Size entry is 5; [Size of breasts infection will try to attain ]
	now Cunt Count entry is 1; [ if sex = "Female or both", indicates the number of female sexes infection will grant you.]
	now Cunt Length entry is 15;
	now Cunt Tightness entry is 9;
	follow the sex change rule;
	follow the sex change rule;
	if Libido of Player < libido entry, now Libido of Player is libido entry;


Hyena Hideout ends here.
