Version 2 of Meredith by Stripes begins here.
[Version 2 - Pregnancy and Gwen]
[Version 2.1 - Minor maintenance and character relocation - Luneth]

"Adds another member of the paratrooper squad triggered by Vanessa to Flexible Survival."

[ HP of Meredith                                     ]
[ 0 = unactivated                                    ]
[ 1 = saved                                          ]
[ 2 = talked to                                      ]
[ 3 = lectured                                       ]
[ 4 = first tf                                       ]
[ 5 = second tf                                      ]
[ 6 = complete tf                                    ]
[ 7 = had sex after tf                               ]
[ 8 = had sex again                                  ]
[ 9 = prompted for Medea visit                       ]
[ 10 = Medea visit completed (UB)                    ]
[ 11 = ready to be bred (no-UB or UB done)           ]
[ 12 = been knocked up                               ]
[ 100 = not saved                                    ]

[ libido of Meredith                                 ]
[ 0 = M/F virgin                                     ]
[ 1 = Had M/F                                        ]
[ 2 = Had M/F w/player                               ]

[ lust of Meredith                                   ]
[ Meredith UB                                        ]
[ 0 = inactive                                       ]
[ 1 = used on Gwen                                   ]
[ 2 = used on player                                 ]

[ XP of Meredith                                     ]
[ 0 = not preggers                                   ]
[ 1-12 = early preggers                              ]
[ 13-24 = late preggers                              ]
[ 25+ birth time                                     ]

[ level of Meredith                                  ]
[ number of kids                                     ]

[ HP of Gwen                                         ]
[ 0 = not met                                        ]
[ 1 = non-UB tf - sent to Dry Plains                 ]
[ 2 = UB'd                                           ]

meredith_coleen_fun1 is a truth state that varies. meredith_coleen_fun1 is usually false.
meredith_anal is a truth state that varies. meredith_anal is usually false.
meredith_vanessa_fun1 is a truth state that varies. meredith_vanessa_fun1 is usually false.
meredith_vanessa_fun2 is a truth state that varies. meredith_vanessa_fun2 is usually false.

Section 0 - Rescue Attempt

to say Meredith_rescue:
	now inasituation is true;
	say "     As you chat with Vanessa, she gets quite serious and motions for you to come a little closer. She slips an electronic device from her pack. 'We had a researcher with our group we were supposed to escort during our scouting mission. She's got a tracer on her, which I've got the locator for. For security, the rest of the team didn't know about the tracer, but the brass figured someone on the team needed to be able to track her down if we got separated.' She keeps her voice low as she explains all this to you.";
	say "     'Now, I shouldn't be telling you all this, let alone letting you see the tracker, but the situation's changed. When my squad was blown off course and separated, I'd lost track of her signal. I figured she'd gotten infected, with her clothes and the transmitter getting destroyed. But as you can see,' she says, showing you the screen and the blip on it, 'she's reappeared and has been on the move ever since. I have to guess wherever she was hiding was shielding the signal until she resurfaced. Her path is very erratic and never stops moving for long, so I think she's trying to get away from something. Since I'm down my squad and you're familiar with the city, can I get you to help me rescue her?  It would really mean a lot to me,' she says, reaching for her pack. Shall you accompany her on the rescue attempt?";
	if the player consents:
		say "     Since she's clearly going to go out there regardless if you're coming or not, you nod in agreement and prepare to venture forth[if Coleen is bunkered]. She calls Coleen over as well to join your impromptu rescue team[end if].";
		say "     You[if Coleen is bunkered] and Coleen[end if] follow the tracker to the city's seedier red light district. While the [if Coleen is bunkered]two soldiers don't say anything, they're clearly nervous about entering such a sexualized area[else]soldier doesn't say anything, she's clearly nervous about entering such a sexualized area[end if], even with you escorting them[if Entrance to the Red Light District is known]. Having been there before, you try to seem confident for them[else]. Having not ventured into the area before, you try your best to hide your own uncertainty[end if]. You move steadily towards the blip on the monitor, sometimes having to adjust your path because of its movements or to avoid some of the residents of the area.";
		attempttowait;
		if Coleen is bunkered:
			say "     As you're getting close, you spot a half-dozen kangaroo women ahead of you. They seem quite excited and are clearly tracking the same target as you. These must be the researcher's pursuers. Before you can close the distance, they break off into three teams of two, in an attempt to surround their quarry. It looks like there's no time to avoid them and you'll need to confront the marsupial females if you're to rescue the woman. You all split up, breaking off to each deal with one of the groups before they can reach her. Suddenly on your own, you rush forward, trying to take down the two you've got to deal with.";
			say "     Getting closer, you can hear them saying something about 'grabbing her for tonight's entertainment' before they notice you. One hesitates briefly, torn between pursuing their prey and facing you, but the other charges at you in quick bounds.";
			challenge "Red Kangaroo";
			if fightoutcome >= 10 and fightoutcome <= 19:
				say "     Having beaten and dealt with the first of them, you turn your attention to the other one. You hope for a moment she might break and run for it, but instead her eagerness for sex drives her to come after you as well.";
				challenge "Red Kangaroo";
				if fightoutcome >= 10 and fightoutcome <= 19:
					say "     With the second of them down, you press forward in the direction they were headed. Lacking the tracking unit, you can only head in the direction of the reseacher's last known position. Fortunately, you're able to catch the sounds of a struggle and turn towards it. There you find Vanessa and Coleen making their stand together to protect her squadmate. Thankfully, the woman seems uninfected for the moment. Her two protectors are worn, but so are the encroaching kangaroos. When you come in at them from behind, one of them breaks off and makes a run for it, leaving her companions to yell indignities at her. The soldiers use this opportunity to counterattack, and you wade into the fray moments later. Soon enough, the other roos are forced to retreat.";
					say "[meredithrescue_succeed]";
				else if fightoutcome >= 20 and fightoutcome <= 29:
					say "[meredithrescue_fail]";
				else:
					say "[meredithrescue_flee]";
			else if fightoutcome >= 20 and fightoutcome <= 29:
				say "[meredithrescue_fail]";
			else:
				say "[meredithrescue_flee]";
		else:
			say "     As you're getting close, you spot a half-dozen kangaroo women ahead of you. They seem quite excited and are clearly tracking the same target as you. These must be the researcher's pursuers. Before you can close the distance, they break off into two teams of three, in an attempt to surround their quarry. It looks like there's no time to avoid them and you'll need to confront the marsupial females if you're to rescue the woman. You both split up, breaking off to both deal with one of the groups before they can reach her. Suddenly on your own, you rush forward, trying to take down the three you've got to deal with.";
			say "     Getting closer, you can hear them saying something about 'grabbing her for tonight's entertainment' before they notice you. While the first of them charges in at you in quick bounds, the other two hesitate, torn between torn between pursuing their prey and facing you.";
			challenge "Red Kangaroo";
			if fightoutcome >= 10 and fightoutcome <= 19:
				say "     With the first of them dispatched, you are about to continue on when the second of them comes rushing forward.";
				challenge "Red Kangaroo";
				if fightoutcome >= 10 and fightoutcome <= 19:
					say "     Having beaten and dealt with the other two, you turn your attention to the last of them. You hope for a moment she might break and run for it, but instead her eagerness for sex drives her to come after you as well.";
					challenge "Red Kangaroo";
					if fightoutcome >= 10 and fightoutcome <= 19:
						say "     With the trio down, you press forward in the direction they were headed. Lacking the tracking unit, you can only head in the direction of the reseacher's last known position. Fortunately, you're able to catch the sounds of a struggle and turn towards it. There you find Vanessa making her stand to protect her squadmate. Thankfully, the woman seems uninfected for the moment. Her protector is worn, but so are the encroaching kangaroos. When you come in at them from behind, one of them breaks off and makes a run for it, leaving her companions to yell indignities at her. The centaur uses this opportunity to counterattack, and you wade into the fray moments later. Soon enough, the other roos are forced to retreat.";
						say "[meredithrescue_succeed]";
					else if fightoutcome >= 20 and fightoutcome <= 29:
						say "[meredithrescue_fail]";
					else:
						say "[meredithrescue_flee]";
				else if fightoutcome >= 20 and fightoutcome <= 29:
					say "[meredithrescue_fail]";
				else:
					say "[meredithrescue_flee]";
			else if fightoutcome >= 20 and fightoutcome <= 29:
				say "[meredithrescue_fail]";
			else:
				say "[meredithrescue_flee]";
		follow the turnpass rule;
		now Entrance to the Red Light District is known;
	else:
		say "     Deciding you don't want to get involved in what seems to you like a wild goose chase, you tell her you've got other matters to deal with. She seems rather disappointed that you won't be coming along, but nods and quickly finishes getting ready. She hugs her [if XP of Vanessa is 2]child[else]children[end if] and heads on her way";
		if Coleen is bunkered:
			say " with Coleen at her side. You go about your own business, though you do notice as time wears on that they've not returned. Past the point of expecting to never see them again, the bunker door is opened and Coleen, looking quite battleworn and exhausted, stumbles inside[if sarah is bunkered]. She pushes past you with an angry grunt and staggers over to Sarah to be comforted[else]. She pushes past you with an angry grunt and staggers over to her bunk to pass out[end if]. It's very clear the rescue failed and that Vanessa will not be returning at all.";
			now lastfuck of Coleen is turns - 8;
		else:
			say ". You go about your own business, though you do notice as time wears on that she's not returned. Eventually you have to presume she simply won't be coming back at all.";
		now HP of meredith is 100;
		now HP of Vanessa is 51;
		remove Vanessa from play;
	now inasituation is false;


to say meredithrescue_succeed:
	say "     While Vanessa trots after the fleeing mob of kangaroos, you're free to check of Vanessa's squadmate. This woman, the researcher they were to escort around while scouting, is clearly not a soldier[if Coleen is bunkered] like the others[end if]. While not out of shape, she's not got the same physical strength one would expect from someone in the military. Instead she seems rather bookish with her nerdy glasses and the plain haircut her ginger hair's been given. While no model, she's fairly pretty in a geeky sort of way.";
	say "     Still catching her breath after the extended chase and last-minute rescue, it takes her a moment to overcome her shock enough to stagger to her feet and start inching slowly along the wall she's backed up against. 'Umm... thanks for... dealing with those... ah... girls. I'll just be going now. If you don't mind, that is,' she says nervously, inching closer to the edge of the building.";
	say "     'And after all the trouble we went through to find you, that's the thanks we get,' Vanessa teases as she canters back over to the woman.";
	say "     'No, that's okay. I'll jus... Vanes... whaaaa!  Oh no!  My notes!' she exclaims first in surprise and then in panic as she spills her papers and they start to blow away. She scrambles to grab them while babbling her thanks for the rescue, surprise at Vanessa[if Coleen is bunkered and Sarah is bunkered] and Coleen's transformations[else][']s transformation[end if] and elation at having found some friendly faces. As she starts straightening up one handful, another bunch slip free from under her arm, spilling onto the ground. While you should probably be helping her, you can't help but watch and sneak peeks at her ass or bosom when she bends over to pick up papers[if Coleen is bunkered]. From the way Vanessa and Coleen just roll their eyes and smile, such clumsiness is probably typical of her. Eventually you all do go over and help her deal with them so you can make your way back to the safety of the library[else]. From the way Vanessa just rolls her eyes and smiles, such clumsiness is probably typical of her. Eventually you both do go over and help her deal with them so you can make your way back to the safety of the library[end if].";
	attempttowait;
	if Coleen is bunkered:
		say "     While on the way back to the library, she's introduced to you as Meredith, which they shorten to Mere at times. She's given a quick explanation of the situation at the hidden bunker and what little is known about the rest of the team. Vanessa and Coleen also give quick summaries of their misadventures before asking what happened with her.";
	else:
		say "     While on the way back to the library, she's introduced to you as Meredith, which the centaur shortens to Mere at times. She's given a quick explanation of the situation at the hidden bunker and what little is known about the rest of the team. Vanessa also gives a quick summary of her misadventure before asking what happened with her.";
	say "     'Well, I was busy taking photos while parachuting down, so I didn't notice we'd gotten blown apart until we'd gotten separated. My landing was a little rough, but I'd thankfully ended up on top of a parking garage instead of out in the open with creatures. I headed down in the underground sections and found a service room a few floors down. The creatures went there infrequently and usually only in couples, so it was pretty easy to stay hidden. When they did come by, usually to make out in one of the cars, I hid and took notes on their behaviour,' she says, leafing through her papers. 'The El Camino was particularly popular for some reason,' she giggles, blushing a bit.";
	say "     'I'd probably have waited this out down there as long as I could. It was a fascinating place to observe the... ummm... activities of the various infection subspecies in the area. But then those kangaroo girls came by. From what I overheard, one of them had spotted me while she and a male were down there and came back with her friends to catch me. They've been trying to get me for quite some time, even searching for me whenever I'd found a new hiding spot. I have to surmise they wanted me for more than the usual quick romp. According to my figures, without some further impetus, there's a 45% chance they'd have broken out into a spontaneous makeout session within the first hour and the probability rises to-wahhh!  Ooof!' she moans, having turned to walk backwards while showing you a graph she'd drawn, resulting in her falling on her ass as she stumbles onto the library steps. Vanessa kindly helps her up, though you do catch the centaur's hand running across the girl's rear while she does. You all head inside and Meredith flops herself out on one of the cots, clearly pleased to have a chance to rest on something even remotely resembling a bed.";
	now HP of meredith is 1;
	move meredith to Back Of The Library;
	now lastfuck of meredith is turns;

to say meredithrescue_fail:
	say "     Beaten by the kangaroos, you are distracted with sex for quite some time. By the time you recover your senses and go looking for the others, all you find are some torn scraps of cloth and the signs of a struggle. You make your way back to the bunker to recover. ";
	if Coleen is bunkered:
		say "     About a half-hour later, Coleen manages to make it back to the bunker, looking quite battleworn and exhausted as she stumbles inside[if sarah is bunkered]. She gives you a brief hug before staggering over to Sarah to be comforted[else]. She gives you a brief hug before staggering over to her bunk to pass out[end if]";
	else:
		say "     You wait for quite some time for any sign of either the centaur woman or her teammate, but neither show";
	say "     It's painfully clear to you that Vanessa will not be returning at all.";
	now HP of meredith is 100;
	now HP of vanessa is 51;
	remove vanessa from play;

to say meredithrescue_flee:
	say "     Making your escape from the kangaroos, you have to withdraw and hope the others will be alright. You make your way back to the library to wait and recover. ";
	if Coleen is bunkered:
		say "     About a half-hour later, Coleen manages to make it back to the bunker, looking quite battleworn and exhausted as she stumbles inside[if sarah is bunkered]. She gives you a brief hug before staggering over to Sarah to be comforted[else]. She gives you a brief hug before staggering over to her bunk to pass out[end if]";
	else:
		say "     You wait for quite some time for any sign of either the centaur woman or her teammate, but neither show";
	say "     It's painfully clear to you that Vanessa will not be returning at all.";
	now HP of meredith is 100;
	now HP of vanessa is 51;
	remove vanessa from play;


Section 1 - Meredith the Mare

Meredith is a woman.
The description of Meredith is "[meredithdesc]".
The conversation of Meredith is { "Oops!" }.

the scent of the Meredith is "[if HP of Meredith is 1]Meredith still has the stale and fading scent of a parking garage clinging to her[else]Meredith smells of horses and female arousal[end if].".

to say meredithdesc:
	if HP of meredith is 0 or HP of Meredith is 100:
		say "ERROR-Meredith-[HP of Meredith]L: You should not be able to find me!";
		remove Meredith from play;
	else if HP of meredith is 1 or HP of meredith is 2 or HP of meredith is 3:
		say "     Meredith is a researcher that Vanessa's scouting team was to escort during their failed mission. Having been found and rescued, she's been brought back here to await recovery by the military. She's a rather plain young woman with an average build, though the occasional peek you've snuck show her to have some nice tits and a cute ass. She's fairly pretty in a geeky sort of way once you look past her nerdy glasses and the plain haircut her ginger hair's been given. She's wearing a gray shirt and khaki cargo pants. Her many pockets hold a collection of technical and scientific instruments, which she fiddles with frequently. Having found an old binder in the library, she's stuffed her crumpled notes into it and can often be found adding to them.";
	else if HP of meredith is 4:
		say "     Meredith is a researcher that Vanessa's scouting team was to escort during their failed mission. Having been found and rescued, she's been brought back here to await recovery by the military. Once a rather plain young woman with an average build, her clumsiness has resulted in her getting partially infected. Her changes are relatively minor, having gained horse hooves for feet, a short equine tail and pointy ears. That aside, she's fairly pretty in a geeky sort of way once you look past her nerdy glasses and the plain haircut her ginger hair's been given. She's wearing a gray shirt and khaki cargo pants. Her many pockets hold a collection of technical and scientific instruments, which she fiddles with frequently. Having found an old binder in the library, she's stuffed her crumpled notes into it and can often be found adding to them.";
	else if HP of meredith is 5:
		say "     Meredith is a researcher that Vanessa's scouting team was to escort during their failed mission. Having been found and rescued, she's been brought back here to await recovery by the military. Once a rather plain young woman with an average build, her sexual release has resulted in her infection progressing further. While she's still wearing her gray shirt and khaki cargo pants, you know her legs have become fully equine all the way from her horse hoof feet to her equine ass and lush tail. While currently covered, you know the glossy coat of her legs is a russet red, darkening to a chestnut brown at her ankles. Quite visible are the horsey ears atop her head which threaten to topple her glasses when they flick around excitedly. That aside, she's fairly pretty in a geeky sort of way once you look past her nerdy glasses and the plain haircut her ginger hair's been given. The many pockets of her ill-fitting pants hold a collection of technical and scientific instruments, which she fiddles with frequently. Having found an old binder in the library, she's stuffed her crumpled notes into it and can often be found adding to them.";
	else if HP of meredith >= 6:
		say "     Once a researcher to be escorted around the city by Vanessa's scouting team, Meredith's become another centaur like her soldier friend. Through misadventure and carnal encouragement, she's been transformed into a horny centaur mare roughly two hands shorter than her stronger protector[if Coleen is bunkered]. Vanessa and Coleen have taken[else]. Vanessa has taken[end if] to referring to her as [']Mare['], a habit you're picking up as well. Mare's become a little more physically fit and has gained a bit of colour to her previously pale skin. Her equine lower half is covered in a russet red coat changing to chestnut at her ankles. Her red hair's darkened a little, having become a vibrant dark red that matches well with her rusty colouration. She's gained a luxurious tail that she's happy to raise playfully to give you a peek at her juicy mare pussy. While still wearing her gray shirt, she's cut up and repurposed her cargo pants into pocketed saddlebags to carry her collection of technical and scientific instruments. When not taking notes of her observations in her binder, she fiddles with these frequently.";
		if HP of Meredith is 10:
			say "     Her equine belly is full and rounded with its occupant. The mare seems quite pleased with herself, blushing at the cheeks and smiling happily. Given the size, you don't expect it'll be too long before Gwen emerges as her foal.";
		else if HP of Meredith is 11:
			say "     Meredith seems in good spirits after her visit to the clinic. With the promise of being able to get pregnant soon, she seems to make an extra effort to raise her tail and show her winking pussy. The scent of her arousal is strong in the air.";
		else if HP of Meredith is 12:
			if XP of Meredith is 0:
				say "     Meredith is in good spirits as she busies herself with her projects and notetaking. Having had a foal, she seems ready and eager to have another, though is a bit more patient in her demands. Though from the way her pussy's winking and the scent of her arousal in the air, it's clear her body's ready for another";
			else if XP of Meredith < 13:
				say "     Meredith is in good spirits as she busies herself with her projects and notetaking. The early signs of her pregnancy have started to show and she couldn't be more pleased";
			else if XP of Meredith > 12:
				say "     Meredith is in good spirits as she busies herself with her projects and notetaking. Her equine belly is full and rounded with her growing pregnancy. The mare seems quite pleased with herself, blushing at the cheeks and smiling happily. Given the size, you don't expect it'll be too long before her new foal emerges";
			if level of Meredith is 1:
				say ". Meredith's foal, having matured rapidly as most kids seem to be doing now, has gone off to the Dry Plains outside the city[if HP of Gwen is 1] with instructions to meet up with Gwen[else if HP of Gwen > 60] with instructions to meet up with their big sister Gwen[end if]";
			else if level of Meredith > 1:
				say ". Meredith's [level of Meredith] foals, having matured rapidly as most kids seem to be doing now, have gone off to the Dry Plains outside the city[if HP of Gwen is 1] with instructions to meet up with Gwen[else if HP of Gwen > 60] with instructions to meet up with their big sister Gwen[end if]";
			say ".";
		say "     She's moved her stuff over to a cot next to Vanessa's and the two of them can often be seen snuggling or making out together when not else busy[if Gwen is booked and HP of Gwen <= 20]. Her young foal, Gwen, is often snuggled up beside her or nursing from the mare's breast when Mare's not else occupied[else if Gwen is booked and HP of Gwen <= 35]. Her growing foal, Gwen, has taken the bunk on the opposite side and has taken an interest in her mother's research and notes[else if Gwen is booked and HP of Gwen <= 60]. Gwen's taken the bunk on the other side of Meredith and is often assisting her mother with her research and organizing her notes when she's not enjoying Vanessa's company[end if][if Coleen is booked and ( coleenslut > 0 or coleenalpha > 0 or coleencollared > 0 )]. Coleen often visits them as well, joining in on the fun with her transformed teammates[end if].";


Section 2 - Conversation

instead of conversing the Meredith:
	if HP of meredith is 0 or HP of Meredith is 100:
		say "ERROR-Meredith-[HP of Meredith]T: You should not be able to talk to me!";
		remove Meredith from play;
	else if HP of meredith is 1:
		say "     'I want to thank you for helping Vanessa find me. I was really afraid those kangaroos would get me in the end. Aside from something about a pub, I didn't really catch what they were talking about when they came after me. I was too focused on avoiding spending the rest of my days as a horny marsupial.' Meredith adjusts her glasses, using the motion to try and obscure her blushing.";
		say "     'But I should be pretty safe here,' she says, looking around the library. 'Secluded, fortified and built to house lots of survivors over the long term - this should be a secure place to await rescue. Staying here will limit my research... unless you can keep finding more survivors got me to examine and observe.'";
		now HP of Meredith is 2;
		now lastfuck of Meredith is turns;
	else if HP of meredith is 2 and lastfuck of meredith - turns >= 8:
		say "     Going over to speak with Meredith, you see that she's busily smoothing out her notes and re-sorting them into piles. Seeing you there, she smiles and motions for you to take a seat. 'I've been able to do some analysis and I have some findings to go over with you. Like I said, I was able to observe numerous creatures in and around the parking garage,' she says, holding up a hand-drawn map of the layout of the cars. It includes a tally of the number of times it was [']visited['] as well as page references to each individual visit.";
		say "     'There's some definite behaviour patterns that begin to emerge as you start to compare between several individuals of a given strain. There's definite trends and interests systemic to particular groups, as you've probably noticed already. Common mannerisms and attitudes, similar pick-up lines, predilections for certain forms of intercourse... clearly this behaviour has to be carried over and induced in the victims by the nanites,' she says as she shows you several charts and graphs which you can't make heads or tails of, but nod regardless. 'In many ways, those overcome by the infection can become slaves to the narrow set of instincts particular to their strain, locked into a limited set of behaviour patterns because of the overwhelming stimuli. Clearly, there are individual exception to these, but most who become infected and especially new offspring of a strain are primarily influenced by the mental changes enforced by the nanites.'";
		say "     As she continues on, she starts going into numbers and percentages as more hand-drawn charts are pulled out. You start to glaze over as the technical jargon becomes thicker. It's only when she accidentally knocks a brown envelope off the cot and numerous photographs of creatures caught mid-coitus spill out that she stops. 'Eeep!  My... umm... reference images.' Blushing brightly, she quickly stuffs the photos, most of sex happening in or on a car, back into the envelope. 'So... ahh... yes, there's a lot to be learned by observing the infected and understanding their behaviour patterns.' And with that, she quickly stores away her notes and heads out into the library, still bright red in the cheeks. Your head is still quite confused by all the numbers and charts, but you were able to glean some useful information from among the barrage of scientific jargon (gaining [level of player + intelligence of player] XP).";
		increase XP of player by level of player + intelligence of player;
		now lastfuck of meredith is turns;
		increase HP of meredith by 1;
	else if HP of meredith is 2:
		say "     [one of]'Please keep an eye out for more survivors. Aside from helping with my research, this place is probably much safer for them to await rescue.'[or]'It's good to see Vanessa again, even if she's changed quite a bit. She certainly seems happy with it though.'[or]'I got to observe several very bizarre infections while out in the Red Light District. I'm glad [if Coleen is bunkered]Vanessa and Coleen weren't[else]Vanessa wasn't[end if] infected by any of the more extreme strains out in the city. While becoming a taur is a significant physiological alteration, there are much worse out there.'[or]'As exciting - ah... scientifically speaking, I mean - this all has been, I'm glad my first practical experience didn't end up being with some infected creature I don't even know.'[or]'I've taken a few samples from Vanessa[if the number of bunkered people + the number of booked people > 3] and the others[end if] to perform some tests.'[or]'I was able to make quite a few observations on the creatures during my time monitoring their - ahem - activities in the parking garage. Once I get my papers sorted and have a chance to look over, I should be able to share some of my results with you. Just the basic stuff though - military contract and all that. I'm sure you understand.'[or]'I'd seen quite a few creatures from my vantage point, including a few not normally native to the area. Those were usually accompanied by one of those tigress hookers. Oh man, could they yowl when... ahem... nevermind,' she says, blushing and turning away.[or]'During my observations, I'd not seen any creatures that really interested me. Well, many of them were quite exciting or interesting, but none that I'd particularly want to end up being. Vanessa's quite lucky to have been turned into such a pretty centaur.'[or]You go over to chat with Meredith, but she's gone and dropped something under her cot. You instead end up watching her cute little ass wiggle around as she squirms to reach it. By the time she's emerged, you've completely lost your train of thought and will have to come back later once you remember what you wanted to talk about.[or][if Coleen is bunkered][meredith_coleen_msg][else]'Please keep an eye out for any others from the squad. I'm worried about what may have happened to them.'[end if][or]'I've undergone treatment to make me more resistant to the infection, but in can only protect me so much. A concerted effort by all those marsupial girls would have been too much for it.'[in random order]";
	else if HP of meredith is 3 and lastfuck of meredith - turns >= 4:
		say "     Finding Meredith in the midst of some work, you approach her and ask what's up.";
		say "[meredith_tfaccident]";
	else if HP of meredith is 3:
		say "     [one of]'Please keep an eye out for more survivors. Aside from helping with my research, this place is probably much safer for them to await rescue.'[or]'It's good to see Vanessa again, even if she's changed quite a bit. She certainly seems happy with it though.'[or]'I got to observe several very bizarre infections while out in the Red Light District. I'm glad [if Coleen is bunkered]Vanessa and Coleen weren't[else]Vanessa wasn't[end if] infected by any of the more extreme strains out in the city. While becoming a taur is a significant physiological alteration, there are much worse out there.'[or]'As exciting - ah... scientifically speaking, I mean - this all has been, I'm glad my first practical experience didn't end up being with some infected creature I don't even know.'[or]'I've taken a few samples from Vanessa[if the number of bunkered people + the number of booked people > 3] and the others[end if] to perform some tests.'[or]'I hope my research is able to help you better understand the creatures out there. I'm going to continue my research as best I can from in here. As it is, I've gathered a lot of data and can use the quieter time in here to analyze it.'[or]'I'd seen quite a few creatures from my vantage point, including a few not normally native to the area. Those were usually accompanied by one of those tigress hookers. Oh man, could they yowl when... ahem... nevermind,' she says, blushing and turning away.[or]'During my observations, I'd not seen any creatures that really interested me. Well, many of them were quite exciting or interesting, but none that I'd particularly want to end up being. Vanessa's quite lucky to have been turned into such a pretty centaur.'[or]You go over to chat with Meredith, but she's gone and dropped something under her cot. You instead end up watching her cute little ass wiggle around as she squirms to reach it. By the time she's emerged, you've completely lost your train of thought and will have to come back later once you remember what you wanted to talk about.[or][if Coleen is bunkered][meredith_coleen_msg][else]'Please keep an eye out for any others from the squad. I'm worried about what may have happened to them.'[end if][or]'I've undergone treatment to make me more resistant to the infection, but in can only protect me so much. A concerted effort by all those marsupial girls would have been too much for it.'[in random order]";
	else if HP of meredith is 4:
		say "     [one of]'Please keep an eye out for more survivors. Aside from helping with my research, this place is probably much safer for them to await rescue.'[or]'It's good to see Vanessa again, even if she's changed quite a bit. I'm starting to see why she's so happy with it.'[or]'I got to observe several very bizarre infections while out in the Red Light District. I'm glad we weren't infected by any of the more extreme strains out in the city. While becoming a taur is a significant physiological alteration, equine [if Coleen is bunkered and sarah is bunkered]and canine [end if]strains are a lot prettier than others out there.'[or]'As exciting - ah... scientifically speaking, I mean - this all has been, I'm glad my first practical experience didn't end up being with some infected creature I don't even know.'[or]'I've taken a few samples from Vanessa[if the number of bunkered people + the number of booked people > 3] and the others[end if] to perform some tests. And I'll be extra-careful with them from now on.'[or]'I hope my research is able to help you better understand the creatures out there. I'm going to continue my research as best I can from in here. As it is, I've gathered a lot of data and can use the quieter time in here to analyze it.'[or]'I'd seen quite a few creatures from my vantage point, including a few not normally native to the area. Those were usually accompanied by one of those tigress hookers. Oh man, could they yowl when... ahem... nevermind,' she says, blushing and turning away.[or]'During my observations, I'd not seen any creatures that really interested me. Well, many of them were quite exciting or interesting, but none that I'd particularly want to end up being. Vanessa's looking quite pretty though as a centaur though, so I'm feeling okay about this,' she adds with a swish of her tail.[or]You go over to chat with Meredith, but she's gone and dropped something under her cot. You instead end up watching her cute little ass wiggle around while her little tail swishes as she squirms to reach it. By the time she's emerged, you've completely lost your train of thought and will have to come back later once you remember what you wanted to talk about.[or][if Coleen is bunkered][meredith_coleen_msg][else]'Please keep an eye out for any others from the squad. I'm worried about what may have happened to them.'[end if][or]'I'd undergone treatment to make me more resistant to the infection, but it's not the sort of thing that could withstand direct contact with a concentrated dose of infected nanites.'[or]'My own transformation has been very enlightening. While it wasn't planned, I wouldn't have understood how good the process can feel if it hadn't happened.'[in random order]";
	else if HP of meredith is 5:
		say "     [one of]'Please keep an eye out for more survivors. Aside from helping with my research, this place is probably much safer for them to await rescue.'[or]'It's nice to have Vanessa here for me as I transform. She's so... ahh... supportive,' she says, blushing quite a bit.[or]'There are some very bizarre infections out there in the city. You should be careful around those infections you want to avoid. I mean, Vanessa[if Coleen is bunkered], Coleen[end if] and I got lucky, but not everything out there are cute horseys[if Coleen is bunkered and sarah is bunkered] and doggies[end if].'[or]'As exciting - ah... scientifically speaking, I mean - this all has been, I'm glad my first practical experience ended up being with someone I knew over some random creature out in the city.'[or]'I've taken a few samples from Vanessa[if the number of bunkered people + the number of booked people > 3] and the others[end if] to perform some tests. And I'll be extra-careful with them from now on.'[or]'I hope my research is able to help you better understand the creatures out there. I'm going to continue my research as best I can from in here. Certainly the... ahh... more practical research has been helping me understand the powerful mental effects the infection can induce during intercourse. I look forward to... uh... continuing my research along those lines soon,' she adds with a nervous giggle.[or]'This equine form's is quite to my liking. I wonder if I'll be as pretty as Vanessa should my condition progress further,' she adds, looking over the transformed soldier with a mix of lust and admiration.[or]You go over to chat with Meredith, but she's gone and dropped something under her cot. You instead end up watching her cute horsey ass wiggle around while her equine tail swishes as she squirms to reach it. By the time she's emerged, you've completely lost your train of thought and will have to come back later once you remember what you wanted to talk about.[or][if Coleen is bunkered][meredith_coleen_msg][else]'Please keep an eye out for any others from the squad. I'm worried about what may have happened to them.'[end if][or]'I'd undergone treatment to make me more resistant to the infection, but it's not the sort of thing that could withstand direct contact with a concentrated dose of infected nanites.'[or]'My own transformation has been very enlightening. While it wasn't planned, I wouldn't have understood how good the process can feel if it hadn't happened. I find myself looking forward to changing further, though I can't be certain if it's solely because of the pleasure or if it is also induced by the infection trying to manipulate me into becoming fully infected. Either way, it is important to understand, as it is significant to the behavior of the infected masses.'[in random order]";
	else if HP of meredith >= 6 and ( coleenslut > 0 or coleenalpha > 0 or coleencollared > 0 ) and Coleen is bunkered and a random chance of 2 in 5 succeeds and meredith_coleen_fun1 is false:
		say "     You head over to chat with Meredith to find her over at Coleen's cot";
		say "[meredith_coleen_funscene1]";
	else if HP of meredith >= 6 and vanessa is booked and a random chance of 2 in 5 succeeds and meredith_vanessa_fun1 is false:
		say "     You head over to chat with Meredith to find her over at Vanessa's cot";
		say "[meredith_vanessa_funscene1]";
	else if HP of meredith >= 6 and vanessa is booked and a random chance of 2 in 5 succeeds and meredith_vanessa_fun1 is true and meredith_vanessa_fun2 is false:
		say "     You head over to chat with Meredith to find her over at Vanessa's cot";
		say "[meredith_vanessa_funscene2]";
	else if HP of meredith is 6 or HP of meredith is 7:
		say "     [one of]'Please keep an eye out for more survivors. Aside from helping with my research, this place is probably much safer for them to await rescue.'[or]'It's nice to have Vanessa here for me as I transformed. She's so... ahh... supportive,' she says, blushing quite a bit.[or]'There are some very bizarre infections out there in the city. You should be careful you won't pick up anything you'd rather avoid. I mean, not everything out there are cute horseys[if Coleen is bunkered and sarah is bunkered] and doggies[end if].'[or]'As exciting - ah... scientifically speaking, I mean - this all has been, I'm glad I've been able to safely have my practical experiences safely here under controlled circumstances rather than out in the wilds of the city.'[or]'I've taken a few samples from Vanessa[if the number of bunkered people + the number of booked people > 3] and the others[end if] to perform some tests. And I'll be extra-careful with them from now on.'[or]'I've been enjoying the... ahh... more practical research into the physical and mental effects of the infection on intercourse. I look forward to... uh... continuing my research along those lines soon,' she adds with a nervous giggle and a wink.[or]'This centaur infection I picked up from Vanessa is quite to my liking. It's turned out splendidly,' she adds, looking at the transformed soldier with a mix of lust and admiration.[or][if Coleen is bunkered][meredith_coleen_msg][else]'Please keep an eye out for any others from the squad. I'm worried about what may have happened to them.'[end if][or]'I'd undergone treatment to make me more resistant to the infection, so I should be quite safe from infection by other strains. As long as I'm careful to avoid direct contact again with a concentrated dose of infected nanites, that is'[or]'My own transformation has been very enlightening. While it wasn't planned, I wouldn't have understood how good the process can feel if it hadn't happened. I can't help but wonder how it'd feel to share that pleasure with others and show them how wonderful it is to be a centaur mare. I suspect this is a result of my own infection affecting my mind, though certainly they could do much worse than becoming centaurs. Empirically speaking, I would be helping them to avoid more unpleasant fates as other creatures,' she muses.[in random order]";
	else if HP of Meredith is 8:
		if libido of Meredith is 0, now libido of Meredith is 1;
		say "     Meredith shifts from hoof to hoof anxiously as you come up to talk to her, the other centaur having come over to join you. 'Actually, there's something Vanessa and I want to talk to you about. As you know, I've been continuing my research into the nanite infection. Now, Vanessa's been describing how nice it felt to be pregnant and we felt it was important that I try that too. For - ahh - purely scientific reasons,' she adds in a quick mumble, blushing brightly and trying to hide it by adjusting her glasses. 'It just hasn't been successful despite trying with [if libido of Meredith is 2]you and [else]several interesting candidates Vanessa's found for me out in the city.'";
		say "     Pulling out some notes and shuffling through them. 'From my observations, the probability of impregnation is quite high due to nanite intervention,' she says, flashing a table of figures. 'Given the number of attempts, it should have succeeded. When they were in me,' she says, consulting more notes, 'it was wonderful, but I consistently felt an empty need. It's like I just need something... more...'";
		say "     As Meredith drifts off into thought, musing over her notes in the hopes of finding the solution, Vanessa continues on for her. 'And fine, virile studs [if cocks of player > 0]like you [end if]they all were, too. Nothing but the best for my sweet Mare,' she says, putting an arm around the distracted centaur. 'Anyhow, so I was thinking, since you've explored a lot more of the city, that you might have come across someone who might be able to check our dear Mare out and see what the problem is.'";
		if medeaget >= 3:
			say "     Telling them that Dr. Medea should be able to help, the girls are eager to hit the road right away. Shall you [link]get going now (Y)[as]y[end link] or tell them to [link]wait (N)[as]n[end link] until everything's prepared?";
			if the player consents:
				say "[meredith_clinictrip]";
			else:
				say "     They seem a little disappointed to have to wait, but understand that you need to deal with your own issues as well. Meredith decides to focus on other avenues of research until you're ready to go.";
				now HP of Meredith is 9;
		else if medeaget is 2:
			say "     While you've gotten the equipment for the lizard doctor, you haven't given it to her yet and don't know for certain how that will work out. Rather than undertaking a risky and pointless trip, you tell them you may know of someone, but you'll need to make sure they're really willing and able to help out. They nod in agreement at this and urge you to do so at your earliest opportunity, Meredith planning to focus on other avenues of research until you're ready to go.";
			now HP of Meredith is 9;
		else if medeaget is 1:
			say "     Telling them you may have found someone like that, but adding that she needs some equipment, the centaurs encourage you to find whatever she needs. It seems you've not got another reason to find that [bold type]abandoned truck[roman type] for Dr. Medea. Meredith does decide to focus on other avenues of research until you've gotten things ready.";
			now HP of Meredith is 9;
		else:
			say "     Telling them you haven't found anyone like that yet, you do promise to keep a look out for a [bold type]pediatrics[roman type] clinic or something of the like. They thank you and wish you luck, Meredith deciding to focus on other avenues of research until then.";
			now HP of Meredith is 9;
	else if HP of Meredith is 9 and a random chance of 1 in 3 succeeds:
		if medeaget is 3:
			say "     'Have you been able to find someone able to help me get pregnant yet?  That aching emptiness inside me is distracting and I'd really like to... umm... advance to the next step in investigating the infection's effects on me,' she says with an eagerness beyond purely scientific interest. Shall you tell her that things are ready to go?";
			if the player consents:
				say "[meredith_clinictrip]";
			else:
				say "     Telling her that you've still got to make some more arrangements, she encourages you to take care of it as quickly as possible so her research can continue.";
		else:
			say "     'Have you been able to find someone able to help me get pregnant yet?  That aching emptiness inside me is distracting and I'd really like to... umm... advance to the next step in investigating the infection's effects on me,' she says with an eagerness beyond purely scientific interest. Telling her that you've not yet made arrangements, she encourages you to try visiting [if medeaget is 0]a [bold type]pediatrics[roman type] clinic[else]the pediatrics office and ensuring everything's ready for her visit[end if].";
	else if HP of Meredith is 9:
		say "     [one of]'Please keep an eye out for more survivors. Aside from helping with my research, this place is probably much safer for them to await rescue.'[or]'It's nice to have Vanessa here for me as I transformed. She's so... ahh... supportive,' she says, blushing quite a bit.[or]'There are some very bizarre infections out there in the city. You should be careful you won't pick up anything you'd rather avoid. I mean, not everything out there are cute horseys[if Coleen is bunkered and sarah is bunkered] and doggies[end if].'[or]'I've taken a few samples from Vanessa[if the number of bunkered people + the number of booked people > 3] and the others[end if] to perform some tests. And I'll be extra-careful with them from now on.'[or]'I've been enjoying the... ahh... more practical research into the physical and mental effects of the infection on intercourse. I look forward to... uh... continuing my research along those lines soon,' she adds with a nervous giggle and a wink.[or]'This centaur infection I picked up from Vanessa is quite to my liking. It's turned out splendidly,' she adds, looking at the transformed soldier with a mix of lust and admiration.[or][if Coleen is bunkered][meredith_coleen_msg][else]'Please keep an eye out for any others from the squad. I'm worried about what may have happened to them.'[end if][or]'I'd undergone treatment to make me more resistant to the infection, so I should be quite safe from infection by other strains. As long as I'm careful to avoid direct contact again with a concentrated dose of infected nanites, that is'[or]'My own transformation has been very enlightening. While it wasn't planned, I wouldn't have understood how good the process can feel if it hadn't happened. I can't help but wonder how it'd feel to share that pleasure with others and show them how wonderful it is to be a centaur mare. I suspect this is a result of my own infection affecting my mind, though certainly they could do much worse than becoming centaurs. Empirically speaking, I would be helping them to avoid more unpleasant fates as other creatures,' she muses.[in random order]";
	else if HP of Meredith is 10:
		say "     [one of]'Please keep an eye out for more survivors. Aside from helping with my research, this place is probably much safer for them to await rescue.'[or]'It's nice to have Vanessa here for me as I transformed. She's so... ahh... supportive,' she says, blushing quite a bit.[or]'There are some very bizarre infections out there in the city. You should be careful you won't pick up anything you'd rather avoid. I mean, not everything out there are cute horseys[if Coleen is bunkered and sarah is bunkered] and doggies[end if].'[or]'I've taken a few samples from Vanessa[if the number of bunkered people + the number of booked people > 3] and the others[end if] to perform some tests. And I'll be extra-careful with them from now on.'[or]'I've been enjoying the... ahh... more practical research into the physical and mental effects of the infection on intercourse. I look forward to... uh... continuing my research along those lines soon,' she adds with a nervous giggle and a wink.[or]'This centaur infection I picked up from Vanessa is quite to my liking. It's turned out splendidly,' she adds, looking at the transformed soldier with a mix of lust and admiration.[or][if Coleen is bunkered][meredith_coleen_msg][else]'Please keep an eye out for any others from the squad. I'm worried about what may have happened to them.'[end if][or]'I'd undergone treatment to make me more resistant to the infection, so I should be quite safe from infection by other strains. As long as I'm careful to avoid direct contact again with a concentrated dose of infected nanites, that is'[or]'My own transformation has been very enlightening. While it wasn't planned, I wouldn't have understood how good the process can feel if it hadn't happened. And now getting to share that with Gwen is all the better,' she says, reaching back to rub her pregnant belly.[or]'Having Gwen inside me feels so wonderful.'[or]'I never knew I could do that thing with Gwen. It's not something I'd observed before.'[in random order]";
	else if HP of Meredith > 10 and Gwen is booked and a random chance of 1 in 4 succeeds:
		say "[meredith_gwen_msg]";
	else if HP of Meredith is 11:
		say "     [one of]'Please keep an eye out for more survivors. Aside from helping with my research, this place is probably much safer for them to await rescue.'[or]'It's nice to have Vanessa here for me as I transformed. She's so... ahh... supportive,' she says, blushing quite a bit.[or]'There are some very bizarre infections out there in the city. You should be careful you won't pick up anything you'd rather avoid. I mean, not everything out there are cute horseys[if Coleen is bunkered and sarah is bunkered] and doggies[end if].'[or]'I've taken a few samples from Vanessa[if the number of bunkered people + the number of booked people > 3] and the others[end if] to perform some tests. And I'll be extra-careful with them from now on.'[or]'I've been enjoying the... ahh... more practical research into the physical and mental effects of the infection on intercourse. And now that I can get properly pregnant, I look forward to... uh... continuing my research along those lines soon,' she adds with a nervous giggle and a wink.[or]'I look forward to seeing how the infection will affect a pregnancy[if cocks of player > 0]. Perhaps you'd be able to help me with my research into that soon?' she asks, blushing[else]. It should be very... ah... informative,' she says, blushing[end if].[or]'This centaur infection I picked up from Vanessa is quite to my liking. It's turned out splendidly,' she adds, looking at the transformed soldier with a mix of lust and admiration.[or][if Coleen is bunkered][meredith_coleen_msg][else]'Please keep an eye out for any others from the squad. I'm worried about what may have happened to them.'[end if][or]'I'd undergone treatment to make me more resistant to the infection, so I should be quite safe from infection by other strains. As long as I'm careful to avoid direct contact again with a concentrated dose of infected nanites, that is'[or][if HP of Gwen is 1]'It's too bad Gwen couldn't stay, but Vanessa needs her to- ah- on that important mission.'[else if Gwen is bunkered]'Gwen's turned into a lovely centaur.'[else]'I'll miss Gwen, but Vanessa needs her to- ah- on that important mission.'[end if][in random order]";
	else if HP of Meredith is 12:
		say "     [one of]'Please keep an eye out for more survivors. Aside from helping with my research, this place is probably much safer for them to await rescue.'[or]'It's nice to have Vanessa here for me as I transformed. She's so... ahh... supportive,' she says, blushing quite a bit.[or]'There are some very bizarre infections out there in the city. You should be careful you won't pick up anything you'd rather avoid. I mean, not everything out there are cute horseys[if Coleen is bunkered and sarah is bunkered] and doggies[end if].'[or]'I've taken a few samples from Vanessa[if the number of bunkered people + the number of booked people > 3] and the others[end if] to perform some tests. And I'll be extra-careful with them from now on.'[or]'I've been enjoying the... ahh... more practical research into the physical and mental effects of the infection on intercourse. And now that I've had a chance to be properly pregnant, I look forward to... uh... continuing my research along those lines soon... and often,' she adds with a nervous giggle and a wink.[or]'I hope I can have lots of lovely foals during the course of my research.'[or]'This centaur infection I picked up from Vanessa is quite to my liking. It's turned out splendidly,' she adds, looking at the transformed soldier with a mix of lust and admiration.[or][if Coleen is bunkered][meredith_coleen_msg][else]'Please keep an eye out for any others from the squad. I'm worried about what may have happened to them.'[end if][or]'I'd undergone treatment to make me more resistant to the infection, so I should be quite safe from infection by other strains. As long as I'm careful to avoid direct contact again with a concentrated dose of infected nanites, that is'[or][if XP of Meredith is 0]'I can feel my body getting ready to be pregnant again. It is a most interesting sensation,' she says, taking some quick notes.[else if XP of Meredith < 13]'I've managed to become pregnant[meredith_again]. There's that special tingle in my equine womb. It's a surprisingly... satisfying sensation,' she says, making some quick notes.[else]'My new foal's coming along nicely,' she says, reaching back to stroke the side of her rounded belly.[end if][or][if HP of Gwen is 1]'It's too bad Gwen couldn't stay, but Vanessa needs her to- ah- on that important mission.'[else if Gwen is booked]'Gwen's turned into a lovely centaur.'[else]'I'll miss Gwen, but Vanessa needs her to- ah- on that important mission.'[end if][in random order]";

to say meredith_again:
	say "[if level of Meredith > 0] again[end if]";

to say meredith_gwen_msg:
	if Gwen is booked:
		if HP of Gwen <= 20:
			say "     [one of]'Gwen's such a sweet filly.'[or]'Doesn't Gwenny make such a cute foal?'[or]'Little Gwenny's growing up quickly. For some reason I've not yet been able to isolate, it's not as quickly as the rapid maturations that have been taking place, but it's still really fast.'[or]'Gwenny's growing like a weed. At this rate, she'll be a full-grown mare in about a week.'[or]Mare cuddles her filly while goin gover her recent notes.[or]'It feels so good to have a foal nursing from me,' she says, caressing her filly's head as she suckles for her momma's milk.[in random order]";
		else if HP of Gwen <= 35:
			say "     [one of]'Gwenny's been helping me with my work, mostly sorting through my notes or handing me equipment during my experiments.'[or]'Gwen still nurses for my milk to help her grow. Vanessa's wants her to be big like her, so she's been helping too.'[or]'Gwen's turning into such a pretty mare. I'm sure she'll be popular with the rest of the herd.'[or]'I'm teaching Gwenny everything I've learned about the infection. She really loves learning all about it.'[or]'Given how lovely Gwen's turning out to be, it seems that tail isn't the only trace of her encounter with those succubi.'[in random order]";
		else:
			say "     [one of]Gwen's so much help with my research. She's helping me with my experiments.'[or]Gwen's become such a lovely mare. She'll be the prettiest of the herd.'[or]'Gwen's learned so much that she's able to do some experiments of her own.'[or]Gwen's earlier succubus infection still seems to be lingering, though it's only made her lovelier.'[in random order]";


to say meredith_coleen_msg:
	if HP of meredith < 4:
		say "     [one of]'Vanessa and Coleen and all the rest of the squad were very nice to me even though I'm not a soldier. They got stuck with orders to escort me into and around the city. They were really patient with my clumsiness during our practice drops. I hope the rest of them are at least happy in their new lives.'[or][if coleenslut > 0 or coleenalpha > 0 or coleencollared > 0]'Coleen's been changed considerably by the infection, but part of her original self is still there. She's just gained some... added urges... that modify her overall behaviour. But she's a cute and happy husky, which is much better than many of the creatures I've seen out there.'[else if sarahslut > 0]'Coleen's showing some husky traits due to her contact with that other female victim. Scientifically speaking, it is interesting to watch the progression of her transformation. I can't help but be curious to see it through to completion,' she says, blushing a little.[else]'Coleen's been very fortunate to have avoided infection up to now. Unless we're recovered soon, I don't know how much longer she'll be able to stay human, even in here.'[end if][cycling]";
	else if HP of meredith is 4:
		say "     [one of]'Vanessa and Coleen and all the rest of the squad were very nice to me even though I'm not a soldier. They got stuck with orders to escort me into and around the city. They were really patient with my clumsiness during our practice drops. I hope the rest of them are at least happy in their new lives.'[or][if coleenslut > 0 or coleenalpha > 0 or coleencollared > 0]'Coleen's been changed considerably by the infection, but part of her original self is still there. She's just gained some... added urges... that modify her overall behaviour. But she's a cute and happy husky who's having a lot of fun.'[else if sarahslut > 0]'Coleen's showing some husky traits due to her contact with that other female victim. Scientifically speaking, it is interesting to watch the progression of her transformation and comparing it to my own. I can't help but be curious to see them it through to completion,' she says, blushing a little.[else]'Coleen's been very fortunate to have avoided infection up to now. Unless we're recovered soon, I don't know how much longer she'll be able to stay human, even in here.'[end if][cycling]";
	else if HP of meredith is 5:
		say "     [one of]'Vanessa and Coleen and all the rest of the squad were very nice to me even though I'm not a soldier. They got stuck with orders to escort me into and around the city. They were really patient with my clumsiness during our practice drops. I hope the rest of them are at least happy in their new lives.'[or][if coleenslut > 0 or coleenalpha > 0 or coleencollared > 0]'Coleen's been changed considerably by the infection, but part of her original self is still there. She's just gained some... added urges... that modify her overall behaviour. Being a cute and happy husky is proving to be a lot of fun for her.'[else if sarahslut > 0]'Coleen's showing some husky traits due to her contact with that other female victim. Scientifically speaking, it is interesting to watch the progression of her transformation and comparing it to my own. I can't help but be curious to see them both through to completion,' she says, blushing a little.[else]'Coleen's been very fortunate to have avoided infection up to now. Unless we're recovered soon, I don't know how much longer she'll be able to stay human, even in here.'[end if][cycling]";
	else if HP of meredith >= 6 and HP of meredith <= 9:
		say "     [one of]'Vanessa and Coleen and all the rest of the squad were very nice to me even though I'm not a soldier. They got stuck with orders to escort me into and around the city. They were really patient with my clumsiness during our practice drops and have been so supportive here as well,' she says, looking at the pair of them with admiration and desire.[or][if coleenslut > 0 or coleenalpha > 0 or coleencollared > 0]'Coleen's been changed considerably by the infection, but part of her original self is still there. She's just gained some... added urges... that modify her overall behaviour. Having her as a cute and playful husky's only made her more fun to be with,' she says, blushing at bit. The scent of equine arousal hints at just what sort of fun she might mean.[else if sarahslut > 0]'Coleen's showing some husky traits due to her contact with that other female victim. Scientifically speaking, it is interesting to watch the progression of her transformation and comparing it to my own. I hope you'll do what you can to help see it through to completion. I'd really like to observe it,' she says in a straight-faced, clinical manner, though the heady scent of her arousal hints that her interest isn't solely scientific.[else]'Coleen's been very fortunate to have avoided infection up to now. Unless we're recovered soon, I don't know how much longer she'll be able to stay human, even in here. It is interesting to observe her, waiting to see what might trigger her transformation.'[end if][cycling]";


to say meredith_tfaccident:
	say "     'I'm running some basic tests. Vanessa was kind enough to let me extract a nanite sample from her,' she says, holding up a vial of steel-gray slurry. 'The infection is actually caused by these nanites - microscopic machines capable of rearranging atoms and molecules. They're running amok with what seems like damaged or corrupted instructions. Their exact origins are unknown to me, but they are clearly designed to [']improve['] people. But either they got loose with faulty information or conflicting instructions, resulting in the many strains and bizarre anomalies as they attempt to fulfill their function. Often, it's like they're filling in gaps with whatever information or nearby reference they can latch onto. It makes analyzing them quite frustrating. Before this, I would have said some of the things I've observed to be impossible.'";
	say "     She holds the vial up to look at it against the fluorescent lights of the library, examining the murky, metallic fluid. 'Regardless, it's humbling that something so small can cause such chaos, isn't it?  Tiny ma-ahhh!' While looking at the vial, it slips from her hand, breaking open and spilling out on the ground. Thankfully neither of you were hit. 'Oh, that was close. Better clean that up before someone steps in it.' Pulling on some thick gloves, she wipes the mess up with a rag and sets it aside.";
	say "     'Now, where was I?' she mumbles, flipping through her extensive notes. Not finding what she's looking for, she sits back on her bunk and goes from one binder to the next. 'Ah, here we go. So as I was saying, the nanites are small machines only a few nanometers across. This means they're no room for them to house all the... ahhh... all the...' she trails off as she fidgets in her seat and tugs at the collar of her shirt as she gets quite flush in the face. 'You'll have to excuse me, I'm feeling quite out of sorts all of a sudden,' she mumbles before releasing a moan out of the blue. Looking at her behind, she eeps and sits up violently, revealing she'd sat on the nanite-suffused rag. From the silvery stain on the seat of her pants and the nub of an equine tail that's tearing its way free of them, it's clear she's accidentally infected herself.";
	say "     She moans again, hand pressing at her crotch and rubbing firmly over the fabric covering it. 'Oh my!  I knew this could be intense, but it is most unexpectedly pleasurable.' As you watch, her tail slowly extends itself as chestnut hair covers it until it has blossomed into fullness. As this is happening, you almost miss the subtle changes to her ears as they become more pointed and their tips darken a little. She wobbles briefly and you quickly grab her for support before she falls. Raising the cuff of her pantleg as she shakes off a now ill-fitting shoe, it is revealed that her feet have become hooves and her ankles are equine in shape. Her skin is darker and a fine coat of furry hair grows to cover it, affecting the lower six inches or so of her leg before the process slows to a halt and her changes have run their course.";
	say "     'This is quite the unfortunate turn of events. I'd hoped to remain uninfected at least until I'd had a chance to complete my observations.' She looks herself over as she wobbles on her unfamiliar hooves for a few steps. As infection strains go, it's not so bad though,' she says, giving her tail an experimental flick. 'By Newton, I should be chronicling this!' she exclaims loudly. 'I need to write down every detail of my transformation immediately.' And with that, she grabs a notepad and dashes off to the washroom, probably to give herself a more thorough examination in private.";
	now lastfuck of meredith is turns + 8;
	increase HP of meredith by 1;


Section 3 - Sex with Meredith

the fuckscene of Meredith is "[sexwithMeredith]".

to say sexwithMeredith:
	if HP of meredith is 0 or HP of Meredith is 100:
		say "ERROR-Meredith-[HP of Meredith]F: You should not be able to fuck me!";
		remove Meredith from play;
	else if player is neuter:
		say "     Lacking a gender of your own, you see little point in making out with Meredith.";
	else if HP of meredith is 3 and lastfuck of meredith - turns >= 4:
		say "     Going over to see if you can entice the nerdy girl into some fun, you find Meredith in the midst of some work. You approach her and ask what's up.";
		say "[meredith_tfaccident]";
	else if HP of Meredith is 1 or HP of Meredith is 2 or HP of Meredith is 3:
		say "     Meredith blushes at your offer, but turns away. 'I'm sorry, but that's the infection talking. I mean, I'm grateful for your help and all, but we hardly know each other. Besides, I should focus on my research.'";
	else if lastfuck of Meredith - turns < 6:
		say "     'Mmm... as informative as it has been, I could use a bit of a break. Besides, I need to write down my observations on how I've responded to our last session,' she says with a smile, casually groping herself with one hand as she scribbles down some notes.";
	else if HP of meredith is 4:
		say "     She is stopped short by your suggestion, pausing to pondering it for quite some time before responding. 'It is an... intriguing offer. There is some risk involved, as my infection may very well progress further, though even that means I'll be able to provide more personal data,' she says, musing on the matter. 'Certainly, it would be nice to get some hands on experience. While I suspect the infection to be involved, it has certainly been on my mind much more since entering the city. Definitely all the occurrences of coitus I've observed haven't helped in that regard. Very well,' she affirms, wrapping her arms around you and giving you a quick kiss. 'Let's [if cocks of player > 0]fuck[else]do it[end if]!'";
		if cocks of player > 0:
			say "     Meredith, while inexperienced, is certainly eager now that she's allowed herself to release her sexual desires. Her hands roam over your body, soon going for your stiff manhood. She moans softly and her tail flicks up reflexively at the first cock she's ever touched. Soon the tainted researcher is on her knees, nuzzling at your [cock of player] shaft while her tongue licks at it.";
			say "     Whether from the infection or her own observations, she quickly becomes more skilled at the task of orally pleasuring you. Her tongue and mouth work over your [cock size desc of player] shaft. Similarly, her fingers shift from a more inquisitive touching to sensual caresses. You rub your hand through her red hair, moaning encouragements to the eager young woman.";
			say "     Feeling yourself getting close and not wanting to pop off too soon, you coax her to release your shaft, reminding her that she asked you to fuck her. 'True enough,' she giggles eagerly as she shucks her clothes. She tumbles back onto her cot as her pant leg gets caught around her ankle. Finding herself naked and on her cot before she even realized she'd undressed, she shyly covers her breasts and crotch, suddenly embarrassed. You can't help but smile down at her, finding something endearing about the cute klutz.";
			say "     You slowly move onto the cot above her and give her a soft, tender kiss. As you do, you ease her hand away from her breasts and cup one of them, drawing a cute moan from her. Moments later, you guide her other hand away and stroke her dripping folds, getting a much louder moan from her. And when you replace your hand with your cock and thrust into her, that moan becomes a cry of delight. After giving her a moment to recover from the mini-orgasm of her first penetration, you rock your hips and fuck the increasingly lustful woman. You can tell that part of her is trying to remain focused enough to observe her own reactions, but every moment sees that waning in lieu of her throwing herself more excitedly into the carnal act. By the time you're cumming, shooting your [cum load size of player] load into her, she's crying out in orgasm as she wantonly fondles her tits - tits you can't help but notice have swollen a little larger and have darker nipples than just a few minutes earlier.";
			now libido of meredith is 2;
		else:
			say "     Meredith, while inexperienced, is certainly eager now that she's allowed herself to release her sexual desires. Her hands roam over your body, soon going for your damp cunny. She moans and releases a soft nicker at the first pussy she's ever touched outside her own. Soon the researcher is on her knees, nuzzling at your crotch and licking up your juices.";
			say "     Whether from the infection or her own observations, she quickly becomes more skilled at the task of orally pleasuring you. Her tongue and lips work over your [cunt size desc of player] pussy. Similarly, her fingers shift from a more inquisitive touching to sensual caresses. You rub your hand through her red hair, moaning encouragements to the eager young woman as she eats you out.";
			say "     Feeling yourself getting close and not wanting to rush things, you coax her to move back, reminding her that this is about her getting relief as well. 'True enough,' she giggles eagerly as she shucks her clothes. She tumbles back onto her cot as her pant leg gets caught around her ankle. Finding herself naked and on her cot before she even realized she'd undressed, she shyly covers her breasts and crotch, suddenly embarrassed. You can't help but smile down at her, finding something endearing about the cute klutz.";
			say "     You slowly move onto the cot above her and give her a soft, tender kiss. As you do, you ease her hand away from her breasts and cup one of them, drawing a cute moan from her. Moments later, you guide her other hand away and stroke her dripping folds, getting a much louder moan from her. And when you slip a few fingers into cunny while sucking on a nipple, that moan becomes a cry of delight. After giving her a moment to recover from the mini-orgasm of her first sexual contact, you pump your fingers into her quivering vagina and finger-fuck the increasingly lustful woman. You can tell that part of her is trying to remain focused enough to observe her own reactions, but every moment sees that waning in lieu of her throwing herself more excitedly into the carnal act. By the time she's crying out in full orgasm, she's excitedly fingering you and groping your bosom. While you moan in climax and grind down onto her probing digits, you lavish attention upon her lovely tits - tits you can't help but notice have become a little larger and have darker nipples than just a few minutes earlier.";
		attempttowait;
		say "     [if cocks of player > 0]After some lustful kissing, you withdraw your spent shaft and sit up[else]After some lustful kissing, you disentangle from one another and sit up[end if]. Meredith pants and moans, running her hands over herself, continuing to enjoy her sexual release. As you hear the clop of hooves coming closer, she looks over to see Vanessa smiling at her. Suddenly realizing she's very publicly had sex for the very first time, she eeps and sits up, slipping off the cot as she fumbles to cover herself with a blanket. The centaur soldier just pulls her friend into her arms and cuddles her. 'I'm very glad for you, Mere. The squad had been planning to set you up with someone once the mission was done, but I think it turned out better this way. Did you enjoy yourself?' she asks with a more sensual tone as she slips a hand between the girl's legs, teasing her [if cocks of player > 0]cum-slick[else]soaked[end if] pussy.";
		say "     Meredith moans and blushes brightly at the touch but doesn't pull away, even sighing a little as two fingers are slipped into her cunt. 'It... it was so nice. After all that teasing, getting to see so many others enjoying it, it felt wonderful to finally have sex. It still feels good,' she says contentedly, nuzzling back at the centaur woman holding her.";
		say "     'It's like a warm tingle from my hooves to my ears. Wait... how can I...?' Meredith starts to ask, looking down at her legs. You can see the darker socks of horsefur spread further up her ankles as a chestnut coat spreads up the rest of her legs even as they become more equine in shape. As the changes slow at her hips, her tail grows out longer with a swish of its russet red hair. Looking her over more fully, you can see that her chest has indeed filled out a little more and her nipples are larger with darker areolae. Her ears have drifted further up her skull and have become more even more pointed and have darkened considerably, now well on their way to become horse ears.";
		say "     Realizing she's changed further as well as had infection-fueled sex, she squirms free of Vanessa and rushes to add to her notes. The centaur chuckles at this and urges you to leave her be for now. Meredith lays face down on her cot, writing furiously with her equine legs bent and swaying in the air. This affords you a good view of her off hand between her thighs, pumping away at her [if cocks of player > 0]creamy[else]juicy[end if] cunt while she logs her experience while still in the nude.";
		increase HP of Meredith by 1;
	else if HP of meredith is 5:
		say "     Meredith smiles at your offer, but pauses momentarily to look herself over, as if pondering the risks consequences of transforming further. 'I... uhh... For Science!' she exclaims with a giggle, throwing herself into your arms and kissing you. Given the ardour of her kiss and the groping of her eager hands, it's clear that her lust has played a strong part in her decision, regardless of her invocation towards scientific discovery. You help strip each other down quickly, lowering her back onto the cot before helping her get her ill-fitting pants off from around her equine ankles, lest she end up tumbling backwards again.";
		say "     Once nude and on the cot, you lustfully embrace and run your hands over each other. Her hands are more focused on you and your [if player is purehuman]seemingly uninfected[else]infected[end if] features as they wander you all over in a mix of sexual play and curious exploration. While she does this, you keep your own caresses light, teasing her breasts and thighs so as to keep her aroused but not to distract her. It's clear her curiosity's been satisfied, at least for the moment when ";
		if cocks of player > 0:
			say "she moves to lean over the cot with her ass. With her tail raised in obvious invitation, her juicy cunt's on display, ready and waiting to be filled.";
			say "     With such an enticing invitation, you move in behind her quickly, grabbing her ass and rubbing your throbbing manhood against her rear. As she grips the bed and grinds back against you, you hear her moan with excitement. You spread her ass cheeks, feeling those stronger equine muscles of her ass while using your grip to hold her quivering ass in place so you can thrust your shaft into her juicy cunt. 'Oh Curie, that feels good!' she moans[if libido of Meredith is 0] as you take her virginity[end if], pushing back to get you buried deeper inside her hot cunt.";
			if anallevel is 3:
				say "     Feeling particularly naughty, you rub your fingers alongside your shaft and across her juicy pussy to get them nice and slick. You then move the digits back to probe at her darkened pucker. She gives a nicker of surprise and pulls away at first, but then pushes back in invitation to explore the arousing possibilities of anal play. She gives another moan as your slip those lubed fingers into her tight back passage and fingerfuck her ass even as you fuck her needy cunt.";
			say "     While the young woman's unpracticed at sex, she's clearly learning quickly as she tries to squeeze and grind down onto your [cock of player] rod. She even tries some tricks she likely picked up during her observations. As she learns which methods work best to please both you and herself, her hot cunny quivers in delight. She cups her breasts and teases her nipples, playing with herself while you pound away at her. Her lust for sex is obviously very strong after having waited so long.";
			say "     With so much pent up desire, it is not too long before you've got her crying out in carnal release, her feminine cum soaking your [cock size desc of player] shaft even as it overflows across your thighs. She throws her own attempts to please you into overdrive, rubbing your ballsack and working her clenching cunt in all the ways that best excited you before, soon driving you over the edge of climactic bliss. You both do your best to keep it going, thrusting firmly into her as you empty your [cum load size of player] load into her as you paint her inner walls with your seed.";
			say "     In the throes of your own orgasm, you almost miss the first signs of her starting to change further with her ass becoming meatier and more equine in form. Soon it's not a woman's pussy you're stuffing, but a mare's winking cunt full of heady equine scent[if anallevel is 3]. As this is happening, you can see and feel her anal ring and rectum changing around your fingers, becoming darker as it becomes a more accommodating and flexible horse hole[end if]. But the most dramatic change comes as her upper body is pushed forward even as her lower body elongates. As you watch, small equine legs form even as her torso bends upwards. Soon these new forelegs are overhanging the other side of the bunk and raising up her centaur body from the bed as her lower torso's changed into a fully equine lower half. Well on her way to fully becoming a centaur, you don't let up, the excitement of seeing her change helping to keep you hard so you can fuck her the whole way through to the completion of her transformation.";
			say "     She cums again as the excitement of her changing body overcomes her. She grinds her equine ass against your hips, hot horse cunt winking and squeezing around your throbbing shaft. Between her mid-coitus transformation and the heavy scent of her equine arousal, you end up cumming again, a part of you perversely pleased with having transformed Meredith into a lustful mare.";
			now libido of Meredith is 2;
		else:
			say "she gets you to roll onto your back and moves into a 69 overtop of you. In this new position, her juicy cunt's on display right above you, waiting to be eaten out.";
			say "     With such an enticing invitation, you dive right in, grabbing her ass and pulling her muff to your lips. As your tongue slathers across it, you hear her moan and soon she's licking and fingering your cunt in return. You knead her rear, feeling those stronger, equine muscles of her ass while using it to hold her quivering hips in place so your tongue can work its magic. 'Oh Curie, you're good,' she moans, grinding her dripping cunt down to get you to lick deeper.";
			if anallevel is 3:
				say "     Feeling particularly naughty, you stuff a pair of fingers into her juicy pussy and get them nice and slick. You then move the digits back to probe at her darkened pucker. She gives a nicker of surprise and pulls away at first, but then pushes back in invitation to explore the arousing possibilities of anal play. She gives another moan as your slip those lubed fingers into her tight back passage and fingerfuck her ass even as you eat her out.";
			say "     While the young woman's unpracticed at providing oral pleasure, she's clearly learning quickly as she tries to imitate some of your tricks as well as those she's seen during her observations. Soon enough she's doing a fine job of pleasuring you, working her tongue and fingers in intricate ways to delight your quivering cunny. She laps up your juices with a hungry eagerness, her lust for sex obviously very strong after having waited so long.";
			say "     With so much pent up desire, it is not too long before you've got her crying out in carnal release, her feminine cum soaking your face even as it flows across your probing tongue. She throws her own attempts to please you into overdrive, fingering, licking and nibbling at your cunt in all the ways that best excited you before, soon driving you over the edge of climactic bliss. You both do your best to keep it going, licking, kissing and caressing quivering folds, sensitive clits and rippling inner walls as you lose yourselves in lesbian lust.";
			say "     In the throes of your own orgasm, you almost miss the first signs of her starting to change further with her ass becoming meatier and more equine in form. Soon it's not a woman's pussy you're tonguing, but a mare's winking cunt full of heady equine scent[if anallevel is 3]. As this is happening, you can feel her anal ring and rectum changing around your fingers, becoming more accommodating and flexible as it shifts into the dark pucker of a horse[end if]. You feel something brush against your sides as her upper body starts to move against you. As her face is drawn away from your cunt despite her best efforts to lap up more of your juices, she's soon only able to finger your cunny. As those things growing alongside you continue up to your shoulders, you realize they're her new forelegs and her lower torso's been changed into a fully equine lower half. Well on her way to fully becoming a centaur, you don't let up, working to pleasure her the whole way through to the completion of her transformation.";
			say "     She cums again as the excitement of her changing body overcomes her. She grinds her equine lower body down atop you while her still human hands play with your pussy. Between her mid-coitus transformation and the heavy flavour of her equine juices, you end up cumming again, a part of you perversely pleased with having transformed Meredith into a lustful mare.";
		say "     Once you both recover enough from your back-to-back orgasms to move, you separate from one another so Meredith can look over her new, fully centaur body. While her humanoid torso's largely unchanged, she looks a little more physically fit and her skin's picked up a light tan. Overall, she's a smaller mare than Vanessa by nearly two hands of height at the whithers. Her equine lower half is covered in a russet red coat changing to chestnut at her ankles. Her red hair's darkened a little, but is still much redder than her coat. As you couldn't help yourself from enjoying, her pussy's become that of a mare to match her equine rump. She seems quite pleased, trotting in a slow circle as she gets used to her new gait. After a brief canter around the room and a happy wave to a smiling Vanessa[if Coleen is bunkered] and Coleen[end if], she remembers that she should be taking notes on all this and grabs a pad to chronicle her experiences.";
		increase HP of Meredith by 1;
	else if HP of meredith >= 6:
		say "     Approaching Meredith, you run a hand across her flank as ask if she's got time for some more 'practical experimentation'. She grins happily and flicks her tail up. 'Oh, I'm always up for some sexy science, [if cocks of player > 0]stud[else]honey[end if],' she laughs with a bit of a blush. She [one of]fumbles a bit in trying to get her pack unhooked until you help her with it[or]almost knocks over her cot trying to turn around to hug you[or]bumps over a stack of notebooks after getting her saddle pack off[or]almost ends up stomping on some sample dishes in her excitement before you can move them out of the way[at random]. Dealing with this gives you a moment to decide what you'd like to show the clumsy cutie next.";
		say "[Meredithsexmenu]";
		if HP of Meredith < 8, increase HP of Meredith by 1;


to say Meredithsexmenu:
	now sextablerun is 0;
	blank out the whole of table of fucking options;
	if cocks of player > 0:
		if bodyname of player is not listed in infections of taurlist:
			choose a blank row in table of fucking options;
			now title entry is "Fuck her";
			now sortorder entry is 1;
			now description entry is "pound that mare pussy";
		else:
			choose a blank row in table of fucking options;
			now title entry is "Taur-style fuck";
			now sortorder entry is 1;
			now description entry is "mount that mare";
[		choose a blank row in table of fucking options;
		now title entry is "Anal";
		now sortorder entry is 2;
		now description entry is "have a go at Mare's ass";]
		choose a blank row in table of fucking options;
		now title entry is "Blow job";
		now sortorder entry is 3;
		now description entry is "have Mare suck you off";
	choose a blank row in table of fucking options;
	now title entry is "Eat her out";
	now sortorder entry is 4;
	now description entry is "lick Mare's juicy pussy";
[	choose a blank row in table of fucking options;
	now title entry is "Fist her";
	now sortorder entry is 5;
	now description entry is "pound her pussy with your arm";]
	if lastfuck of Vanessa - turns >= 8 and meredith_vanessa_fun1 is true:
		choose a blank row in table of fucking options;
		now title entry is "Threesome w/Vanessa";
		now sortorder entry is 6;
		now description entry is "have Vanessa join in on the fun";
	if lastfuck of Coleen - turns >= 4 and meredith_coleen_fun1 is true:
		choose a blank row in table of fucking options;
		now title entry is "Threesome w/Coleen";
		now sortorder entry is 7;
		now description entry is "have Coleen join in on the fun";
[	if HP of Meredith >= 11 and XP of Meredith is 0:	[able to get preggers and not preggers right now]
		choose a blank row in table of fucking options;
		now title entry is "UB fun";
		now sortorder entry is 10;
		now description entry is "take a turn inside the mare's womb";]
	sort the table of fucking options in sortorder order;
	repeat with y running from 1 to number of filled rows in table of fucking options:
		choose row y from the table of fucking options;
		say "[link][y] - [title entry][as][y][end link][line break]";
	while sextablerun is 0:
		say "Pick the corresponding number> [run paragraph on]";
		get a number;
		if calcnumber > 0 and calcnumber <= the number of filled rows in table of fucking options:
			now current menu selection is calcnumber;
			choose row calcnumber in table of fucking options;
			say "[title entry]: [description entry][line break]";
			say "Is this what you want?";
			if player consents:
				let nam be title entry;
				now sextablerun is 1;
				if nam is "Fuck her" or nam is "Taur-style fuck":
					say "[Meredithsex1]";
				else if nam is "Anal":
					say "[Meredithsex2]";
				else if nam is "Blow job":
					say "[Meredithsex3]";
				else if nam is "Eat her out":
					say "[Meredithsex4]";
				else if nam is "Fist her":
					say "[Meredithsex5]";
				else if nam is "Threesome w/Vanessa":
					say "[Meredith_3some1]";
				else if nam is "Threesome w/Coleen":
					say "[Meredith_3some2]";
				else if nam is "UB fun":
					say "[Meredith_UBplayer]";
		else:
			say "Invalid Option. Pick between 1 and [the number of filled rows in the table of fucking options].";
	now lastfuck of Meredith is turns;
	wait for any key;
	clear the screen and hyperlink list;

to say Meredithsex1:
	say "     In the mood to fuck the mare's equine cunny, you give her a quick kiss before moving around to her rear. Rubbing your hands over her flanks, you bring your [cock of player] cock into position and rub it against her rear. Enjoying the soft, eager nickers of the geeky mare, you draw it out, brushing your glans across her wet folds several times before finally easing your [cock size desc of player] penis into her. Feeling your [if cock length of player < 12]small for her shaft sinking into her needy cunt, she gives a moaning nicker[else if cock length of player < 24]goodly-sized shaft sinking into her needy cunt, she gives a loud moaning nicker[else]impressively large shaft sinking into her needy cunt, she gives a moaning nicker. '[one of]Oh Curie[or]By Newton[or]Eureka[at random], that's big,' she exclaims[end if].";
	if bodyname of player is listed in infections of taurlist:
		say "     Having mounted Mare, you put your arms around her upper body. Holding onto her both around the torso and with your forelegs around her flanks, you steady yourself atop her and start pounding away. Despite being a smaller mare than Vanessa, her transformed body's able to support your weight while you pound her needy cunny[if cock length of player > 36] with your belly-bulging monster-cock[end if]. You alternate between groping the red-headed centaur's breasts and gripping her front hips when you go to pound her particularly hard.";
	else:
		say "     Having thrust into Mare, you grip her meaty rump with your hands and start pounding away. Settling into a rhythm, you let your hands roam around to rub her flanks, mare breasts[if anallevel is 3], underbelly and equine pucker[else] and underbelly[end if]. And once you've got her pushing lightly back into your thrusts, [if cock length of player > 36]you drive your belly-bulging monster-cock fully into her, much to her nickering delight[else]you get her nickering with delight[end if]. You alternate between stroking the red-headed centaur's [one of]tail[or]flanks[or]back[at random] and teasing her [one of][if anallevel is 3]equine pucker[else]equine udder[end if][or]equine udder[or]spread folds[or]throbbing clit[at random] between phases when you're pounding her particularly hard.";
	say "     Your orgasm's fast approaching by the time Meredith throws back her head and cries out in release. You can feel her hot juices soak your crotch and as she clamps down around your shaft. Having her inner walls squeezing and milking around your shaft with a wanton need for your seed, how can you deny it to her?  Unable to hold back for more than another thrust or two, you empty your rich load into the lustful Mare. You shoot shot after shot of semen into her until your [cum load size of player] output's been emptied into her womb.";
	say "     When you pull out, she staggers uneasily on her four legs, a little wobbly after her orgasm. She manages to stay upright and makes a show of flashing her creamy equine pussy to you as she leans her forequarters down and grabs a notebook to document the effects of this most recent session.";
	if HP of Meredith > 10:
		if XP of Meredith is 0 and a random chance of 2 in 3 succeeds:
			now XP of Meredith is 1;
			if HP of Meredith is 11, now HP of Meredith is 12;
	if libido of Meredith < 2, now libido of Meredith is 2;

to say Meredithsex2:
	say "***";

to say Meredithsex3:
	say "     Offering up your cock to the centaur, you suggest she suck you off. After giving you a quick kiss, she grabs a blanket off the cot, scattering a few items onto the floor, and uses it to rest upon. Kneeling her equine lower body onto the blanket, she's able to sit comfortably while [if scalevalue of player > 2]lowering[else]bringing[end if] her head to your [cock of player] cock. She gives a soft, eager nicker and brushes a red bang from in front of her glasses, eyeing your pulsing rod with an obvious desire. She licks her lips and then licks your glans before running her tongue along the full length of your [cock size desc of player] manhood[if cock length of player < 12]. She[else if cock length of player < 24]. She smiles happily at the size of it and[else]. She's clearly impressed and pleased with the size of it and[end if] lavishes attention upon your meat, stroking and kissing it before finally taking it into her mouth.";
	say "     You stroke the cute centaur's soft hair while she [if cock length of player < 24]sucks your cock[else]works to get the whole of your hefty cock into her mouth and throat[end if]. Mare gives soft, muffled nickers and whinnies as you let your fingertips brush along the edge of her rather equine ears, causing them to flick. She blushes at this, but sucks you all the harder as well. Her hands stroke your exposed length[if cockname of player is not listed in infections of internallist] and [ball size][end if] while bobbing her head.";
	say "     She works your shaft with her mouth and tongue with an eagerness rich in exploration, often trying some new method to find what's most enjoyable[if cock length of player > 36]. By the time she's managed to stuff your massive manhood down her throat, bulging her torso to fit it, you're on the edge of exploding right into her[else]. After several minutes of this treatment, you're on the edge of exploding right into her[end if]. Knowing she's as eager for it as you are, you moan that you're about to cum. With her sucking all the harder upon hearing your words, you let your [cum load size of player] load shoot down her throat to feed your cute Mare. She swallows it all down and licks your cock clean once you pull it free, definitely having enjoyed the tasty reward for her studious research.";
	say "     After sharing some hugs (and fondling), you leave her resting there on the blanket. She buries her nose in her notebook as she documents the effects of this most recent session. You can't help but notice the occasional pause as she licks her lips or plays with her own breasts while remembering the finer details.";

to say Meredithsex4:
	say "     Wanting a taste of the centaur's wet cunny, you offer to eat her out while taking a moment to stroke her breasts and suck on her nipples. Between her nickers of delight, she happily agrees and flicks her tail up to give you access to her winking pussy. Running your hand along her side, you move into position behind her equine rear and bury your face against those hot, dripping folds. After some teasing licks and light caresses of your fingers over her vulva, you spread those lips and dive in with your tongue.";
	say "     If the taste of her juices were not enough, the sounds of her pleasure encourage you on. Having difficulty playing with herself now seems to have made her all the more eager to have someone like you tend to her womanly needs[if anallevel is 3]. You even take the opportunity to lick further up, ringing your tongue teasingly around her equine tailhole before returning to her pussy once you've stuffed a finger into that crinkled hole[end if]. As her excitement grows further, the flow of her juices is deliciously arousing and you lap up as much of it as you can get. And when she whinnies loudly in climax, your face ends up soaked in the mare's running juices despite your best attempts to lap it all up.";
	say "     Still tasting her on your tongue and smelling strongly of mare arousal, you share a kiss with the blushing but contented Meredith. She [one of]fumbles picking up her notebook the first time, necessitating she lean forward (and exposing her sticky rump for all to see) to grab it again[or]accidentally pours some scientific instruments from her pack as she picks it up from the bottom while trying to retrieve a pen[or]takes a few basic readings from herself after the romp[at random]. That done, she sets herself to documenting this most recent experience with a happy smile on her face.";

to say Meredithsex5:
	say "***";

to say Meredith_3some1:
	say "     Recalling that it's been a while since you did anything with Vanessa, you motion for her to come over and join the both of you. Mare's quite happy to see her join in, putting her arms around the sexy centaur breeder and sharing a loving kiss. They face each other and playfully cuddle for a bit, hands running over each other's body while you snuggle up to them, arm around the waist of each centaur.";
	if cocks of player > 0:
		say "     After this warmup, Vanessa trots around to give Mare a swat on the rear, telling her to get into position and to raise her tail for you. The bigger centaur then lines up alongside her and does the same. With the lovely sight of these two mares showing their juicy equine vulvae to you, you rise to full hardness and move in to take advantage of their offer. Selecting Mare first, you [if bodyname of player is listed in infections of taurlist]mount the transformed researcher and [end if]sink your [cock of player] cock into her hot, wet folds and start pounding away. You certainly don't leave the other centaur out of it though, reaching over to finger her cunny while you fuck her friend.";
		say "     You swap between the two every couple of minutes, taking your time at first to make sure you can last long enough to satisfy them both. Certainly they're both very excited even while it's not their turn to judge from the copious juices flowing from them as you finger their quivering petals or fingerfuck their pussies. They snuggle and make out while you ride them as well, arms around each other and hands groping breasts and teasing nipples. Soft nickers and whinnies are mixed into their tender words of affection they share.";
		say "     Swapping between them allows you to compare their cunts, unable to quite decide which you enjoy the best. While Mare's is naturally a little smaller and tighter given her smaller stature, Vanessa's inner muscles still manage to squeeze tighter around your thrusting shaft. You're still left undecided as you feel your climax fast approaching and swap to Mare one last time, really start pounding into her juicy cunny to finish. You cry out in orgasmic release, pumping your [cum load size of player] load into the whinnying mare. That final added sensation of your spurting semen sends her over the edge. Vanessa soon follows as you work your now slick hand in and out of her cunt rapidly while draining your balls into her friend. Once your orgasms have passed and you all move apart, more kisses and snuggling is shared before Vanessa and Meredith settle onto the floor side by side while you ready to go about some other tasks.";
		if HP of Meredith > 10:
			if XP of Meredith is 0 and a random chance of 2 in 3 succeeds:
				now XP of Meredith is 1;
				if HP of Meredith is 11, now HP of Meredith is 12;
		if libido of Meredith < 2, now libido of Meredith is 2;
	else:
		say "     After this warmup, Vanessa trots around to give Mare a swat on the rear, telling her to get into position and raise her tail for you. The bigger centaur then lines up alongside her and does the same. With the lovely sight of these two mares showing their juicy equine vulvae to you, you lick your lips and move in, placing a hand on each. You trace your fingers lightly over those wet folds, complimenting the lovely mares on how juicy they look before slowly pushing a few fingers into them.";
		say "     Fingerfucking their pussies, you alternate between licking one and then the next, swapping back and forth to sample their hot juices. They snuggle and make out while you ride them as well, arms around each other and hands groping breasts and teasing nipples. Soft nickers and whinnies are mixed into their tender words of affection they share. Over time, you add more digits until you're working your whole hand into those equine cunts to give them something adequately filling to really get them going. You set up the best rhythm and control by twisting a little, pushing into one while pulling out of the other.";
		say "     Doing them both in tandem allows you to compare their cunts, unable to quite decide which you enjoy the best. While Mare's is naturally a little smaller and tighter given her smaller stature, Vanessa's inner muscles still manage to squeeze tighter around your pistoning hand. You're still left undecided by the point Meredith's shifting excitedly from hoof to hoof as her cunny quivers around you before finally spasming around you as she climaxes. Knowing the other's cum soon has Vanessa's vagina squeezing harder around your hand as her orgasm washes through her. Both limbs are thoroughly soaked with equine juices from the orgasming centaurs.";
		say "     Once their orgasms have passed and you slide your hands free, the two centaurs turn around and move in on you. You're groped and manhandled by the pair of them, eager fingers finding their way to your [if breasts of player > 0 and breast size of player > 0 and anallevel > 1]breasts, puss[yfn] and even your pucker[else if breasts of player > 0 and breast size of player > 0]breasts and puss[yfn][else]puss[yfn][end if]. After all the recent excitement, you don't hold out long before you're crying out in orgasmic release, soaking your thighs and their playful fingers with your hot juices. They make a show of licking these from their hands even as you do the same to get at their juices. Wet, sloppy kisses and snuggles are also shared before Vanessa and Meredith settle onto the floor side by side while you ready to go about some other tasks.";
	now lastfuck of Vanessa is turns;
	now lastfuck of Meredith is turns;

to say Meredith_3some2:
	say "     Spotting the husky nearby watching with lewd interest, you decide to have her join in on the fun. Knowing she'll be up for playing with her friend, you motion for the canine girl to come over. Her tail wags happily as she runs over on all fours in her excitement. Mare eeps in surprise as she finds a cold doggy nose buried in her snatch moments later, dropping the last few things in her hands. The doggy tongue slurping into her distracts her from picking them up and she shifts her hind legs apart a little further and releases a satisfied moan.";
	if cocks of player > 0:
		say "     Once you're satisfied that the husky's gotten Mare nice and ready for you, you get your [cock of player] cock lined up with her pussy and let the helpful doggy slut guide it in. Coleen moves around to Meredith's front, hugging and kissing her while they play with each other's breasts. The sight of them making out turns you on all the more and you grip your lover's [if bodyname of player is listed in infections of taurlist]waist gently[else]hips firmly[end if] and fuck her all the faster. The soft whinnies and yips of the excited females mix with your own cries as the three of you go at it.";
		say "     After a particularly long kiss with lots of doggy tongue, Coleen breaks off and moves under the centaur. Nosing around the juicy hole you're stuffing, she starts lapping at your shaft and Meredith's cunny each time you withdraw before another thrust. From the increase of wet sounds, you can tell the husky's also fingering herself wildly under there[if cockname of player is not listed in infections of internallist]. And with that tongue also finding its way to your [ball size][else]. And with that playful tongue[end if], you're quickly building to your climax as well.";
		say "     All this proves to be too much for the researcher first, sending her over the edge into an orgasmic bout of whinnying as her hot cunt squeezes and milks at your[if cock length of player > 36] belly-bulging[end if] manhood. You follow soon after, shooting your hot seed into that needy womb. A canine moan and frantic lapping informs you that the husky's cumming as well as she gathers up the leaking semen and feminine juices seeping from that creamy hole. And when you pull out, she's right there to stuff your cock into her muzzle to lick and suck it clean. Meredith's given similar treatment, the helpful doggy lapping the leaking excess from her friend's cunt. They cuddle up together and, after some hugs and kisses for each, you leave them there while you get back to other matters.";
		if HP of Meredith > 10:
			if XP of Meredith is 0 and a random chance of 2 in 3 succeeds:
				now XP of Meredith is 1;
				if HP of Meredith is 11, now HP of Meredith is 12;
		if libido of Meredith < 2, now libido of Meredith is 2;
	else:
		say "     Once the husky's had her turn, you gently nuzzle her over and move in to lick at that dripping cunny. Coleen moves around to Meredith's front, hugging and kissing her while they play with each other's breasts. The sight of them making out turns you on all the more and you dive in with increased zeal, pumping a few fingers into that juicy hole while your tongue and lips tend to her equine labia. The soft whinnies and yips of the excited females mix with the wet sounds of your tonguework and fingering as the three of you go at it.";
		if anallevel is 3 and a random chance of 1 in 3 succeeds:
			say "     Moving up to Mare's equine pucker, you start licking at that crinkled hole. After some playful tonguework gets it to start to relax, you bring your juice-covered fingers to it and ease your way into her rump. As you fingerfuck that tight hole, Coleen moves under you and takes over fingering and licking her cunt. You give the husky a playful bump for stealing the prime spot, but then turn your attention to providing even further stimulation to the mare's back door. The transformed researcher moans and whinnies excitedly as both holes are tended to by her friendly lovers. From the increase of wet sounds, you can tell the husky's also fingering herself wildly under there.";
		else if anallevel is 3:
			say "     Moving up to Mare's equine pucker, you start licking at that crinkled hole. After some playful tonguework gets it to start to relax, you bring your juice-covered fingers to it and ease your way into her rump for a brief fingerfuck. As you return your attention back to her dripping twat, Coleen comes sniffing around again and the two of you end up sharing it, taking turns at the centaur's pussy. The transformed researcher moans and whinnies excitedly as her needy cunny's tended to by her friendly lovers. From the increase of wet sounds, you can tell the husky's also fingering herself wildly under there.";
		else:
			say "     After a particularly long kiss with lots of doggy tongue, Coleen comes sniffing around again and the two of you end up sharing it, taking turns at the centaur's pussy. The transformed researcher moans and whinnies excitedly as her needy cunny's tended to by her friendly lovers. From the increase of wet sounds, you can tell the husky's also fingering herself wildly under there.";
		say "     All this proves to be too much for the researcher, sending her over the edge into an orgasmic bout of whinnying as her hot cunt squeezes with a rush of fresh juices. You and Coleen follow soon after, fingering yourselves to orgasm while lapping and licking Mare. Coleen's doggy tongue dives particularly deep in its search for the centaur's sweet waters. And when you move back, the husky's right there to lap across your face with canine kisses. They cuddle up together and, after some hugs and kisses for each, you leave them there while you get back to other matters.";
	now lastfuck of Coleen is turns;
	now lastfuck of Meredith is turns;


to say meredith_coleen_funscene1:
	say ". The husky's splayed out while Meredith performs a rather playful examination of the horny hound's erogenous zones. She makes a game of teasing her while asking how it feels until she's quite worked up, only to then stop so she can take a few notes while the husky whines with need. You take a seat on a nearby bed and get to watch her start on the husky's many breasts, playing with her nipples and sucking on them between more sedately taking measurements with only a minimum of groping. From there, her focus shifts downwards to eventually reach the bitch's juicy cunt.";
	say "     [if cocks of player > 0 or cunts of player > 0]You can't help but play with yourself[else]You can't help but be turned on[end if] as the show gets hotter as Mare works over the husky's dripping pussy. Opening with a rather clinical examination with just enough light teasing to keep her subject aroused, she goes over that heated muff in full detail. By the time she's on to touching, licking and fingering it to analyze the husky's responses, the canine's hips are quivering as she whimpers with need. From your vantage point, you watch as Mare's fingers, tongue and lips explore the husky's needy cunt in a myriad of delightful ways, including a few suggested by her subject.";
	if anallevel is 3:
		say "     To give her a brief [']reprieve['], she switches her focus to the husky's tailhole, giving it similar treatment while the doggy's cunt cools down. Mare seems to have no reservations about giving that crinkled hole the same in-depth treatment as the slutty pup's other hole, licking and fingering at it until she's panting lustfully once again. She even delves her tongue right into it while kneading that fluffy ass of hers. After a few teasing questions and quick notetaking, it's back to Coleen's cunt to renew her investigation there, this time asking her to compare getting her pussy and ass teased, licked and tongued as she does each all over again.";
	say "     Worked up by all of this, the slutty bitch quivers and yips with lust, barely able to answer the questions coherently. From the juices running down Mare's thighs, you can tell she's faring little better despite her attempts to at least appear self-controlled as part of their game. Eventually she can't hold out though and dives into it, pumping her fingers wildly into Coleen's cunt while licking and sucking at her clit. The husky woman cries out in orgasmic delight and Meredith soon follows[if cocks of player > 0 or cunts of player > 0]. You can't hold back any longer either and push yourself to a much-needed orgasm after watching their kinky, lesbian fun.";
	now meredith_coleen_fun1 is true;

to say meredith_vanessa_funscene1:
	say ". Vanessa's standing in the gap between the rows of cots while Meredith performs a playful examination of the breeding mare's new body. Now that she's fully transformed, Meredith feels no worries about getting close to the larger centaur and is quite happy to get quite close. They smile to you and you settle onto Vanessa's bunk and stretch out to watch them have fun together.";
	say "     From the looks of it, Meredith's already gone over most of Vanessa's humanoid upper body, though she's lingering extra long on her breasts, double-checking measurements between kisses and licks to those dark nipples. Enjoying the show, you [if cocks of player > 0 or cunts of player > 0]can't help but start to play with yourself, keeping it casual to not overly[else]watch quietly, not wanting to[end if] distract the pair from Meredith's [']important research[']. After sucking on the centaur's nipples one last time, the playful researcher's ready to move on to examining her subject's more equine lower half.";
	say "     Meredith starts by stroking Vanessa's white coat before relaxing to take some more mundane measurements to start. The time while Vanessa has such things as the length of the equine body, the height of her legs, the thickness of her muscles and so on is more sedate. Were it not for the more caressing touches and the occasional wander of Mare's hands to the mare's ass as well as Vanessa's continued playing with her breasts, you might become disinterested. Luckily for you things start to heat up again [if HP of Vanessa is 4 or HP of Vanessa is 6]after Meredith measures around the mare's pregnant belly and[else]when she[end if] shifts her focus to her subject's equine breasts.";
	say "     With Meredith kneeling down under the other mare, she examine's the mare's lower breasts, teasing those teat-like nipples and sucking on them. She asks the ex-soldier a series of questions about what she's feeling and how it compares to her earlier play with her human breasts. She licks and sucks on them, enjoying the nickers of pleasure the larger mare releases. And things get even hotter when you notice a hand reach around to start fingering Vanessa's dripping, winking pussy between taking notes.";
	say "     With her hand having found its way to the centaur's wet vulva, it's not long before Meredith's focus shifts there as well. She moves around behind her protector, friend and lover, and moves to lavishing attention upon it. She's gotten quite distracted herself now by this point, hardly remembering to take measurements or notes as she fingers, licks and kisses at those winking folds. As the exploration continues, she slips a pair of fingers into the mare's vagina, followed by another and soon the whole hand. The researcher's hand pushes deeper with every thrust it makes, seeking to delve the depths of that squeezing, quivering hole while Vanessa nickers and whinnies louder. With Mare's fingers rubbing at what must be the very depths of the centaur's vagina once most of her arm is buried in it, that stuffed cunny can take no more and clamps down around the limb, squeezing tightly in orgasmic release. Mare pounds away at that quivering hole as hard and fast as she can to satisfy her lesbian lover, but her rhythm's thrown off when she climaxes as well[if cocks of player > 0 or cunts of player > 0]. You can't hold back any longer either and push yourself to a much-needed climax after the extended show[end if]. As they move to sit and cuddle side by side, you decide to leave them in peace for now.";
	now meredith_vanessa_fun1 is true;

to say meredith_vanessa_funscene2:
	say ". Vanessa's standing in the open space between bunks while Meredith performs another playful examination of the breeding mare. Able to be safely affectionate with the centaur now that she's one as well, Mare's eager to do more [']hands-on research['] with her. It is a mix of an examination and foreplay as the smaller mare teases her hands over the ex-soldier's body. Vanessa gets quite excited at the playful caresses and kinky questions thinly veiled as scientific inquiry.";
	say "     You smile as they indicate for you to watch from Vanessa's bunk and stretch yourself across it, settling in to enjoy the show. Mare swirls her tongue slowly over Vanessa's nipples, pauses for a moment and then drags her tongue slowly across them. This is followed up by her asking how each made the centaur feel and which felt better. Each response is followed by more playful exploration, teasing and other questions until Vanessa can't take it any more and presses Mare's face to her bosom, urging her to suck on her nipples.";
	say "     Meredith squirms a little at first, frustrated that her kinky exam's been curtailed. But she settles down soon enough when it becomes clear that Vanessa's not going to put up with any more teasing[if cocks of player > 0 or cunts of player > 0]. You slip a hand between your legs to casually play with yourself while you watch the pair[end if]. Enjoying the sight, you can't help but smile as you see Mare's lips wrap around one of those darkened nipples and sucks on it while the other breast is caressed by the smaller centaur's hand.";
	say "     Meredith gives a little gurgle of surprise a few moments later and you notice a spot of white at the edge of her lips, and soon the mare's nursing hungrily from the larger mare's bosom. 'That's it, my thirsty Mare,' Vanessa moans. 'I promised we'd take care of you, and I will. Drink up like a good girl.' Though Meredith needs no encouragement, suckling hungrily from Vanessa's tits while fondling them with lustful desire. The breast feeding continues until the milk from both breasts has gone into the centaur's belly. They settle down on the floor together side by side, Vanessa's strong arms cradling Meredith's body tenderly to hers.";
	now meredith_vanessa_fun2 is true;

to say Meredith_UBplayer:
	say "***";


Section 4 - Meredith's Clinic Visit

to say meredith_clinictrip:
	say "     Striking out across the city with Vanessa and Meredith in tow, you make your way towards the pediatrics clinic. The early part of the trip is fairly uneventful, any troublesome mutants driven off by you and the centaur soldier. You're about halfway there when an approaching voice calls out.";
	say "     'Sergeant Harris?  Sarge?  Is that really you?' Her cry has a sensual air to it despite its words.";
	say "     Looking toward the speaker, you see a rather sexy black woman struggling over a mound of rubble to get to your group. The partial remains of her paratrooper jumpsuit is stained with dirt and a few sticky splotches. Once she crests the top and starts rushing down, you can see she's also got a slender, demonic tail to go along with her unnaturally appealing body.";
	attempttowait;
	say "     'Oh, it is you!  And you've found Meredith. Isn't that wonderful,' she says with a lustful edge in her voice. Not trusting the partial succubus, you move in between the others and ready your weapon. She stops short and looks you over. 'And who's your friend?'";
	say "     'Private Washington?  Gwenneth?' Vanessa asks, holding an excited Meredith back with an outstretched arm. 'Ten-Hut, soldier!' she barks. 'And what's with that slutty tone?'";
	say "     'Reporting for duty,' she says, coming to attention with a flick of her tail. Spotting its wayward motion, she makes a grab for it, but it wriggles out of her hand before she can get a good grip on it. 'Sorry Sarge, ever since I had a run-in with those overeager demon-girls, everything I say comes out in a porno voice,' she says, sounding naughtily pouting despite herself. 'From the looks of it, you two've got a similar story of your own.'";
	say "     Meredith, finally released, trots over to the new arrival with a smile. 'Oh Gwenny!  You found us!  It's great to see you again!  And you're all va-va-va-voom, too.' That she is, you must agree, her body having a perfect hourglass figure, plump breasts and flawless chocolate brown skin.";
	attempttowait;
	say "     Hugs are quickly exchanged, and since Meredith could use a break from hiking across the city, the four of you go inside an abandoned building to get caught up. Gwen is brought up to speed on what the two centaurs have been up to, more than a little shocked at some parts of the tale. Hearing how Vanessa encouraged Meredith's transformation, she gets up abruptly.";
	say "     'You... you've turned!  All of you!' she exclaims, an edge of lust on her face and in her voice despite her words as she jumps to her feet and starts to back away.";
	say "     'Oh, it's not like that,' Meredith pleads. 'It's for my research. I needed to lea... ooof...' The small centaur, fumbling in her notepack saddlebag even as she moves towards Gwen, ends up charging right into her without looking. This knocks the infected soldier over in what can best be described as a swoon - a swoon that has her land face first between Vanessa's breasts. The large centaur, having moved to try and calm her squadmate down, finds herself in a position to do just that. Putting her arms around her, she presses the woman's face to her bosom. 'At ease, Gwen,' she says soothingly. 'That's an order.'";
	attempttowait;
	say "     The dark-skinned woman makes a few halfhearted punches but, finding her mouth pressed to Vanessa's brown nipple, can't help but put her lips around it. Vanessa moans softly as those warm lips wrap around her nipple and start suckling, soon rewarded with the centaur's milk. Seeing her friend calm down, Mare smiles happily and snuggles up beside her, seeking a drink of her own from Vanessa's other breast. The partially infected woman fidgets a little in protest as Mare's hands run over her body, baring her chocolate skin to her sensual touches.";
	say "     Already infected with such an alluring and lustful strain as the Succubus infection, she can't help but become increasingly aroused. After her fill of milk, her lustful daze sends her to Meredith's pussy for juicier fare. Mare moans with need, her dripping pussy wide and winking as it slurps on the tongue delving into it.";
	say "     'Oh, that empty need,' Meredith moans. 'I want to be filled.' She grinds back against the black woman's face. Having watched up until now, you are struck with the idea of using Gwen to fill Mare. Shall you follow through on this plan? (warning: UB and temporary AR)[line break]";
	if the player consents:
		say "     Motioning for Vanessa to give you a hand, you start by running your hands sensually over Gwen. With a few fingers buried in her snatch and a firm grip on her brown booty, you have Vanessa hold the soldier's head and shoulders. Giving a firm push, Gwen is driven forward just as Mare's pussy gapes wide again. As if preparing itself for this, the centaur's wet folds part readily, welcoming her friend's head right into her sopping cunt. The soldier, startled partially from her daze, tries to struggle, but the pumping action of your fingers in her cunny keeps her lust high and her struggles weak.";
		say "     Mare meanwhile is beside herself with delight, moaning for more. A little wobbly on her hooves from the pleasure, she tries her best to push herself back. With another hard shove from you both, Gwen goes in to her shoulders and orgasms with a muffled moan. Grinning and nodding to one another, you and Vanessa push again, slowly now, watching those wide mare lips sliding wetly down the sexy woman's waist. Meredith's vaginal muscles begin to pull their prize along as well, no longer needing your assistance. The impromptu mother cries out in orgasm, panting that she can feel her in her womb, that she's finally going to be filled, that she's finally going to have a foal.";
		say "     With Mare's vagina having taken over the work of pulling her foal-to-be in, you switch to licking Gwen's dripping pussy instead. As her folds stretch to encompass the soldier's ass, you grab her tail and push its spaded head into her own snatch. Oh, how she moans and quivers at that, her naughty tail wriggling and thrusting inside her even as she's devoured by the mare's cunt. You watch as she's pulled in a few more inches and her ass and pussy disappear from sight, tail still stuffed into the latter.";
		say "     Vanessa, having moved to Meredith's front, encourages her on, reassuring the smaller mare that she's almost done. They kiss and fondle one another through Mare's struggle to draw the last of Gwen into her womb. And succeed she does with another orgasmic release. Her tauric belly is left rounded and heavy from its new occupant.";
		attempttowait;
		say "     After a rest filled with plenty of snuggling and caressing of the new pregnancy, you complete the journey to Dr. Medea's, though now with an extra reason for the visit.";
		say "     The lizard doctor is very pleased to see her patient so plumply pregnant. After a quick description of what happened and a thorough examination by the elated doctor, both are pronounced healthy. Mare's pregnancy difficulties have been corrected and Gwen is on her way to becoming the centaur's foal. While some corner of you can't help but wonder if you've done the right thing, both centaurs and their doctor are quite happy with the results. The three of you return back to the library in high spirits after your expedition's (unusually) successful completion, the two centaur women exchanging conspiring, giggling exchanges during the hike.";
		now HP of Meredith is 10;
		now lust of Meredith is 1;
		now XP of Meredith is 12;
		now HP of Gwen is 2;
		follow the turnpass rule;
	else:
		say "     Pushing away that impulse, you still want in on that action and advance upon the trio. Grabbing Gwen's brown-skinned ass, you plunge a pair of fingers into her snatch. Soon you've got her dripping and moaning ";
		if cocks of player > 0:
			say "and ready to be mounted. Getting lined up, you drive your shaft into her pussy and start pounding away. While you fuck her, the two centaurs take turns being eaten out by her. When you finally cum, the soldier's cries of orgasm are mixed with neighs. The two centaurs smile at the sound, sharing a tongue-filled kiss.";
		else:
			say "and oh-so-juicy looking. Burying your face in her shaved pussy, you dive right in and start licking. While you eat her out, the two centaurs take turns being eaten out by her. When she cums, the soldier's cries of orgasm are mixed with neighs. The two centaurs smile at the sound, sharing a tongue-filled kiss.";
		attempttowait;
		say "     After your sex break and another feeding of Vanessa's milk to keep their squadmate compliant, you continue your journey. As you go, you can see the early signs of transformation showing on Gwen, her ears becoming equine like Meredith's and her feet shifting to hooves. At the clinic, you accompany Meredith in to see the lizard doctor. Quite pleased to have a patient looking for assistance in becoming pregnant, she gives the cute centaur a thorough examination. While you can't follow half of the jargon they say, Mere's busily taking notes both on the procedure and on the reptilian obstetrician's findings and the behaviour of the infection - at least as far as her focus on pregnancy are concerned. The procedure drags on for much longer than you would have initially expected, the lizard probably drawing it out after finally having found someone to discuss her interest in such detail.";
		say "     Finally, after a little prompting from you, Dr. Medea declares that she's done, the issue corrected and Mare now able to become pregnant. Upon leaving the doctor's office, you are met with the surprising sight of Gwen nursing again from Vanessa's breast, but now fully transformed into a centaur herself. Well, almost fully - that demonic tail of hers persistently remains, currently buried in the new centaur's snatch and fucking herself as she nurses. She makes for quite the lovely sight, having retained her seductively sexy upper body, flawless chocolate skin and matching colour to her glossy equine coat. She's nearly as large as Vanessa, probably due to those lingering traces of her succubus infection, only about a half a hand or so shorter in height. Like Meredith, she's got horse ears atop her head, poking from her curly black hair.";
		say "     After another session of [']getting reacquainted['] with their squadmate [if cocks of player > 0]during which you fuck the seductive new centaur alongside her tail[else]during which you finger and lick the seductive new centaur to orgasm alongside her tail[end if], you find that her earlier concerns over the state of her friends are gone. Eager to help out and looking to Vanessa for fresh orders, she's provided with some of her sergeant's equipment and given instructions. You're not privy to some of the details, the sergeant claiming it's military secrets and winking coyly, but it seems to be come sort of scouting mission. A little disappointed that the brown beauty will be leaving[if cocks of player > 0], you give her one last fuck for the road[else], you lustfully kiss her while playing with her bountiful bosom[end if] before she and your group part ways. You, Vanessa and Meredith return back to the library in high spirits after your expedition's (unusually) successful completion, the two centaur women exchanging conspiring, giggling exchanges during the hike.";
		now HP of Meredith is 11;
		now HP of Gwen is 1;
		follow the turnpass rule;


Section 5 - Everyturn Rule (pregnancy & Gwen UB)

an everyturn rule:
	if Meredith is booked and HP of Meredith >= 10 and XP of Meredith > 0:
		increase XP of Meredith by 1;
		if XP of Meredith > 24 and skipturnblocker is 0:
			say "Your thoughts drift back to Meredith and you feel a need to go check in on her.";
			if HP of Meredith is 10:
				now HP of Gwen is 3;
				move Gwen to Back Of The Library;
				now HP of Meredith is 11;
				now XP of Meredith is 0;
			else:
				if HP of Meredith is 11, now HP of Meredith is 12;
				now XP of Meredith is 0;
				increase level of Meredith by 1;


Meredith ends here.
