Version 3 of Naughty Nurse by Stripes begins here.
[ Version 2.4 - Neuter player loss added ]
[ Version 3.0 - Rework by Leob           ]

"Adds a Naughty Nurse Vixen creature to Flexible Survival's Wandering Monsters table"

Section 1 - Creature Responses

vixgender is a number that varies.

to say VixenFemNurseMaleScene:
	say "     The vixen nurse pushes you down as you stop struggling. Climbing over you, her paws go to your crotch and grab your cock. With an adept paw, she gets you fully hard before moving to line it up with her wet slit. She sinks herself slowly down over your cock and moans. She kneads her paws over your chest as her bubble butt bounces in your lap. While she rides you, her silvery body and her white and black outfit become your entire, monochrome word of ecstasy. That one spot of red on her cap is the only color in your vision until finally you climax. Your vision is then awash in a blur of colors as you pump your hot seed into her before finally sagging back onto the floor with a sigh of pleasure. She smiles down at her happy patient and leaves you there.";

to say VixenFemNurseFemaleScene:
	say "     The vixen nurse pushes you down as you stop struggling. She takes you in her arms and holds you close as she unbuttons the front of her shirt enough to bare one of her breasts. 'Time to take your medicine, my dear,' she purrs softly. You consider resisting only briefly, for once your lips touch that nipple and taste the traces of her warm milk on it, you start nursing right away. As you drink down her milk, she slips a paw between your legs to play with your pussy. Her milk has a mild, medicinal taste that clouds your judgment and makes you increasingly aroused. She teases your wet folds, then slips a finger into you. She works it in and out quickly until you finally have a very fulfilling orgasm that makes your head spin and colors dance in your eyes. As you try to recover from this, she lowers her patient to the floor and leaves you there, still licking your lips.";

to say VixenFemNurseFacesitting:
	say "     The vixen nurse rubs your bare groin several times. 'Oh, you definitely need some special treatment, my dear,' she says. Pushing you gently to the ground, she straddles your face and presses her hot, dripping pussy to your mouth. With her juices running across your lips, you can't help but start lapping across her folds. After a few tentative licks, your lust grows as your self-restraint fades and soon you're worming your tongue into her quivery cunny in search of more. 'Yes! Yes! Drink up and you'll feel so much better in no time,' she pants, grinding down onto your tongue until she climaxes in a rush of musky fluids. You're left panting and a little dazed as your head spins and colors dance in your eyes. As you try to recover from this, she gives you a blanket makes sure your comfortable before leaving you there.";

to say VixenHermNursePussyFuck:
	say "     The vixen nurse pushes you down to the ground, getting you onto all fours. The herm vixen is on you moments later, driving her large fox cock into your pussy, making you moan. She nips at your ears and growls playfully as she pumps her hard shaft into you again and again. You find yourself growing even more aroused[if Player is male]when she reaches around to stroke your pulsing shaft in return,[end if] and are soon pushing back into her thrusts trying to get as much of her inside your pussy as you can. She gives you a few slaps on the rear with her clipboard, then drives her knot inside you, unleashing her hot seed. This pushes you over the edge, causing you to cum as well.";
	impregchance;
	say "     She holds you tightly to her for a minute fox cum still flowing into you while her knot holds. Eventually she is able to pull out a flood of cum flowing from your pussy as she moves on to let you recover.";

to say VixenHermNurseAssFuck:
	say "     The vixen nurse pushes you down to the ground, getting you onto all fours. The herm vixen is on you moments later, driving her large fox cock into your ass, making you groan in pain. She nips at your ears and growls playfully as she pumps her hard shaft into you again and again. You find yourself growing even more aroused and as it becomes more and more pleasurable[if Player is male], especially once she reaches around to stroke your pulsing shaft in return[end if]. You are soon pushing back into her thrusts trying to get her deeper inside of you. She gives you a few slaps on the rear with her clipboard, then drives her knot deep inside you, unleashing her hot seed[if Player is male]. This pushes you over the edge and causes you to cum as well[end if].";
	mimpregchance;
	say "     Held to you by her knot she holds herself on top of you for a minute cum flowing deep inside you. Eventually she is able to pull free and leaves you to rest and recover ass still leaking cum from her intensive care-taking.";

to say VixenNursePussyFuck:
	say "     Not wanting to waste such a fine prize, you shove her forward and force her to bend over one of the patient's beds. You run a hand over her skirted bottom, giving it a squeeze before pulling it up to reveal her tight rump[if vixgender is 1], her dripping pussy and her ballsack[else] and her dripping pussy[end if] to you. Keeping one on her back to keep her in place, you slide the other over her rear, then between her legs to tease her wet slit. She moans and wiggles her rear invitingly.";
	say "     Being the offer you were waiting for, you get your hard cock lined up with her slit and sink it slowly into her. Her moaning and yipping is deliciously cute as you start pounding away at her. She pushes her hips back, eager now for you to take her. You reach around to fondle her breasts, teasing her nipples. The naughty nurse makes for a very enjoyable fuck, tight and wet around your cock.";
	say "     After giving her the good dicking she so richly deserves, you push into her one last time and unleash your hot seed into her quivering puss. Her orgasm makes her pussy shudder around you for a long time, extending your own orgasm to give her as much as you can give. Once you're finally done, you pull out, wipe your cock with her bushy tail and leave her skirt up to show anyone who comes by what you did to the passed out silver vixen.";
	decrease Libido of Player by 5;

to say VixenNursePlayWithHer:
	say "     Not wanting to waste such a fine prize, you shove her forward and force her to bend over one of the patient's beds. You run a hand over her skirted bottom, giving it a squeeze before pulling it up to reveal her tight rump[if vixgender is 1], her dripping puss and her ballsack[else] and her dripping puss[end if] to you. Keeping one on her back to keep her in place, you slide the other over her rear, then between her legs to tease her wet slit. She moans and wiggles her rear invitingly.";
	say "     You push a pair of fingers into her slit, making her release a deliciously cute set of moans and yips. You pump those fingers into her again and again and she starts pushing back to meet them[if vixgender is 1]. You place your other hand on her cock, stroking over the herm's shaft, making her drip on the floor[end if]. Taking your time, you move your fingers over her sensitive flesh, teasing and caressing her.";
	say "     You keep it up for quite some time, getting her good and riled up until finally she is driven over the edge. Her pussy clamps down around your fingers and her inner walls quiver as her juices soak your hand and her thighs[if vixgender is 1]. Her cock throbs in your hand, unleashing its load onto the floor as you stroke her off[end if]. [if Player is female]Your free hand is meanwhile rubbing her tail between your legs, teasing your female slit until you cum as well and soak the soft fur in your juices [end if]. Quite pleased with yourself when you finish, you leave her passed out with her skirt up, showing any who pass what a state you've left the silver vixen in.";
	decrease Libido of Player by 5;

to say VixenHermNurseRideHer:
	say "     A";

to say VixenHermNurseGetFucked:
	say "     A";

to say VixenHermNurseGetAnal:
	say "     A";

to say LoseToVixenNurse:
	choose row MonsterID from the Table of Random Critters;
	if vixgender is 0:
		if Player is herm:
			if a random chance of 1 in 2 succeeds:
				say "[VixenFemNurseMaleScene]";
			else:
				say "[VixenFemNurseFemaleScene]";
		else if Player is male:
			say "[VixenFemNurseMaleScene]";
		else if Player is female:
			say "[VixenFemNurseFemaleScene]";
		else:
			say "[VixenFemNurseFacesitting]";
	else if vixgender is 1:
		say "     The silver-furred vixen grins at you as she looks over her [if fightoutcome is 22]willing [end if]patient. Moving in close, she rubs her sexy body against yours, grinding her throbbing knotted erection against you even as she grabs your ass meaningfully. Knowing you're going to be mounted shortly by the horny vixen if you don't do anything, you consider trying to suck her off to satisfy her instead. Shall you attempt an [link]oral distraction (Y)[as]y[end link] or simply accept to let the herm [link]fuck you (N)[as]n[end link]?";
		if Player consents:
			say "     Deciding you'd prefer that throbbing cock of hers in your mouth than elsewhere, you lower yourself to your knees and start licking and kissing at it. She moans in pleasure and runs her paws over your head, pushing her leaking shaft against your lips and into your mouth. As you suck her off, you grow increasingly aroused and eager to get her off, soon lusting for the sexy herm's seed. As you bob your head over her meaty rod, she scribbles some distracted notes on her clipboard, mumbling about her patient's ['][one of]cooperative nature[or]arousal response[or]satisfying progress[at random]['] and ['][one of]eagerness to take [if Player is female]her[else if Player is male]his[else]their[end if] medicine[or]oral fixation[or]lingum activity[at random]['] before turning her full attention back to you as you bump against her growing knot. You rub her plump ballsack with one hand and slide a pair of fingers into her puss with the other, pumping in time to her thrusting, getting her to cum hard and spew her hot load down your throat. You eagerly swallow down the musky mess and suck her cock clean before letting it go, having gotten quite turned on by the whole experience.";
			let x be Libido of Player;
			if fightoutcome is 22, increase x by 15; [submitted]
			if Player is female, increase x by 15; [F/H]
			if a random chance of x in 200 succeeds:
				WaitLineBreak;
				say "     The vixen nurse, panting a little from her orgasm, takes in the scent of your arousal and smiles. Reminded of her initial plan, her cock starts to rise again. Getting hard in your mouth again. Lost in your lust, you help her along, licking and sucking it to restore her erection. With some help from you, soon she's up and ready to go again, which you are far more eager for than before.";
				if Player is herm:
					if a random chance of 1 in 2 succeeds:
						say "[VixenHermNurseAssFuck]";
					else:
						say "[VixenHermNursePussyFuck]";
				else if Player is female:
					say "[VixenHermNursePussyFuck]";
				else:
					say "[VixenHermNurseAssFuck]";
					now Libido of Player is ( Libido of Player + Libido of Player + libido entry ) / 3;
					infect "Vixen Nurse"; [extra infection for double-sex]
			else:
				say "     The vixen nurse, panting a little from her orgasm, pushes you off her spent shaft and straightens her uniform and grins as she places her clipboard in front of the bulge in her skirt. She grins and heads off, perhaps to find another vict... ah... patient in need of her special brand of TLC.";
				increase Libido of Player by 15;
				if Libido of Player > 100, now Libido of Player is 100;
		else if Player is female:
			say "     The vixen nurse pushes you down to the ground, getting you onto all fours. The herm vixen is on you moments later, driving her large fox cock into your pussy, making you moan. She nips at your ears and growls playfully as she pumps her hard shaft into you again and again. You find yourself growing even more aroused[if Player is male] when she reaches around to stroke your pulsing shaft in return[end if], and you are soon pushing back into her thrusts, trying to get as much of her inside your pussy as you can. She gives you a few slaps on the rear with her clipboard, then drives her knot inside you, unleashing her hot seed. This pushes you over the edge, causing you to cum as well.";
			impregchance;
			say "     She holds you tightly to her for a minute fox cum still flowing into you while her knot holds. Eventually she is able to pull out a flood of cum flowing from your pussy as she moves on to let you recover.";
		else:
			say "     The vixen nurse pushes you down to the ground, getting you onto all fours. The herm vixen is on you moments later, driving her large fox cock into your ass, making you groan in pain. She nips at your ears and growls playfully as she pumps her hard shaft into you again and again. You find yourself growing even more aroused and as it becomes more and more pleasurable[if Player is male], especially once she reaches around to stroke your pulsing shaft in return[end if]. You are soon pushing back into her thrusts trying to get her deeper inside of you. She gives you a few slaps on the rear with her clipboard, then drives her knot deep inside you, unleashing her hot seed[if Player is male]. This pushes you over the edge and causes you to cum as well[end if].";
			mimpregchance;
			say "     Held to you by her knot she holds herself on top of you for a minute cum flowing deep inside you. Eventually she is able to pull free and leaves you to rest and recover ass still leaking cum from her intensive care-taking.";
	[value reset]
	now lev entry is 4;

to say BeatTheVixenNurse:
	choose row MonsterID from the Table of Random Critters;
	say "The vixen nurse stops fighting and you move in to catch her, it seems you have a slutty vixen nurse on your hands [bold type]What would you like to do?[roman type][line break]";
	now sextablerun is 0;
	blank out the whole of table of fucking options;
	[]
	if Player is male:
		choose a blank row in table of fucking options;
		now title entry is "Fuck her pussy";
		now sortorder entry is 1;
		now description entry is "Give her a taste of her own medicine";
	[]
	choose a blank row in table of fucking options;
	now title entry is "Play with her";
	now sortorder entry is 2;
	now description entry is "Play with her using your hand";
	[
	if Player is female and vixgender is 1:
		choose a blank row in table of fucking options;
		now title entry is "Ride her cock";
		now sortorder entry is 3;
		now description entry is "Take her knotted cock on your own terms?";
	[]
	if Player is female and vixgender is 1:
		choose a blank row in table of fucking options;
		now title entry is "Let her fuck your pussy";
		now sortorder entry is 4;
		now description entry is "Let her breed your pussy";
	[]
	if vixgender is 1:
		Choose a blank row in table of fucking options;
		now title entry is "Let her fuck your ass";
		now sortorder entry is 5;
		now description entry is "Let her fill your ass";
	]
	sort the table of fucking options in sortorder order;
	repeat with y running from 1 to number of filled rows in table of fucking options:
		choose row y from the table of fucking options;
		say "[link][y] - [title entry][as][y][end link][line break]";
	say "[link]0 - Turn her down[as]0[end link][line break]";
	while sextablerun is 0:
		say "Pick the corresponding number> [run paragraph on]";
		get a number;
		if calcnumber > 0 and calcnumber <= the number of filled rows in table of fucking options:
			now current menu selection is calcnumber;
			choose row calcnumber in table of fucking options;
			say "[title entry]: [description entry]?";
			if Player consents:
				now sextablerun is 1;
				if title entry is:
					-- "Fuck her pussy":
						say "[VixenNursePussyFuck]";
					-- "Play with her":
						say "[VixenNursePlayWithHer]";
					-- "Ride her cock":
						say "[VixenHermNurseRideHer]";
					-- otherwise: say "Sex menu failed!";
				wait for any key;
		else if calcnumber is 0:
			now sextablerun is 1;
			say "     You let the vixen's hand go and she quickly disappears down a hallway, leaving you to gather your thoughts.";
			wait for any key;
		else:
			say "Invalid Option. Pick between 1 and [the number of filled rows in the table of fucking options] or 0 to exit.";
	clear the screen and hyperlink list;
	[value reset]
	choose row MonsterID from the Table of Random Critters;
	now lev entry is 4;


to say VixenNurseDesc:
	choose row MonsterID from the Table of Random Critters;
	now lootchance entry is 20;
	let debit be 0;
	now vixgender is 0;
	if HermList is banned:			[always female if herm banned]
		now vixgender is 0;
	else if hospquest > 5:
		let hermvixchance be 30 + hospquest + hospquest; [increasingly likely as hospquest progresses]
		if hermvixchance > 75, now hermvixchance is 75;
		if a random chance of hermvixchance in 100 succeeds:
			now vixgender is 1; [now a herm]
	if vixgender is 0:
		setmongender 4; [creature is female]
		say "     You find yourself face to face with a sensually curved vixen in a tight, little nurse's outfit. She has a short cut, white apron with a black top under it. There's even a traditional, white nurse's cap with a red cross on it on the vixen's head. She has lustrous, gray fur, indicating that her infection originated from a silver fox. Glancing down those long, slender legs you see they end in digitigrade paws. To her ample chest, she holds a large clipboard. You can still see the bumps that the perky nipples on her four breasts make in the fabric, unblocked by the clipboard. She looks you over quickly and tut-tuts, saying '[one of]It looks like one patient's gotten out of bed[or]Bend over, sweetie. It's time to take your temperature[or]You look like you need a little TLC[or]Please return to the waiting area. The doctor will see you shortly. Until then, let me take care of you[at random].' She raises her clipboard, seemingly intent on clubbing you with it.";
		if hardmode is true and level of Player > 4, let debit be level of Player - 4;
		now HP entry is 36 + ( debit * 4 );
		now monsterHP is 36 + ( debit * 4 );
		now lev entry is 4 + debit;
		now wdam entry is 5 + ( debit / 3 );
		now dex entry is 14 + ( lev entry / 5 );
	else:
		setmongender 5; [creature is herm]
		say "     You find yourself face to face with one of those sensually curved vixen in the tight, little nurse's outfit. She has lustrous, gray fur, indicating that her infection originated from a silver fox. She has a traditional, white nurse's cap with a red cross on it on the vixen's head. She is wearing a short cut, white apron with a black top under it.";
		say "     And there your eyes stop, finding that something is amiss with this naughty nurse. Her tight dress has a rather sizable bulge in it and it is growing larger as you watch. It's a trap! Grinning, she rubs the firm lump and says, '[one of]It looks like one patient's gotten out of bed. I'll tuck you in good and tight[or]Bend over, sweetie. Mmm... I want to take your temperature[or]You look like you need a dose of my medicine[or]Let me give you a thorough examination, my pretty patient[at random].' She rubs her four breasts and moans lustfully before charging at you.";
		if hardmode is true and level of Player > 7, now debit is level of Player - 7;
		now HP entry is 72 + ( debit * 4 );
		now monsterHP is 72 + ( debit * 4 );
		now lev entry is 7 + debit;
		now wdam entry is 8 + ( debit / 3 );
		now dex entry is 18 + ( ( lev entry - 7 ) / 5 );

Section 2 - Creature Insertion

Table of Random Critters (continued)
NewTypeInfection (truth state)	Species Name	Name	Enemy Title	Enemy Name	Enemy Type	Attack	Defeated	Victory	Desc	Face	Body	Skin	Tail	Cock	Face Change	Body Change	Skin Change	Ass Change	Cock Change	str	dex	sta	per	int	cha	sex	HP	lev	wdam	area	Cock Count	Cock Length	Ball Size	Nipple Count	Breast Size	Male Breast Size	Cunt Count	Cunt Depth	Cunt Tightness	Libido	Loot	Lootchance	Scale (number)	Body Descriptor (text)	Type (text)	Magic (truth state)	Resbypass (truth state)	non-infectious (truth state)	Cross-Infection (text)	DayCycle	Altcombat (text)	BannedStatus (truth state)
--	--	--	--	--	--	--	--	--	--	--	--	--	--	--	--	--	--	--	--	--	--	--	--	--	--	--	--	--	--	--	--	--	--	--	--	--	--	--	--	--	--	--	--	--	--	--	--	--	--	--;

When Play begins:
	Choose a blank row from Table of Random Critters;
	now NewTypeInfection entry is false;
	now Species Name entry is ""; [name of the overall species of the infection, used for children, ...]
	add "Vixen Nurse" to infections of VulpineList;
	add "Vixen Nurse" to infections of FurryList;
	add "Vixen Nurse" to infections of NatureList;
	add "Vixen Nurse" to infections of FemaleList;
	add "Vixen Nurse" to infections of TaperedCockList;
	add "Vixen Nurse" to infections of SheathedCockList;
	add "Vixen Nurse" to infections of BipedalList;
	add "Vixen Nurse" to infections of TailList;
	now Name entry is "Vixen Nurse"; [Name of your new Monster]
	now enemy title entry is ""; [name of the encountered creature at combat start - Example: "You run into a giant collie." instead of using "Smooth Collie Shemale" infection name]
	now enemy Name entry is ""; [specific name of unique enemy]
	now enemy type entry is 0; [0 = non unique enemy; 1 = unique (unknown name); 2 = unique (known name) | Used to disqualify unique enemies from Vore/UB and showing the enemy name in encounters]
	now attack entry is "[one of]The naughty nurse gives you a hard slap![or]The vixen bonks you on the head with the clipboard she's carrying![or]The silver vixen gives you a scratch with her claws![or]The vixen nurse stomps her foot-paw down onto the top of your foot![or]Lunging at you, the nurse tries to smother you in her ample cleavage![or]The vixen nurse knees you in the side![or]The silver-furred nurse strikes you firmly at the temple, making your ear ring![or]The nurse moves in quick and grinds her body against you as she gives you a steaming kiss![or]The vixen swings wildly, managing to bop you on the nose with her clipboard![or]She sidesteps you as she grabs your upper arm in one paw and spanks you repeatedly with her clipboard![at random]";
	now defeated entry is "[BeatTheVixenNurse]";
	now victory entry is "[LoseToVixenNurse]"; [Text used when monster wins, can be directly entered like combat text or description. or if more complex it can be linked to a 'To Say' block as the demonstration text shows.]
	now desc entry is "[VixenNurseDesc]"; [ Description of the creature when you encounter it.]
	now face entry is "a vulpine head with a long muzzle and teeth. You have steely-gray eyes and silver fur covers your face"; [ Face description, format as "Your face is (your text)."]
	now body entry is "seductively curved, with a tight, bubble butt. Your hands have hard, black claws at their fingertips and your feet are digitigrade paws now"; [ Body Description, format as "Your body is (your text)."]
	now skin entry is "smooth, silver-colored fur over your"; [ skin Description, format as "You have (your text) skin"]
	now tail entry is "From the base of your spine, you have a silver fox's luxurious tail."; [ Tail description, write a whole Sentence or leave blank. ]
	now cock entry is "steely-gray vulpine"; [ Cock Description, format as you have a 'size' (your text) cock]
	now face change entry is "it shifts and stretches, gaining a long, slender muzzle which ends in a black nose and whiskers. Silvery fur covers his muzzle as your ears move upwards and grow into pointed, vulpine ears"; [ face change text. format as "Your face feels funny as (your text)." ]
	now body change entry is "it becomes a slender and seductively curved one. You can feel your butt shift as it becomes a taut bubble butt, ripe for mounting. Your hands become paw-like, with little black claws at the tips of your fingers. You can hear cracks and pops as your ankle and foot changes, becoming digitigrade paws"; [ body change text. format as "Your body feels funny as (your text)." ]
	now skin change entry is "it grows a soft, fluffy layer of silvery fur"; [ skin change text. format as "Your skin feels funny as (your text)." ]
	now ass change entry is "a floofy fox tail extends from your spine. It is covered in soft, silvery fur"; [ ass/tail change text. format as "Your ass feels funny as (your text)." ]
	now cock change entry is "it takes on a steely-gray color. Changing shape, it becomes pointed at the glans with a knot at its base"; [ cock change text. format as "Your cock feels funny as (your text)." ]
	now str entry is 12;
	now dex entry is 14;
	now sta entry is 10;
	now per entry is 12;
	now int entry is 15;
	now cha entry is 18;
	now sex entry is "Female"; [ Defines which sex the infection will try and make you. current options are 'Male' 'Female' 'Both']
	now HP entry is 36;
	now lev entry is 4; [ Level of the Monster, you get this much XP if you win, or this much XP halved if you loose ]
	now wdam entry is 5; [Amount of Damage monster Does when attacking.]
	now area entry is "Hospital"; [ Location of monster, in this case the City Hospital]
	now Cock Count entry is 0; [ How many cocks will the infection try and cause if sex is 'Male' or 'Both']
	now Cock Length entry is 0; [ Length infection will make cock grow to if cocks]
	now Ball Size entry is 0; [ Size of balls 1-7: "acorn-sized", "dove egg-sized", "chicken egg-sized" "goose-egg sized", "ostrich-egg sized", "basketball-sized", "beachball-sized"]
	now Nipple Count entry is 4; [ Number of nipples infection will give you (males have nipples too) ]
	now Breast Size entry is 4; [Size of breasts infection will try to attain ]
	now Male Breast Size entry is 0; [ Breast size for if Sex="Male", usually zero. ]
	now Cunt Count entry is 1; [ if sex = "Female or both", indicates the number of female sexes infection will grant you.]
	now Cunt Depth entry is 12;
	now Cunt Tightness entry is 5;
	now libido entry is 60; [ Set to zero in this monster to control elsewhere ]
	now loot entry is "healing booster"; [ Dropped item. Key will be used later ]
	now lootchance entry is 20; [ Chance of loot dropping 0-100 ]
	now scale entry is 3; [ Number 1-5, approx size/height of infected PC body: 1=tiny, 3=avg, 5=huge ]
	now body descriptor entry is "[one of]curvaceous[or]sexy[or]effeminate[at random]";
	now type entry is "vulpine"; [ one-word creature type. Ex: feline, canine, lupine, robotic, human... Use [one of] to vary ]
	now magic entry is false;
	now resbypass entry is false;
	now non-infectious entry is false;
	now Cross-Infection entry is ""; [infection that this infection will give the player when they lose; can be left empty if they infect with the monster's own]
	now DayCycle entry is 0; [ 0 = Up at all times; 1 = Diurnal (day encounters only); 2 = Nocturnal (night encounters only);]
	now altcombat entry is "vixennurse"; [ Row used to designate any special combat features, "default" for standard combat. ]
	now BannedStatus entry is false;

[
Table of New Infection Parts (continued)
Species Name	Name	Body Weight	Body Definition	Androginity	Head Change	Head Description	Head Adjective	Head Skin Adjective	Head Color	Head Adornments	Hair Length	Hair Shape	Hair Color	Hair Style	Beard Style	Body Hair Length	Eye Color	Eye Adjective	Mouth Length	Mouth Circumference	Tongue Adjective	Tongue Color	Tongue Length	Torso Change	Torso Description	Torso Adjective	Torso Skin Adjective	Torso Adornments	Torso Color	Torso Pattern	Breast Adjective	Breast Size	Male Breast Size	Nipple Count	Nipple Color	Nipple Shape	Back Change	Back Adornments	Back Skin Adjective	Back Color	Arms Change	Arms Description	Arms Skin Adjective	Arms Color	Locomotion	Legs Change	Legs Description	Legs Skin Adjective	Legs Color	Ass Change	Ass Description	Ass Skin Adjective	Ass Color	Ass Width	Tail Change	Tail Description	tail skin adjective	Tail Color	Asshole Depth	Asshole Tightness	Asshole Color	Cock Change	Cock Description	Cock Adjective	Cock Color	Cock Count	Cock Girth	Cock Length	Ball Description	Ball Count	Ball Size	Cunt Change	Cunt Description	Cunt Adjective	Cunt Color	Cunt Count	Cunt Depth	Cunt Tightness	Clit Size
--	--	--	--	--	--	--	--	--	--	--	--	--	--	--	--	--	--	--	--	--	--	--	--	--	--	--	--	--	--	--	--	--	--	--	--	--	--	--	--	--	--	--	--	--	--	--	--	--	--	--	--	--	--	--	--	--	--	--	--	--	--	--	--	--	--	--	--	--	--	--	--	--	--	--	--	--	--	--;

When Play begins:
	Choose a blank row from Table of New Infection Parts;
	now Species Name entry is ""; [name of the overall species of the infection, used for children, ...]
	now Name entry is ""; [matching infection name to Table of Random Critters]
	now Body Weight entry is 5; [scale of 1-9 for body weight, grouped into low weight (1-3), mid weight (4-6) and high weight (7-9)]
	now Body Definition entry is 5; [scale of 1-9 for body definition, grouped into low muscle (1-3), mid muscle (4-6), high muscle (7-9)]
	[Body Adjective is generated out of the body weight and body definition and can be used in scenes - one word descriptive adjective depending on weight and definition groups: low weight group: skinny/slender/lithe; mid weight group: average/fit/muscled; high weight group: pudgy/husky/jacked]
	now Androginity entry is 5; [1-9 scale of hypermasculine to hyperfeminine]
	[Gender Adjective is generated out of androginity 1-9: hypermasculine/masculine/effeminate/somewhat effeminate/androgynous/feminine butch/tomboyish/feminine/hyperfeminine]
	now Head Change entry is ""; [partial sentence that fits in: "Your head and face [one of]tingle[or]go flush[or]vibrate with odd pleasure[or]go cold[or]feel oily[at random] as [head change entry]."]
	now Head Description entry is ""; [partial sentence that fits in "Your face and head resemble that of [Head Description of Player]. You have [Eye Adjective of Player], [Eye Color of Player] eyes and an overall [Gender Adjective of Player] appearance."]
	now Head Adjective entry is ""; [one word descriptive adjective (avian/canine/...)]
	now Head Skin Adjective entry is ""; [one word descriptive adjective]
	now Head Color entry is ""; [single word color adjective for the dominant color of the skin/fur/feathers/scales]
	now Head Adornments entry is "";[partial sentence that fits in "Before moving on from your head, you give your [head adornments of Player] a proud glance followed by a light caress."]
	now Hair Length entry is 2; [hair length in inches]
	now Hair Shape entry is ""; [one word shape descriptor (curly/straight/...)]
	now Hair Color entry is ""; [one word color descriptor]
	now Hair Style entry is ""; [one word style descriptor (ponytail/mohawk/buzzcut/...) to fit "On top of your head you have [Hair Length of Player] inch long, [Hair Shape of Player] [Hair Color of Player] hair in the [Hair Style of Player] style."]
	now Beard Style entry is ""; [short beard style (goatee/3-day stubble beard/porn stache/mutton chops beard/...) to go into "You have a [Hair Color of Player] [Beard Style of Player]."]
	now Body Hair Length entry is 0; [numerical value, 0-4 (no body hair/light/moderate/heavy/furry) - only set to > 0 if the infection does not have fur/scales/etc. !]
	now Eye Color entry is ""; [one word color descriptor]
	now Eye Adjective entry is ""; [one word descriptive adjective (slitted/round/...)]
	now Mouth Length entry is 3; [inches deep for face fucking; maximum possible will be double this number (when deep throating)]
	[Mouth Length Adjective  is generated by a function and can be used in scenes too - "petite, shallow, average, deep, bottomless"]
	now Mouth Circumference entry is 3; [mouth circumference 1-5, see Mouth Circumference Adjective]
	[Mouth Circumference Adjective is generated by a function and can be used in scenes too - "tiny, small, normal, wide, gaping"]
	now Tongue Adjective entry is ""; [one word descriptive adjective (wide/slobbery/...)]
	now Tongue Color entry is ""; [one word color descriptor]
	now Tongue Length entry is 3; [length in inches]
	now Torso Change entry is ""; [partial sentence that fits in: "Your torso [one of]tingles[or]goes flush[or]vibrates with odd pleasure[or]goes cold[or]feels oily[at random] as [Torso Change entry]."]
	now Torso Description entry is ""; [partial sentence, fitting in "Looking down at yourself, you appear [Gender Adjective of Player] with a [Body Adjective of Player] build. Your torso is [Torso Description of Player][if Body Hair Length of Player > 1], covered in [Torso Color of Player] skin and [Body Hair Description of Player][else if Body Hair Length of Player is 1], covered in smooth, [Torso Color of Player] skin[end if]."]
	now Torso Adjective entry is ""; [one word descriptive adjective (avian/canine/...)]
	now Torso Adornments entry is ""; [(pouch/udders/...); partial sentence to fit: "You take a moment to feel your [torso adornments of Player]."]
	now Torso Skin Adjective entry is ""; [one word adjective (feathered/furred/scaly/...); EMPTY "" for creatures with just skin]
	now Torso Color entry is ""; [single word color adjective for the dominant color of the skin/fur/feathers/scales]
	now Torso Pattern entry is ""; [single word color adjective for the dominant pattern of the skin/fur/feathers/scales]
	now Breast Adjective entry is ""; [adjective(s) example: round, pointy, perky, saggy, bouncy. This would serve as either a general appearance of a infections breasts or possibly something that may be effected by a item or NPC.]
	now Breast Size entry is 0; [cup size as number, counting Flat Pecs = 0, A = 1, B = 2, ...]
	now Male Breast Size entry is 0; [cup size as number, counting Flat Pecs = 0, A = 1, B = 2, ...]
	now Nipple Count entry is 2; [count of nipples]
	now Nipple Color entry is ""; [one word color descriptor]
	now Nipple Shape entry is ""; [shape example: any shape will do as long as it has a baseline with a current infection or item]
	now Back Change entry is ""; [partial sentence that fits in: "Your back [one of]tingles[or]goes flush[or]vibrates with odd pleasure[or]goes cold[or]feels oily[at random] as [Back Change entry]."]
	now Back Adornments entry is ""; [partial sentence to fit: "Your back tickles with the feeling of movement caused by [back adornments of Player]."]
	now Back Skin Adjective entry is ""; [one word adjective (feathered/furred/scaly/...); EMPTY "" for creatures with just skin]
	now Back Color entry is ""; [single word color adjective for the dominant color of the skin/fur/feathers/scales]
	[Limbs Adjective is generated by a function and can be used in scenes too - "rail-thin, slender, sinewy, average, firm, muscular, flabby, meaty, rippling"]
	now Arms Change entry is ""; [partial sentence that fits in: "Your arms [one of]tingle[or]go flush[or]vibrate with odd pleasure[or]go cold[or]feel oily[at random] as [Arms Change entry]."]
	now Arms Description entry is ""; [partial sentence to fit: "Your [Limbs Adjective of Player] arms are [Arms Description of Player]."]
	now Arms Skin Adjective entry is ""; [one word adjective (feathered/furred/scaly/...); EMPTY "" for creatures with just skin]
	now Arms Color entry is ""; [single word color adjective for the dominant color of the skin/fur/feathers/scales]
	now Locomotion entry is ""; [one word adjective: (bipedal/quadrupedal/octapedal/serpentine/sliding)]
	now Legs Change entry is ""; [partial sentence that fits in: "Your legs [one of]tingle[or]go flush[or]vibrate with odd pleasure[or]go cold[or]feel oily[at random] as [Legs Change entry]."]
	now Legs Description entry is ""; [partial sentence to fit: "As your inspection goes even lower, you come to the two [Body Adjective of Player] legs supporting you. They are [legs description of Player]."]
	now Legs Skin Adjective entry is ""; [one word adjective (feathered/furred/scaly/...); EMPTY "" for creatures with just skin]
	now Legs Color entry is ""; [single word color adjective for the dominant color of the skin/fur/feathers/scales]
	now Ass Change entry is ""; [partial sentence that fits in: "Your ass [one of]tingles[or]goes flush[or]vibrates with odd pleasure[or]goes cold[or]feels oily[at random] as [Ass Change entry]."]
	now Ass Description entry is ""; [partial sentence to fit: "Using your hands you feel your behind enjoying the sensation of your [Ass Width Adjective of Player], [Ass Shape Adjective of Player] [Ass Description of Player]." (For players with skin, instead of the period: ", covered in [Ass Color of Player] skin and [Body Hair Description of Player]"]
	now Ass Skin Adjective entry is "";  [one word adjective (feathered/furred/scaly/...); EMPTY "" for creatures with just skin]
	now Ass Color entry is ""; [single word color adjective for the dominant color of the skin/fur/feathers/scales]
	now Ass Width entry is 3; [ass width from 1-5]
	[Ass Width Adjective generated by function out of ass width: dainty/small/round/huge/enormous]
	[Ass Adjective generated by function out of body definition and ass width]
	now Tail Change entry is ""; [partial sentence that fits in: "Your rear [one of]tingles[or]goes flush[or]vibrates with odd pleasure[or]goes cold[or]feels oily[at random] as [if HasTail of Player is true]your existing tail is changed into a [Tail Description entry][else][Tail Change entry][end if]."]
	now Tail Description entry is ""; [partial sentence to fit: "Just below your lower back sprouts a [tail description of Player], which you move back and forth with glee."]
	now Tail Skin Adjective entry is ""; [one word adjective (feathered/furred/scaly/...); EMPTY "" for creatures with just skin]
	now Tail Color entry is ""; [single word color adjective for the dominant color of the skin/fur/feathers/scales]
	now Asshole Depth entry is 7; [inches deep for anal fucking]
	[Asshole Depth Adjective is generated by a function and can be used in scenes too - "petite (< 3), shallow (< 5), average (< 9), deep (< 15), bottomless (15+)"]
	now Asshole Tightness entry is 3; [asshole tightness 1-5, "extremely tight, tight, receptive, open, gaping"]
	[Asshole Tightness Adjective is generated by a function and can be used in scenes too - "extremely tight, tight, receptive, open, gaping"]
	now Asshole Color entry is ""; [one word color descriptor]
	now Cock Count entry is 0;
	now Cock Girth entry is 0; [thickness 1-5, generates the Cock Girth Adjective]
	[Cock Girth Adjective is generated by a function and can be used in scenes too: thin/slender/average/thick/monstrous]
	now Cock Length entry is 0; [length in inches]
	now Cock Adjective entry is ""; [one word adjective: avian/canine/...]
	now Cock Change entry is ""; [partial sentence that fits in: "Your cock [one of]tingles[or]goes flush[or]vibrates with odd pleasure[or]goes cold[or]feels oily[at random] as [Cock Change entry]."]
	now Cock Description entry is ""; [partial sentence to fit: "You have a [Cock Girth Adjective of Player], [Cock Length of Player]-inch-long [cock adjective of Player] [one of]cock[or]penis[or]shaft[or]maleness[at random] that [cock description of Player]."]
	now Cock Color entry is ""; [one word color descriptor]
	now Ball Count entry is 0; [allowed numbers: 1 (uniball), 2 or 4]
	now Ball Size entry is 0; [size of balls 1-7: "acorn-sized", "dove egg-sized", "chicken egg-sized" "goose-egg sized", "ostrich-egg sized", "basketball-sized", "beachball-sized"]
	[Ball Size Adjective is generated by a function and can be used in scenes too]
	now Ball Description entry is ""; [partial sentence to fit: "Underneath it hangs a pair of [Ball Size Adjective of Player] [ball description of Player]."]
	now Cunt Count entry is 0;
	now Cunt Depth entry is 0; [penetratable length in inches; some minor stretching allowed, or more with Twisted Capacity]
	now Cunt Tightness entry is 0; [size 1-5, generates adjectives of extremely tight/tight/receptive/open/gaping]
	[Cunt Tightness Adjective is generated by a function and can be used in scenes too: extremely tight/tight/well-used/open/gaping]
	now Cunt Adjective entry is ""; [one word adjective: avian/canine/...]
	now Cunt Change entry is ""; [partial sentence that fits in: "Your pussy [one of]tingles[or]goes flush[or]vibrates with odd pleasure[or]goes cold[or]feels oily[at random] as [Cunt change entry]."]
	now Cunt Description entry is ""; [partial sentence to fit: "You have a [Cunt Tightness Adjective of Player] [one of]cunt[or]pussy[or]vagina[or]cleft[at random] that [cunt description of Player]."]
	now Cunt Color entry is ""; [one word color descriptor]
	now Clit Size entry is 0; [size 1-5, see Clit Size Adjective]
	[Clit Size Adjective is generated by a function and can be used in scenes: very small/small/average/large/very large]
]


Table of Critter Combat (continued)
name	combat (rule)	preattack (rule)	postattack (rule)	altattack1 (rule)	alt1chance (number)	altattack2 (rule)	alt2chance (number)	monmiss (rule)	continuous (rule)	altstrike (rule)
"vixennurse"	vixhealboost rule	--	--	--	--	--	--	--	--	--

this is the vixhealboost rule:
	choose row MonsterID from the Table of Random Critters;
	if monsterHP <= ( HP entry / 4 ) and lootchance entry > 0 and a random chance of 1 in 4 succeeds:	[weak and not used healing booster]
		let healed be 25;
		increase monsterHP by healed;
		if monsterHP > HP entry:
			decrease healed by HP entry - monsterHP;
			now monsterHP is HP entry;
		say "     The [one of]vixen nurse[or]vulpine nurse[or]silvery vixen[at random] falls back momentarily due to her injuries. She pulls a small syringe filled with blue fluid out and injects it quickly into her [one of]leg[or]thigh[or]arm[or]side[purely at random] before [one of]throwing the empty needle aside[or]tossing the needle away[or]breaking the empty needle on the ground[at random]. As her injuries start to rapidly heal, she then rushes back into the fray to face you again. She has recovered [special-style-1][healed][roman type] HP.";
		now lootchance entry is 0; [used up potential healing booster]
		follow the monster injury rule;
		say "[Name entry] is [descr].";
		wait for any key;
	else:
		standardretaliate;


Table of Game Objects (continued)
name	desc	weight	object
"healing booster"	"A small syringe filled with a clear, blue fluid."	1	healing booster

healing booster is a grab object. It is a part of the player. It is fast. It is not temporary.

the scent of the healing booster is "The healing booster smells of chemicals and medicine.".

when play ends:
	if BodyName of Player is "Vixen Nurse":
		if humanity of Player < 10:
			say "     Falling to the instincts and reprogramming of the infection, you drift off into the city and eventual come to the city hospital. There you are taken in by the silvery vixen nurses of the hospital staff, feeling the urge to work alongside them. They welcome you happily, and lustfully, as do the other denizens of the large medical facility.";
			if hospquest < 2:
				if "Sterile" is not listed in feats of Player and player is female:
					say "     After a particularly energetic romp with one of the jaguar orderlies, you become pregnant and are transferred to the maternity ward. There you tend to the hospital's cubs, adding your own litter to them and feeding the cute cubs from your bosom.";
				else if Player is male:
					say "     Being a rare vulpine in their midst with a cock, you are quite popular with the female vixens and mate with many of them, adding many more cubs to the maternity ward to grow and add to the hospital's population.";
				else:
					say "     Between the strange, medical duties you and the others perform, you enjoy many an evening with the muscled jaguars that populate the hospital, never tiring of the feel of their cocks pounding into your hyper-sexualized body.";
			else if hospquest < 13:
				say "     Drawn by your instincts as a member of the hospital staff, you report back to Dr Mouse. While you only vaguely remember him, he greets you with a smile and happily adds you to his hospital's staff. He puts you in charge of one of his exploratory teams, letting you order around the jaguar orderlies as they capture new [']volunteers['] for his experiments.";
				if Player is female:
					say "     On a trip to the beach, you are ambushed by a crew of pirate sharks after the helicopter. Successfully boarding the craft, they disable the pilot and manage to deal with the orderlies only by sheer numbers. They are all dumped overboard into the sea while you are kept as booty. The sharks celebrate that evening with drink, song and sex, all eager to take a turn with you. Being treated by the good doctor for your duties, you resist physically transforming to become another shark, but your mind unravels again. You are remade into a vixen pirate, lover to this band of air pirates.";
				else:
					say "     During a mission to an old hotel on the outskirts of the red light district, your team is assaulted by a herd of powerful equines. The ferocious orderlies manage to hold their own, but you are dragged off. The horses spend many weeks trying to turn you into another equine slave for their brothel, but the treatment given to you by the mouse doctor holds enough to keep your body intact. But your mind does not fare as well and succumbs to the constant training they give you, turning you into a slutty, silver fox. You act as their medical staff, helping them with their conversions when needed and the rare injuries that are too much for the nanites. When not performing these infrequent duties, you are there to provide a change of pace to anyone looking for something a little different from the otherwise equine whorehouse.";
			else if hospquest is 13 and HP of doctor mouse is 1:
				say "     Driven by your new instincts as a member of the hospital staff, you report back to Dr Mouse. While you only vaguely remember the experiences that lead you to know him, he somehow recognizes you readily and is cruelly pleased with your fate. Fully subservient to him now, he takes delight in ordering you around and using you for any twisted experiment he wants. Your body is changed over and over again in countless ways over the years and you are often used to mate with any new test subjects he captures for his amusement";
				if "Sterile" is not listed in feats of Player and player is female:
					say ". You birth many bizarre, hybrid creatures from these matings";
				say ". You do all this for him gladly, though never understanding why he is so mean to you, his loyal follower";
				if Player is female:
					say ". It hurts you the most any time he takes you as a lover to slake his lust upon you. He is particularly cruel at these times, but you want it so badly from him and love it so much when your master fills you with his seed";
				say ".";
			else if hospquest is 13 and HP of doctor mouse is 2:
				say "     The hospital is in disarray when you arrive, more like a stirred up hornets nest than the orderly bee hive you feel it should be. The various factions strike out at each other at times, but cooperate at others. The maternity ward still runs, but the cafeteria is often host to in-fighting over mates.";
				if intelligence of Player >= 20 and charisma of Player >= 15 and "Expert Medic" is listed in feats of Player:
					say "     It is only with the coming of the military that control is restored. The united threat of military action unifies the factions, at least temporarily. And you would see that order remain and start taking charge of the groups. Feeling the need to have someone in charge, the other groups begin to respond to your commands, beginning to rely on you to fill that void. Your familiarity and experience in the city helps counter the military incursion. You use your knowledge of the safe paths through the city and its havens to hide to command the medical staff into position over the radio. Using medical and anatomical terminology for your code, the staff understand it intrinsically and can act upon it instantly while the military code-breakers labor over it. The strikes are made with surgical precision, excising key elements from the military supply and support chain within the city until the point that they're driven back from the hospital. With the hospital left alone and a new collection of test subjects, you leave the remaining military forces largely alone.";
					say "     Taking over as the head of the hospital from that point comes naturally. The groups fall into line and order is restored to you hospital. While lacking the extensive medical training and experience Dr. Mouse had, you learn quickly by studying the numerous medical books and journals throughout the hospital. You even start up some experiments of your own, enjoying converting the captured soldiers into more staff or using them for perverse, sexual cross-breeding with sample creatures. While perhaps not as ambitious as the mouse's experiments, you also have no urge to leave the hospital like he did, content with your orderly medical center and your collection of cross-breed test subjects to satisfy your myriad sexual hungers.";
					increase score by 50;
				else:
					say "     It is only with the coming of the military that control is restored. The united threat of military action unites the factions, at least temporarily. And you would see that unity remain and enact a plan that percolates in the back of your mind. Feeling the need to have someone in charge, you break from the defense and slip past the military lines. You find a small veterinarian hospital and spot some activity inside. Armed with a syringe filled with tranquilizers and a need to do what must be done for the good of the hospital, you slip in and attack the panther taur vet. Unprepared for the injection, she moved in close, letting you knock her out with it.";
					say "     You relay your success over the radio to the hospital, but it takes them some time to get a team past the military and out to you. Thankfully the veterinary clinic still has supplies and you're able to keep her under until you can get her back to the hospital. One of the female jaguars is allowed to welcome the panther herm to the hospital, bonding her into the staff as your new leader. The taur doctor fills her position well, maintaining the unity of the hospital staff after the military is repulsed. The hospital's medical work slacks off, but several of the staff are sent out to capture many animal creatures from the city. These are converted into more staff for an expanding new wing for sexual veterinary medicine.";
			else:
				say "     Drawn by your instincts as a member of the hospital staff, you report back to Dr Mouse. While you only vaguely remember him, he greets you with a smile and happily adds you to his hospital's staff. He puts you in charge of monitoring his test subjects with a pair of jaguars to act as your muscle. Obediently, you follow the mad doctor's orders, watching his [']volunteers['] and often using them as play-toys when he's done with them before sending them downstairs to the hospital proper to be assimilated into the staff[if Susan is in hidden lab]. Susan, as his assistant, is there with him to help you and reward you with lustful sex[end if].";
				say "     When the time comes to leave the city, Dr Mouse takes you[if Susan is in hidden lab], Susan[end if] and several other of the staff to escape through the service tunnels under the hospital. Meanwhile the main body of the staff hold the hospital against the army with the helicopter running as an added diversion. You all escape out of the city and Dr Mouse sets up a new lab in secret. He begins selling off the fruits of his research to foreign powers and the growing factions of transformed creatures that form. He has you continue to monitor his test subjects for his ongoing experiments";
				if Player is female:
					say ". You also are honored with being the little mouse's personal sex-toy when he needs to unwind after a particularly exciting procedure";
					if "Sterile" is not listed in feats of Player:
						say ". You are very proud when your belly grows full, swelling with his young";
				say ".";
		else:
			if hospquest > 13:
				say "     When you are rescued from the infected city by the military, they take you to a base they've set up for the testing and processing of the infected. While you are being examined, you have to resist your urges to play with doctors like the naughty nurse you are. You can't afford to draw too much attention to yourself. Using your innate medical knowledge and your sensual body, you avoid receiving the treatment to render you non-infectious and fudge the results. When cleared, you travel to a new city and insinuate yourself into a small clinic, infecting the staff there and setting up a nice little den of silver foxes to be your mates.";
			else:
				say "     When you are rescued from the infected city by the military, they take you to a base they've set up for testing and processing of the infected. While you are being examined, you chat up the doctors. At first, they are clinical and unresponsive to your playful antics, but eventually begin to warm up to you as you prove clever and knowledgeable about their medical examinations. At your behest, one of them gets a nurse's outfit for you and join their staff. Receiving the treatment to render you non-infectious, they also start giving in to your playful banter and sneaking off with you for a little fun to help relieve their stress after a particularly alluring patient gets them riled up.";

Naughty Nurse ends here.
