Version 6 of Sven by Stripes begins here.
[Version 6 - Alternate 'Confident Sven' path]
"Adds an NPC named Sven/Svetlana to the Flexible Survival game"

Section 1 - Event and Hideaway

Hidden Kitty is a situation. The level of Hidden Kitty is 5.
The sarea of Hidden Kitty is "Red".
when play begins:
	add Hidden Kitty to badspots of guy;
	add Hidden Kitty to badspots of furry;

Instead of resolving a Hidden Kitty:
	now lastSvendrink is turns + 8;
	say "     While exploring in one of the older residential areas at the edge of this seedy district of town, you spot the flash of white and gray as something dashes down the steps and quickly shuts the basement door behind it. You catch sight of someone nervously glancing out from behind the curtains covering the basement window, watching you. As this is atypical behavior for someone who's succumbed, you're hopeful that this is a survivor. You wave and head cautiously to the door, trying to look non-threatening while remaining at the ready. You knock and assure them that you are still sane and want to help. It takes a while, always unsure if they're even listening as you can't risk yelling and drawing any infected to the house.";
	say "     Eventually, it seems you are able to convince him and he opens the door to his small, basement apartment. As you look the young man over, he wrings his fluffy tail in his hands. The tail is a snowy white with gray and black leopard spots. He has a pair of feline ears poking out from his long, blond hair. For a tall, well-built fellow, he seems very timid and nervous as he shyly invites you in before quickly glancing around and then closing the door again. He speaks with a noticeable Nordic accent.";
	wait for any key;
	LineBreak;
	move player to Sven's Place;
	now Sven's Place is known;
	now battleground is "void";
	increase score by 5;
	Now Hidden Kitty is resolved;

Sven's Place is a room. It is fasttravel. It is private.
The description of Sven's Place is "[SvenPlaceDesc]".

the scent of Sven's Place is "The small basement apartment smells faintly of mold and snow leopard from its [if HP of Sven > 3]former [end if]occupant[if HP of Sven is 99]. The scent of snow leopard sex from the cum is strong[end if].".

to say SvenPlaceDesc:
	if HP of Sven < 4: [Sven still at home]
		say "     Hidden beneath one of the many homes in this neighborhood, Sven's basement apartment has avoided scrutiny by the lustful hordes outside for the moment. The rundown place has little furniture and fewer supplies. It seems whatever stores the young man had are almost gone. The apartment is tidy enough, with most of the mess coming from his confinement while hiding and not from slovenliness. The place is made up of a small kitchen, a smaller bathroom and one small bedroom.";
	else if HP of Sven > 3 and HP of Sven < 99: [Sven left]
		say "     Hidden beneath one of the many homes in this neighborhood, Sven's basement apartment has been broken into and the door smashed. The rundown place has little furniture and no remaining supplies. It seems he's taken what little stores he had with him. The apartment is tidy enough, with most of the mess coming from his confinement while hiding and not from slovenliness. The place is made up of a small kitchen, a smaller bathroom and one small bedroom.";
	else if HP of Sven is 99: [Sven was taken]
		say "     Hidden beneath one of the many homes in this neighborhood, Sven's basement apartment has been broken into and the door smashed. The rundown place has little furniture and no more supplies. The place is quite the mess now, with the two snow leopards using it as a cool place to rut. Their scent is strong in the air and there are cum stains everywhere, especially in the bedroom. There is no longer a reason to come here.";
	else if HP of Sven is 100: [Sven lost in the city]
		say "     Hidden beneath one of the many homes in this neighborhood, Sven's basement apartment has avoided scrutiny by the lustful hordes outside for the moment. The rundown place has little furniture and no more supplies. It seems whatever stores the young man had ran out and he went off into the city and hasn't returned. There is no longer a reason to come here.";


Section 2 - Sven the Snowmeow

Sven is a man. Sven is in Sven's Place. The HP of Sven is normally 0.
The description of Sven is "[SvenDesc]".
The conversation of Sven is { "Mew!" }.
lastSvendrink is a number that varies. lastSvendrink is normally 555.
SvenCandyMsg is a number that varies. SvenCandyMsg is usually 0.
SvenStory1 is a truth state that varies. SvenStory1 is usually false.

the scent of Sven is "[SvenScent]".

to say SvenScent:
	if HP of Sven < 5 or HP of Sven is 50: [no sex yet, not fully transformed]
		say "Sven smells faintly of male snow leopard and growing arousal.";
	else if HP of Sven < 8: [sexed up]
		say "Sven smells increasingly of male snow leopard and sex.";
	else if HP of Sven < 30 and lust of Sven is 1: [Sven + Candy]
		say "Sven smells like a male snow leopard and heavily of sex[if HP of Sven is 8]. Your scent is mixed in with his[else]. Aside from your scent all over him, there's a hint of cotton candy sweetness from his raccoon playmate[end if].";
	else if HP of Sven < 30 and lust of Sven is 2: [Sven + Candy]
		say "Sven smells like a male snow leopard and heavily of sex[if HP of Sven is 8]. He is marked quite thoroughly with your scent from all your messy fun with the kitty[else]. Aside from your scent all over him, there's a hint of cotton candy sweetness from his raccoon playmate[end if].";
	else if HP of Sven < 50: [transformed]
		say "Sven smells of male snow leopard and growing arousal.";
	else if HP of Sven is 51: [settling in at the porn store]
		say "Sven smells faintly of snow leopard, mouse and sex. There's a mix of male and female scents over him, lingering from his fun with Lisa.";

to say SvenDesc:
	if HP of Sven < 4: [still at his place]
		say "     Sven is tall and well-built, looking roughly 20 years old. He has long, blond hair, blue eyes and Nordic features. Poking from his golden hair are a pair of feline ears. These, along with his tail, are his only visible signs of infection. He clutches the fluffy snow leopard tail nervously, petting and wringing it in his hands. He speaks in a soft, shy voice with a Scandinavian accent. He has a light t-shirt and shorts on, but still seems quite hot in the relatively cool basement apartment.";
	else if HP of Sven is 4: [pet Sven - in the bunker]
		say "     Sven is tall and well-built, looking roughly 20 years old. He has long, blond hair, blue eyes and Nordic features. Poking from his golden hair are a pair of feline ears. These, along with his tail, are his only visible signs of infection. He clutches the fluffy snow leopard tail nervously, petting and wringing it in his hands. He speaks in a soft, shy voice with a Scandinavian accent. He has a light t-shirt and shorts on and seems more comfortable in the much cooler underground bunker now that he's here.";
	else if HP of Sven is 5: [pet Sven - player fucked him]
		say "     Sven has gained a little more fur after his first bout of fun with you. He still has his long, blond hair and blue eyes, though his face is a little more feline in shape. His feline ears poke from his golden hair. He pets and strokes his fluffy, snow leopard tail with furry paws now. He speaks in a soft, shy voice with a Scandinavian accent. He has a light t-shirt and shorts on and seems more comfortable in the much cooler underground bunker now that he's here, though his clothes seem a little looser on him now.";
	else if HP of Sven is 6 or HP of Sven is 7: [pet Sven - collar quest]
		say "     Sven is fully covered in a soft pelt of snow leopard fur. It's clear he's gotten shorter as well, roughly of average height now, though it's hard to tell with the infection throwing off your sense of scale at times. He still has his long, blond hair, blue eyes and a few traces of his human face remaining, but it is mostly feline now. His feline ears poke from his golden hair. Despite his feline muzzle, he still speaks in a soft, shy voice with a Scandinavian accent. It seems he's decided to stop wearing clothes at all now that he's got a coat of fur instead. He grooms it often, keeping it soft and beautiful. He still tries to cover himself up with his tail from time to time, but will give you blushing glances or a flash of his erect cock behind it. You smile to yourself, quite pleased at how your pet is coming along[if HP of Sven is 6]. Looking at him, you are again reminded of your idea to get a collar for him[else if HP of Sven is 7]. Remembering the collar you picked up for him, you find yourself looking forward to presenting it to him[end if].";
	else if HP of Sven is 8: [pet Sven - collared]
		say "     Sven is fully covered in a soft pelt of snow leopard fur. He's gotten much shorter than when you first met him, now only about five feet tall. His head is fully feline, but still has his long, blond hair and baby blue eyes. Despite his feline muzzle, the snowmeow still speaks in a soft, shy voice with a Scandinavian accent. Now your sexy fuck-toy, he is no longer wearing clothes at all and runs his paws over his sensually soft coat of fur. He grooms it often, keeping it soft and beautiful. He makes little effort to cover himself with his tail when you're looking, giving you peeks at his erect cock or sexy ass from behind it. You smile to yourself, very pleased at how your pet has turned out and you look forward to the next time you have a moment to show him how much you enjoy your feline fuck-toy.";
	else if HP of Sven is 9: [pet Sven - transition state]
		say "ERROR-Sven-9L: You should not be able to find me! Exiting and re-entering the bunker should resolve this.";
	else if HP of Sven is 10: [pet Sven - +Candy]
		say "     Sven is fully covered in a soft pelt of snow leopard fur, though his markings are [if lust of Sven is 1]baby blue in color[else if lust of Sven is 2]a golden yellow[end if], as is his long, flowing hair. He's gotten much shorter than when you first met him, now only about five feet tall. His head is fully feline now, that of a snowmeow with baby blue eyes. He feline ears poke from his [if lust of Sven is 1]light blue[else if lust of Sven is 2]golden[end if] hair. Despite his feline muzzle, the snowmeow still speaks in a soft, shy voice with a Scandinavian accent. Now your sexy fuck-toy, he is no longer wearing clothes at all and runs his paws over his sensually soft coat of fur. He grooms it often, keeping it soft and beautiful. He makes little effort to cover himself with his tail when you're looking, giving you peeks at his erect cock or sexy ass from behind it. His penis has changed color as well to match his brighter markings. You smile to yourself, very pleased at how your pet has turned out and you look forward to the next time you have a moment to show him how much you enjoy your feline fuck-toy. He and Candy snuggle and play around from time to time, making quite a show of it if you're there to watch.";
	else if HP of Sven >= 30 and HP of Sven < 50:	[self-confident Sven]
		say "     Sven is fully covered in a soft pelt of snow leopard fur. Unlike the other snow leopards around, he's kept the height from his Nordic heritage, making him appear quite impressive. And while his head is fully feline, he's also still has his long, blond hair and baby blue eyes. Despite his feline muzzle, the snowmeow still speaks in a soft voice with a Scandinavian accent, though his earlier timidity is largely gone. Now an impressive and sexy feline with a fluffy coat of fur, all he wears are some shorts he's brought with him after abandoning his basement apartment. He grooms his sensually soft fur often, keeping it soft and beautiful. He seems particularly pleased with his long, fluffy tail and pets it often and playfully uses it to teasingly hide his crotch.";
	[Sven at Porn Store]
	else if HP of Sven is 50:
		say "     Sven is tall and well-built, looking roughly 20 years old. He has long, blond hair, blue eyes and Nordic features. Poking from his golden hair are a pair of feline ears. These, along with his tail, are his only visible signs of infection. He blushes quite a bit at everything around him in the store, trying his best to hide the bulge in his shorts behind his tail while trying not to seem like he's looking it all over. He clutches the fluffy snow leopard tail nervously, petting and wringing it in his hands. He speaks in a soft, shy voice with a Scandinavian accent. He has a light t-shirt and shorts on and seems a little overheated in the store, but that could be the surrounds as well. It does seem that Lisa has quite a bit for him to drink, so he's coping well regardless.";
	else if HP of Sven is 51:
		say "     Sven is tall and well-built, looking roughly 20 years old. It seems his infection has progressed somewhat, with snow leopard fur covering his body now. He still has his long, blond hair and blue eyes, though his face is a more feline in shape. His feline ears poke from his golden hair. He pets and strokes his fluffy, snow leopard tail with furry paws now. He still blushes a little at the store's more graphic wares, but seems to be coping much better now. He seems less worried about hiding the bulge in his shorts as well, though blushes behind his tail when he sees you notice it. He also seems much more at ease with Lisa's casual touches to his feline body, purring softly. He speaks in a soft, shy voice with a Scandinavian accent. He has shorts on and seems a little overheated in the store with his thick fur, having to go topless. It does seem that Lisa has quite a bit for him to drink, so he's coping well regardless.";
	else if HP of Sven > 51:
		say "ERROR-Sven-52L: You should not be able to find me!";

instead of conversing the Sven:
	if HP of Sven is 0: [first meeting]
		say "     He clutches his tail to his chest, stroking it nervously as he speaks. 'I am Sven. I am attending college here on an international scholarship.' He talks softly and carefully, with a noticeable accent. He tells you that he's been holed up down here since the outbreak, living off what supplies he had. As they began to run low, he headed out into the city and had the misfortune of running into one of the snow leopard men running around. He fidgets a little in his seat, sporting a stiffy in his shorts as he tells you the feline forced itself on him. He tries to hide the bulge with his tail and quickly changes the subject.";
		say "     'It is getting very hot out now, but I do not want to head out again. Those sexy ki... uhh... I might be spotted again. Do you think someone might come to help us soon?' He tries fanning himself with his tail.";
		if water bottle is owned:
			say "     [bold type]'Do you have any fresh water I could have, my friend?'[roman type][line break]";
			LineBreak;
			say "     ([link]Y[as]y[end link]) - Yes.";
			say "     ([link]N[as]n[end link]) - No.";
			if the player consents:
				LineBreak;
				say "     You pull out a bottle of water and give it to the poor fellow. He tries his best to drink it down slowly, but soon finishes it off. He seems much better having gotten a much-needed drink.";
				now lastSvendrink is turns;
				now HP of Sven is 2;
				decrease carried of water bottle by 1;
				increase score by 5;
				say "     'I should be okay for a little while now, but please come back and visit again. I do not really want to leave here again.' You start to mention moving him to the bunker, but he fidgets nervously in his seat and shakes his head vigorously. He is clearly not ready for such a trek across the city after his unfortunate first attempt outside.";
			else:
				LineBreak;
				say "     You tell him you don't have any at the moment, but promise to be on the look out for extra for him. He seems a little disappointed, but nods and continues fanning himself with his tail.";
				now HP of Sven is 1;
		else:
			say "     You tell him you don't have any at the moment, but promise to be on the look out for extra for him. He seems a little disappointed, but nods and continues fanning himself with his tail.";
			now HP of Sven is 1;
	else if HP of Sven is 1: [asking for water]
		say "     The poor fellow is clearly having a hard time with the heat and his low supplies. '[one of]Can I get a bottle of water from you, please?'[or]I never thought it would be so hot in this country when I accepted the scholarship.'[or]Do you have any water to spare?'[or]How long do you think we will have to keep waiting before someone comes to help us?'[or]'I am worried what my parents will say when they see me like this. They were finally so proud of me when I got my scholarship.'[or]Do you think they will be able to undo what has been done to us?'[in random order]";
		if water bottle is owned:
			say "     [bold type]Do you give the thirsty fellow a drink from your water supply?[roman type][line break]";
			LineBreak;
			say "     ([link]Y[as]y[end link]) - Yes.";
			say "     ([link]N[as]n[end link]) - No.";
			if the player consents:
				LineBreak;
				say "     You pull out a bottle of water and give it to the poor fellow. He is very grateful as he shyly takes it from you. He tries his best to drink it down slowly, but soon finishes it off. He seems much better having gotten a much-needed drink.";
				decrease carried of water bottle by 1;
				now lastSvendrink is turns;
				now HP of Sven is 2;
				increase score by 5;
				say "     'I should be okay for a little while now, but please come back and visit again. I do not really want to leave here again.' You start to mention moving him to the bunker, but he fidgets nervously in his seat and shakes his head vigorously. He is clearly not ready for such a trek across the city after his unfortunate first attempt outside.";
	else if HP of Sven is 2 and lastSvendrink - turns < 8: [just chatting]
		say "     [one of]The partially feline fellow nervously strokes his new tail as he tries to stay calm.[or]'I am very grateful for your help. I do not know what would have happened if you had not come along.'[or]'I never thought it would be so hot in this country when I accepted the scholarship.'[or]'How long do you think we will have to keep hiding before someone comes to rescue us?'[or]'I am worried what my parents will say when they see me like this. They were finally so proud of me when I got my scholarship.'[or]'Do you think they will be able to undo what has been done to us?'[or]Sven fidgets with his new tail while you speak to him. He doesn't seem to pay much attention and you spot a bulge in his shorts that he's trying to hide with his tail.[in random order]";
	else if HP of Sven is 2: [more water needed]
		say "     The poor fellow is clearly suffering from thirst again and having a hard time between the heat and his low supplies. '[one of]Can I get another bottle of water from you, please?'[or]I never thought it would be so hot in this country when I accepted the scholarship.'[or]Do you have any more water to spare?'[or]How long do you think we will have to keep waiting before someone comes to help us?'[or]'I am worried what my parents will say when they see me like this. They were finally so proud of me when I got my scholarship.'[or]Do you think they will be able to undo what has been done to us?'[or]I hate to be a bother, but do you have more water for me?'[in random order]";
		if water bottle is owned:
			say "     [bold type]Do you give the thirsty fellow a drink from your water supply?[roman type][line break]";
			LineBreak;
			say "     ([link]Y[as]y[end link]) - Yes.";
			say "     ([link]N[as]n[end link]) - No.";
			if the player consents:
				LineBreak;
				say "     You pull out a bottle of water and give it to the poor fellow. He is very grateful as he shyly takes it from you. He tries his best to drink it down slowly, but soon finishes it off. He seems much better having gotten a much-needed drink.";
				decrease carried of water bottle by 1;
				now lastSvendrink is turns;
				now HP of Sven is 3;
				increase score by 5;
				say "     'I should be okay for a little while now, but please come back and visit again. I do not really want to leave here again.' You start to mention moving him to the bunker, but shakes his head and wrings his tail nervously. It seems he's still not ready for such a trek across the city after his unfortunate first attempt outside.";
			else:
				LineBreak;
				say "     You tell him that you don't have any extra water at the moment, but you assure him you'll keep your eyes open and try to find more for him.";
	else if HP of Sven is 3 and lastSvendrink - turns < 8: [just chatting 2]
		say "     [one of]The partially feline fellow nervously strokes his new tail as he tries to stay calm.[or]'I am very grateful for your help. I do not know what would have happened if you had not come along.'[or]'I really appreciate all you have done for me. Please come back and check up on me again.'[or]'I would like to repay you for your help somehow, but I do not really have anything.' He fidgets nervously and presses his tail into his lap, growing quiet again.[or]'I never thought it would be so hot in this country when I accepted the scholarship.'[or]'How long do you think we will have to keep hiding before someone comes to rescue us?'[or]'I am worried what my parents will say when they see me like this. They were finally so proud of me when I got my scholarship.'[or]'Do you think they will undo what has been done to us?'[or]Sven fidgets with his new tail while you speak to him. He doesn't seem to pay much attention and you spot a bulge in his shorts that he's trying to hide with his tail.[in random order]";
	else if HP of Sven is 3: [Snow leopard attack]
		say "     As you sit with Sven, watching him stroke his tail and nibble at its tip nervously. 'I... umm... do you have any more water I could get? I do not really have anything I can give you for it, but I guess I could... you know...' He squirms in his seat and you spot a bulge in his shorts that he's trying to hide with his tail. You smile politely, trying not to grin and let on you know what's coming when there is a loud growl outside followed by banging at the door that interrupts your conversation.";
		say "     You grab your weapon and press yourself against the door to help barricade it as whatever is outside charges down the steps again and again to batter against it. The beast's pounding and claw slashes soon weaken the flimsy door too much and it starts to break in. Through the cracks, you can see it is a snow leopard like Sven, but fully transformed and wild, and probably drawn by your friend's scent. The next time it moves back for another charge, you whip open the door and charge it first, pushing it out of the stairwell and into the street.";
		WaitLineBreak;
		say "     Finding yourself about to face off against the angry feline, you ready for battle. As the fight is about to begin, you have a moment to size the creature up.";
		say "     [bold type] Do you feel you can handle this fight on your own or shall you try to convince Sven to fight back?[roman type][line break]";
		LineBreak;
		say "     ([link]Y[as]y[end link]) - Fight on your own.";
		say "     ([link]N[as]n[end link]) - Convince Sven to fight back.";
		if the player consents:
			LineBreak;
			say "[SvenRescueFight]";
		else:
			LineBreak;
			let bonus be ( charisma of player minus 10 ) divided by 2;
			if hardmode is false, increase bonus by level of player / 5;
			if bonus > 8, now bonus is 8;
			let dice be a random number from 1 to 20;
			say "You roll 1d20([dice])+[bonus]= [special-style-1][dice + bonus][roman type] vs [special-style-2]12[roman type]:[line break]";
			if bonus + dice > 11:
				say "     You call for Sven's help in the fight, [if level of player < 6]struggling to hold out against the powerful feline as best you can[else if level of player > 8 and hardmode is false]keeping the feline in check fairly easily while you try to rally him[else]holding your own against the feline while you try to rally him[end if]. It takes [if bonus + dice > 15]some[else]quite a bit of[end if] coaxing, but you manage to get the young man to assist you. Once he joins in the fray, he proves to be quite the asset, using his strength and longer reach to keep the compact feline off balance. The snow leopard, suddenly at the disadvantage, gets taken down [if level of player < 6]with less struggle, Sven managing to get in the final blow[else if level of player > 8 and hardmode is false]quite easily, you letting Sven get in the final blow[else]easily enough when Sven strikes the final blow[end if] while you keep it at bay. Staggered, the gray spotted cat is easily pushed to the ground by the two of you.";
				say "     Grabbing the feline's wrists, you sit upon his chest while Sven plants himself down on the cat's legs. With your foe held down, the two of you pant from the excitement. Looking over your shoulder at him, you can tell that Sven is surprised by what he's accomplished. This creature he feared, once faced, has been defeated with your help - and thus, so has his fear.";
				WaitLineBreak;
				say "     And with that fear gone, that arousal he had earlier returns, but now with a new-found confidence to back it up. There is but a brief hesitation before his hand moves to the snow leopard's crotch, fondling is sheath and cock with a quiet, giddy laugh of unrestrained excitement. While the gray shaft had started to go flaccid after the creature's defeat, the touch soon brings it back to full arousal.";
				say "     Sven gives the snow leopard's shaft several slow strokes with growing ease. His tail-tip twitches, betraying his excitement at handling the object of his desires. 'Hold him down,' he says with an eagerness in his eyes and a grin like the cat who's gotten the cream. Or going to get the cream, in this case. Sliding further back and laying down, he moves his head in to take a closer look at his prize. It soon goes from looking to smelling, nuzzling and licking before finally sucking on the pulsing rod with obvious relish.";
				WaitLineBreak;
				let xx be 0;
				if cocks of player > 0 or cunts of player > 0:
					say "     Hearing the cat beneath you give a pleasant rumble, you look down at him. With his head right there between your legs, it would be easy to join in on the fun.";
					say "     [bold type] Shall you get the pinned kitty to [if cocks of player > 0]suck you off[else]eat you out[end if] or just watch the show behind you?[roman type][line break]";
					LineBreak;
					say "     ([link]Y[as]y[end link]) - Get the pinned kitty to [if cocks of player > 0]suck you off[else]eat you out[end if].";
					say "     ([link]N[as]n[end link]) - Watch the show.";
					if the player consents:
						LineBreak;
						now xx is 1;
						if cocks of player > 0:
							say "     Wanting to get in on the action, you grab the snow leopard's head and pull it forward to meet your erection. The cat gives an obstinate snarl, but relents with a moan when Sven pushes himself down onto the feline's cock again. His warm muzzle slides over your [cock of player] meat[if cock length of player > 36] with some initial difficulty given your [cock size desc of player] size[else if cock length of player > 24], stretching his mouth open wide to fit your big manhood[else if cock length of player > 12] with increased desire once he sees your impressive manhood[else] with a lustful hunger in his feral eyes[end if]. His raspy tongue plays across your throbbing meat as he licks and sucks on it while rumbling in delight.";
						else:
							say "     Wanting to get in on the action, you grab the snow leopard's head and pull it forward to meet your crotch. The cat gives an obstinate snarl, but relents with a moan when Sven pushes himself down onto the feline's cock again. With his nose pressed to your pussy, the scent of it captivates him and soon he's licking at your dripping petals. That raspy tongue feels great sliding across your sensitive folds and clit. After several licks, it delves deeper, lapping inside your quivering cunny while the pinned feline rumbles in delight.";
					else:
						LineBreak;
						say "     While the snow leopard seems little interested in fighting or struggling at this point, keeping him restrained seems to be the safer course of action. Rather than risk getting too distracted, you keep a firm grip on the feline's arms and watch Sven over your shoulder. Besides, you feel you should let Sven enjoy his moment of personal victory.";
				WaitLineBreak;
				say "     Only after thoroughly savoring that gray shaft with his mouth and tongue does Sven pull away. His mouth is more of a muzzle at this point and fluff is spreading from it. His hands (looking increasingly like paws) wrestle his shorts down. You start to warn him about what you're seeing, but he just nods.";
				say "     'I know. I can feel it. But I suspect it would happen regardless. This way I know it will be on my terms.' And with that, he presses his ass down onto the other male's cock, taking it into his virgin rear with a mrowl of pained delight. The transforming man takes several panting breaths to adjust before starting to ride it with growing satisfaction.";
				if xx is 1:
					say "     Turning your attention back to the front, you rub the [if cocks of player > 0]sucking[else]licking[end if] snow leopard's fluffy ears. The horny creature rumbles and purrs softly, attempting to get you off with increased vigor. That warm muzzle and lashing tongue of his feel wonderful [if cocks of player > 0]upon your throbbing shaft[else]across and inside your quivering mound[end if]. Your excitement continues to build, making you forget your concerns about Sven's transformation and it's only once the young man behind you gives a particularly strong moan do you turn your attention back to him.";
				WaitLineBreak;
				say "     Sven continues to ride the pinned feline as his transformation progresses at an increasing rate. Fur spreads across his face as his head becomes more and more that of a snow leopard like the one he's riding. It also creeps up his body and down his legs, probably spreading from his fluffy tail. His cock is not exempt either, the color shifting to a steely gray and gaining several inches. A sheath forms at the base of his erection while white fluff covers his swelling balls.";
				say "     As the young man's transformation into a snow leopard is reaching completion, so does the feline beneath [if xx is 0]him[else]you both[end if]. With a snarl of climactic release, you know he's pumping his hot load into Sven's bowels. The new feline, clearly loving every delicious moment of this, cums moments later, spraying his load [if xx is 1]across your back and onto his chest. By the time to two felines are spent, you've cum as well, providing the quelled kitty with a tasty treat[else]onto his chest[end if]. Once sated, you help Sven rise and send the other snow leopard on his way.";
				WaitLineBreak;
				say "     After your victory against the intruder, the two of you look around quickly to make sure other infected weren't attracted by the commotion before heading back to the basement apartment. Once back inside, he heaves a heavy sigh of relief and slumps against a wall. You give him a moment to collect his thoughts before urging him to get ready to leave. Looking at the destroyed door, he nods affirmatively and rushes about his former haven to gather a few things and the last of his supplies into his backpack. Once ready, he slings his pack over his shoulder and charges up the steps two at a time. Following him up, you suggest that he stay with you in the bunker, to which he agrees readily[if daytimer is day]. The daytime heat is quite oppressive to the fully snow leopard Sven, but he perseveres and eventually makes it to the relative coolness of the bunker[else]. Thankfully, with the sun down, the heat has let up slightly, letting the fully snow leopard Sven make the journey to the relative coolness of the bunker[end if].";
				now HP of Sven is 30;
				move Sven to bunker;
				move player to bunker;
				increase score by 20;
			else:
				say "     Try as you might, you are unable to inspire the young man to stand up for himself. It looks like you'll have to deal with this yourself.";
				say "[SvenRescueFight]";
	else if HP of Sven is 4:
		say "     [one of]The partially feline fellow strokes his new tail, purring softly.[or]'I am very grateful for your help. I do not know what would have happened if you had not come along. You're so brave, strong and sexy.' He blushes and hides behind his tail after admitting that aloud.[or]'I really appreciate all you've done for me.'[or]'I really want to repay you for your help somehow. I guess I could... maybe...' He fidgets nervously and presses his tail into his lap as his voice trails off.[or]'I never thought it would be so hot in this country when I accepted the scholarship.'[or]'How long do you think we will be waiting before someone comes to rescue us?'[or]'I am worried what my parents will say when they see me like this. They were finally so proud of me when I got my scholarship.'[or]'Do you think they will let me keep my tail? It is so pretty.'[or]Sven fidgets with his new tail while you speak to him. He doesn't seem to pay much attention and you spot a bulge in his shorts that he's trying to hide with his tail.[or]Sven looks at you with admiration and longing as you chat with him for a bit.[or]Sven licks his lips and mumbles something about being thirsty while eying your crotch. He then notices what he's said and blushes behind his fluffy tail.[in random order]";
	else if HP of Sven is 5:
		say "     [one of]The partially feline fellow strokes his new tail, purring softly.[or]'I am very grateful for your help. I do not know what would have happened if you had not come along. You're so brave, strong and sexy.' He blushes and hides behind his tail after admitting that aloud.[or]'I really appreciate all you've done for me.'[or]'I really want to repay you for your help. I hope you'll let me... maybe...' He blushes and strokes his tail, licking his lips as he remembers the fun you had together earlier.[or]'I never thought it would be so hot in this country when I accepted the scholarship.'[or]'How long do you think we will be waiting before someone comes to rescue us?'[or]'I am worried what my parents will say when they see me like this. They were finally so proud of me when I got my scholarship.'[or]'Do you think they will let me keep my tail? It is so pretty.'[or]Sven fidgets with his new tail while you speak to him. He doesn't seem to pay much attention and you spot a bulge in his shorts that he's trying to hide with his tail.[or]Sven looks at you with admiration and longing as you chat with him for a bit.[or]Sven licks his lips and mumbles something about being thirsty while eying your crotch. He then notices what he's said and grins before hiding behind his fluffy tail.[in random order]";
	else if HP of Sven is 6 or HP of Sven is 7:
		say "     [one of]The cute snowmeow strokes his new tail, purring softly.[or]'I am very grateful for your help. I do not know what would have happened if you had not come along. You are so brave, strong and sexy.' He blushes and hides behind his tail after admitting that aloud.[or]'I really appreciate all you've done for me.'[or]'I really hope you'll let me [']repay['] you again soon,' he purrs with a wink before hiding behind his tail.[or]'I never thought it would be so hot in this country when I accepted the scholarship.'[or]'How long do you think we will have alone before someone comes to rescue us?'[or]'I hope my parents will like this new me as much as I do. They were finally so proud of me when I got my scholarship.'[or]'Do you think they will let me stay like this? I love being a pretty kitty.'[or]Sven lickgrooms his tail while you speak to him. He listens attentively as he runs a paw over his stiff cock while keeping it only half-hidden under his tail. He blushes when you notice what he's doing.[or]Sven looks at you with admiration and longing as you chat with him for a bit.[or]Sven licks his lips and mumbles something about being thirsty while eying your crotch. He grins and blushes before hiding behind his fluffy tail.[in random order]";
	else if HP of Sven is 8:
		if cocks of player > 0:
			say "     [one of]The cute snowmeow strokes his fluffy tail with one paw as the other fondles his heavy balls.[or]'I am very grateful for your help, master. I'm glad someone so brave, strong and sexy was there to take me as his pet.' He smiles coyly from behind his tail and runs a paw slowly along his feline body.[or]'I really appreciate all you've done for me, master.'[or]'I really hope you'll let me [']repay['] you again soon,' he purrs with a wink before hiding behind his tail.[or]'I never thought it would be so hot in this country when I accepted the scholarship.'[or]'How long do you think we will have alone before someone comes to rescue us?'[or]'I can't wait to show everyone what a pretty kitty I've become,' he purrs, stroking a paw over his chest while the other lightly caresses his half-hard cock.[or]Sven lickgrooms his tail while you speak to him. He listens attentively as he runs a paw over his stiff cock while keeping it only half-hidden under his tail. He grins when you notice what he's doing.[or]Sven looks at you with admiration and longing as you chat with him for a bit.[or]Sven licks his lips and mumbles something about being thirsty while eying your crotch. He grins and brushes his fluffy tail against his cheek.[or]Your snowmeow pet purrs up at you as he lightly fingers his tail-hole and fondles his cock and balls with his tail only partially hiding his actions.[or]Sven nuzzles against the cot, thick with the scent of sex, rumbling happily.[or]The sexy snow leopard cuddles the large catnip mouse you got him, nibbling it lightly and purrumbling loudly.[in random order]";
		else:
			say "     [one of]The cute snowmeow strokes his fluffy tail with one paw as the other fondles his heavy balls.[or]'I am very grateful for your help, mistress. I'm glad someone so brave, strong and sexy was there to take me as her pet.' He smiles coyly from behind his tail and runs a paw slowly along his feline body.[or]'I really appreciate all you've done for me, mistress.'[or]'I really hope you'll let me [']repay['] you again soon,' he purrs with a wink before hiding behind his tail.[or]'I never thought it would be so hot in this country when I accepted the scholarship.'[or]'How long do you think we will have alone before someone comes to rescue us?'[or]'I can't wait to show everyone what a pretty kitty I've become,' he purrs, stroking a paw over his chest while the other lightly caresses his half-hard cock.[or]Sven lickgrooms his tail while you speak to him. He listens attentively as he runs a paw over his stiff cock while keeping it only half-hidden under his tail. He grins when you notice what he's doing.[or]Sven looks at you with admiration and longing as you chat with him for a bit.[or]Sven licks his lips and mumbles something about being thirsty while eying your crotch. He grins and brushes his fluffy tail against his cheek.[or]Your snowmeow pet purrs up at you as he lightly fingers his tail-hole and fondles his cock and balls with his tail only partially hiding his actions.[or]Sven nuzzles against the cot, thick with the scent of sex, rumbling happily.[or]The sexy snow leopard cuddles the large catnip mouse you got him, nibbling it lightly and purrumbling loudly.[in random order]";
	else if HP of Sven is 9:
		say "ERROR-Sven-9T: You should not be able to talk to me! Exiting and re-entering the bunker should resolve this.";
	else if HP of Sven is 10:
		if cocks of player > 0:
			say "     [one of]The cute snowmeow strokes his fluffy tail with one paw as the other fondles his heavy balls.[or]'I am very grateful for your help, master. I'm glad someone so brave, strong and sexy was there to take me as his pet.' He smiles coyly from behind his tail and runs a paw slowly along his feline body.[or]'I really appreciate all you've done for me, master.'[or]'I really hope you'll let me [']repay['] you again soon,' he purrs with a wink before hiding behind his colorful tail.[or]'I never thought it would be so hot in this country when I accepted the scholarship.'[or]'How long do you think we will have alone before someone comes to rescue us?'[or]'I can't wait to show everyone what a pretty kitty I've become,' he purrs, stroking a paw over his chest while the other lightly caresses his half-hard cock.[or]'Candy admires you so much, just like I do. And he's so confident and friendly, when we were talking and he was snuggling me, I just felt so close to him, like I do to you.'[or]Sven lickgrooms his tail while you speak to him. He listens attentively as he runs a paw over his stiff cock while keeping it only half-hidden under his tail. He grins when you notice what he's doing.[or]'Candy thinks the three of us should have some fun together sometime. He... I'd really like that too. We both care for you so much.'[or]Candy comes over as you're chatting to Sven and runs a paw over the kitty's body, then scritches his ear before walking away, swishing his tail teasingly and giving you both a view of his panties.[or]'Candy's such a talented coon. He's showing me so much so I can please you better, master.'[or]Sven looks at you with admiration and longing as you chat with him for a bit.[or]Sven licks his lips and mumbles something about being thirsty while eying your crotch. He grins and brushes his fluffy tail against his cheek.[or]Your snowmeow pet purrs up at you as he lightly fingers his tail-hole and fondles his cock and balls with his tail only partially hiding his actions.[or]Sven nuzzles against the cot, thick with the scent of sex, rumbling happily.[or]The sexy snow leopard cuddles the large catnip mouse you got him, nibbling it lightly and purrumbling loudly.[in random order]";
		else:
			say "     [one of]The cute snowmeow strokes his fluffy tail with one paw as the other fondles his heavy balls.[or]'I am very grateful for your help, mistress. I'm glad someone so brave, strong and sexy was there to take me as her pet.' He smiles coyly from behind his tail and runs a paw slowly along his feline body.[or]'I really appreciate all you've done for me, mistress.'[or]'I really hope you'll let me [']repay['] you again soon,' he purrs with a wink before hiding behind his colorful tail.[or]'I never thought it would be so hot in this country when I accepted the scholarship.'[or]'How long do you think we will have alone before someone comes to rescue us?'[or]'I can't wait to show everyone what a pretty kitty I've become,' he purrs, stroking a paw over his chest while the other lightly caresses his half-hard cock.[or]'Candy admires you so much, just like I do. And he's so confident and friendly, when we were talking and he was snuggling me, I just felt so close to him, like I do to you.'[or]Sven lickgrooms his tail while you speak to him. He listens attentively as he runs a paw over his stiff cock while keeping it only half-hidden under his tail. He grins when you notice what he's doing.[or]'Candy thinks the three of us should have some fun together sometime. He... I'd really like that too. We both care for you so much.'[or]Candy comes over as you're chatting to Sven and runs a paw over the kitty's body, then scritches his ear before walking away, swishing his tail teasingly and giving you both a view of his panties.[or]'Candy's such a talented coon. He's showing me so much. I hope we can put on a little show for you sometime, mistress.'[or]Sven looks at you with admiration and longing as you chat with him for a bit.[or]Sven licks his lips and mumbles something about being thirsty while eying your crotch. He grins and brushes his fluffy tail against his cheek.[or]Your snowmeow pet purrs up at you as he lightly fingers his tail-hole and fondles his cock and balls with his tail only partially hiding his actions.[or]Sven nuzzles against the cot, thick with the scent of sex, rumbling happily.[or]The sexy snow leopard cuddles the large catnip mouse you got him, nibbling it lightly and purrumbling loudly.[in random order]";
	else if HP of Sven is 30:		[Self-confident Sven arrived at Bunker]
		say "     'I wanted to thank you for all your help. I never would have believed I was capable of that. Any of that,' he adds, blushing a little at his ears as he thinks back to what he did after the fight. 'I feel so much better now - stronger.' He certainly looks it, having become a well-built feline thanks to the mix of his previous height and the stocky might of the snow leopard build. 'I am very grateful for your help. You helped me defend myself and have given me a place in your shelter. I... I would enjoy thanking you in a [']more personal way['],' he adds with a soft smile and a swish of his tail.";
		now HP of Sven is 31;
	else if HP of Sven >= 32 and HP of Sven < 50 and SvenStory1 is false and a random chance of 1 in 3 succeeds:
		say "     'As I told you, I came here to study after getting an international scholarship. I've... not particularly lived up to my parent's expectations of what a young man should be, but that was one of my few accomplishments that was able to please them. I know they would not be pleased to see what has become of me, let alone how I came to be this way, but I do not care what they think. I like this new me and I enjoyed having a male's cock inside me.'";
		now SvenStory1 is true;
	else if HP of Sven >= 31 and HP of Sven < 50:		[Self-confident Sven]
		say "     [one of]The large snowmeow strokes his fluffy tail with one paw while the other fondles his heavy balls.[or]'I am very grateful for your help, my friend. I thank you for helping me become stronger.'[or]'I appreciate all that you've done for me and I hope you'll let me [']repay['] you [if HP of Sven > 31]again [end if]soon,' he adds with a coy grin and a swish of his thick tail across his bulging crotch.[or]'I never thought it would be so hot in this country when I accepted the scholarship.'[or]'How long do you think it will be before someone comes to rescue us?'[or]'I can't wait to show everyone what a hot kitty I've become,' he purrs, stroking a paw over his firm chest while the other lightly caresses his half-hard cock.[or]Sven lickgrooms his tail while listening attentively while you speak to him.[or]Sven sits back, lounging comfortably while the two of you chat for a bit.[or]Sven licks his lips and slips in something about being thirsty while eying your crotch. He grins and brushes his fluffy tail across your side.[or]The studly snow leopard stretches himself out on his bunk, lightly fingering his tail-hole with one paw while the other fondles his cock and balls. His tail is only loosely draped over his shorts, doing little to hide his unashamed self-exploration.[or]The big feline runs a paw along his side. 'If they find a way to do it, I don't want to be changed back. I like this new me.' He runs his paw more slowly and sensually over his body. 'Don't you?' he purrs with a smile.[in random order]";
	[Sven at Porn Store]
	else if HP of Sven is 50:
		say "     [one of]The partially feline fellow strokes his new tail, purring softly.[or]'I am very grateful for your help. I do not know what would have happened if you had not come along. You're so brave, strong and sexy.' He blushes and hides behind his tail after admitting that aloud.[or]'I really appreciate all you've done for me.'[or]'I want to thank you for bringing me here. It's... a little overwhelming, but at least I'll be safe.' He fidgets nervously and presses his tail into his lap as turns his eyes to floor, trying to avoid staring at the wares again.[or]'I never thought it would be so hot in this country when I accepted the scholarship.'[or]'How long do you think we will be waiting before someone comes to rescue us?'[or]'I am worried what my parents will say when they see me like this. They were finally so proud of me when I got my scholarship.'[or]'Do you think they will let me keep my tail? It is so pretty.'[or]Sven fidgets with his new tail while you speak to him. He doesn't seem to pay much attention, his eyes having fallen on a large dildo on display. You spot a hand drift into his shorts while his tail half-blocks the motion.[or]Sven looks at you with admiration and longing as you chat with him for a bit.[or]Sven licks his lips and mumbles something about being thirsty while eying your crotch. He then notices what he's said and blushes behind his fluffy tail before rushing to the back to get another drink from Lisa's supplies.[or]Sven tries sweeping the floor to help out, but has a hard time as he attempts to keep his tail hiding his crotch bulge as well as his eyes wander over the wares.[in random order]";
	else if HP of Sven is 51:
		say "     [one of]The partially feline fellow strokes his new tail, purring softly.[or]'I am very grateful for your help. I do not know what would have happened if you had not come along. You're so brave, strong and sexy.' He blushes and hides behind his tail after admitting that aloud.[or]'I really appreciate all you've done for me.'[or]'I want to thank you for bringing me here. It's... a little overwhelming, but at least I'll be safe.' He fidgets nervously and presses his tail into his lap as turns his eyes to floor, trying to avoid staring at the wares again.[or]'I never thought it would be so hot in this country when I accepted the scholarship.'[or]'How long do you think we will be waiting before someone comes to rescue us?'[or]'I am worried what my parents will say when they see me like this. They were finally so proud of me when I got my scholarship.'[or]'Do you think they will let me keep my tail? It is so pretty.'[or]Sven fidgets with his new tail while you speak to him. He doesn't seem to pay much attention, his eyes having fallen on a large dildo on display. You spot him subconsciously slip a paw into his shorts, half-hidden by his fluffy tail.[or]Sven looks at you with admiration and longing as you chat with him for a bit.[or]Sven licks his lips and mumbles something about being thirsty while eying your crotch. He then notices what he's said and blushes behind his fluffy tail before rushing to the back to get another drink from Lisa's supplies.[or]Sven sets himself to resorting the DVDs on display but gets rather caught up at reading the back of them. You observe him with a paw in his shorts as he works, purring softly.[in random order]";
	else if HP of Sven > 51:
		say "ERROR-Sven-52T: You should not be able to talk to me!";

to say SvenRescueFight:
	now inasituation is true;
	challenge "Snow Leopard";
	now inasituation is false;
	if fightoutcome >= 10 and fightoutcome <= 19:
		say "     After your victory against the intruder, you look around quickly to make sure there aren't any infected coming, then head back to the house to check on Sven. You find him huddled in the stairwell with his head just poking over edge, clearly having crept out to watch the fight from there. He has one hand nervously playing with his tail while the other has slipped into his shorts. He does not appear to be aware he's doing the latter, looking up at you with admiration at your defeat of the beast. As he starts to get up, he notices where his hand has gotten and quickly whips it out, blushing behind his tail.";
		if Porn Store is known:
			say "     You grin inside, but remember that you have more pressing things to deal with now. Pulling Sven down the stairs, you go through the broken doorway and tell him that he needs to get ready to leave. He wrings his tail and releases a few nervous mewls as he tries to cope with the idea of leaving his home away from home. But you do recall another friend he could stay with who is much closer. It would be faster and easier to move the nervous kitty there than going across the city to the bunker.";
			say "     [bold type]Do you suggest taking him to stay with Lisa the Mouse instead?[roman type][line break]";
			LineBreak;
			say "     ([link]Y[as]y[end link]) - Yes.";
			say "     ([link]N[as]n[end link]) - No.";
			if the player consents:
				LineBreak;
				say "     You make the suggestion to him, saying you have a friend who's hiding in a store much closer to here. 'A store near here? That doesn't sound too bad. And I'll be safe there?' You tell him that your mouse friend hasn't had any trouble. 'A... mouse? I... I think I could cope with a mouse. That wouldn't be too scary.' With that decided and a little prompting from you, Sven gathers up a few things and the last of his supplies in his backpack. As you head out with him, he stays at your side, clutching your arm tightly to his chest. He glances nervously over your shoulder, when he's not nuzzling against it, that is. The trek is short and thankfully uneventful.";
				now HP of Sven is 50;
				now lastSvendrink is turns;
				move Sven to Porn Store;
				move player to Porn Store;
				increase score by 20;
				say "     Upon arriving at the Lisa's, Sven is a little unnerved by the type of store you've brought him to. He blushes behind his tail as he tries not to appear like he's staring at the items on display. When Lisa comes out, Sven fidgets a little and moves behind you. She smiles to you and starts asking about your pointy-eared friend. You explain the situation to her and she seems a little reluctant at first, but eyes the blushing guy while you talk. Eventually, she replies, 'Well, maybe a little game of cat and mouse would be fun. Don't you think, kitty?' she asks Sven, he blushes brighter and hides behind his plush tail, mumbling a soft, 'May I please stay, ma'am?' She smiles and laughs, 'Oh! He's so sweet! And what a lovely accent. I think I will keep him. I'm sure he'll fit right in soon enough,' she chuckles and sidles up to him. The mousetaur runs a paw along his side, then scritches his ear, making him purr a little even as he squirms and reddens further, much to her delight. It seems everything's settled.";
			else:
				LineBreak;
				say "     You decide it would be for the best if you could get the feline infected fellow to the bunker. The porn store may be a little overwhelming for the shy kitty. Besides, the idea of having the snowmeow secluded away for yourself at the bunker is quite appealing. With your plan firmly set in your mind, you give him a little prodding and he gathers up a few things and the last of his supplies in his backpack. As you head out with him, he stays at your side, clutching your arm tightly to his chest. He glances nervously over your shoulder, when he's not nuzzling against it, that is.";
				now HP of Sven is 4;
				move Sven to bunker;
				move player to bunker;
				increase score by 20;
		else:
			say "     You grin inside, but remember that you have more pressing things to deal with now. Pulling Sven down the stairs, you go through the broken doorway and tell him that he needs to get ready to leave. He wrings his tail and releases a few nervous mewls as he tries to cope with the idea of leaving his home away from home. But, with a little prodding from you, he gathers up a few things and the last of his supplies in his backpack. As you head out with him, he stays at your side, clutching your arm tightly to his chest. He glances nervously over your shoulder, when he's not nuzzling against it, that is.";
			now HP of Sven is 4;
			move Sven to bunker;
			move player to bunker;
			increase score by 20;
	else if fightoutcome >= 20 and fightoutcome <= 29:
		say "     After the snow leopard has dealt with you, it catches sight of Sven in the stairwell, mewling softly as he plays with himself in his shorts. Too aroused by the show he received and drawn in by the feline's scent, he doesn't flee as it pads over, switching to move on all fours. He moans softly as it nuzzles and licks his face, pulling off his clothes and mounting him right there. He mewls and moans lustfully as he's taken by the strong male, slowly transforming as their loud rutting continues. Recovering enough to get back up, you can see that the humanity's gone from Sven's eyes and he's succumb to his infection. As there is nothing else you can do for him than to wish him well, you slink away quietly to nurse your wounds and search elsewhere.";
		now HP of Sven is 99;
		move Sven to dark basement;
		remove Sven from play;
		move player to Entrance to the Red Light District;
		decrease score by 20;
	else:
		say "     Unwilling to continue fighting the snow leopard, you turn and flee. But he does not pursue you, instead turning his attention to Sven, who is curled up at the top of the stairwell, watching the battle. Aroused by the sight and scent of the snow leopard, he is fondling himself in his shorts and does not try to run as the creature pads over on all fours. Sven moans softly as it nuzzles and licks his face, pulling off his clothes and mounting him right there. You turn away and continue to make your escape, sure that there will soon be another of those sexy snow leopards prowling the area.";
		now HP of Sven is 99;
		move Sven to dark basement;
		remove Sven from play;
		move player to Entrance to the Red Light District;
		decrease score by 20;


An everyturn rule:
	if HP of Sven > 0 and HP of Sven < 4 and lastSvendrink - turns > 20 and skipturnblocker is 0:
		now HP of Sven is 100;
		remove Sven from play;
		say "You briefly remember Sven and have a sinking feeling that something's happened to him.";
	if HP of Sven is 8 and Candy is in Bunker and lastSvendrink - turns > 11:
		now HP of Sven is 9;
		if player is in Bunker:
			say "     While taking your break before heading back into the city, you spot Candy prance on over to Sven's bunk. He sits quite close to the snow leopard and starts chatting with him, as you've seen him do several times before. But there's something subtly different in his approach this time. It seems he's going to make his move now and you'll get to watch the show.";
			WaitLineBreak;
			say "     Candy runs his paw through your pet's fur as he talks softly to him. Those nimble fingers glide through the thick pelt, stroking and scritching the kitty as they drift around in it. He snuggles a little closer, nuzzling the snowmeow, who gets a little shy and blushes behind his tail, but doesn't pull away. Next comes a nibble to his ear, something whispered and a paw on the kitty's sheath and emerging cock. Those playful fingers brush teasingly over it, then cup those heavy balls.";
			say "     Sven makes a quick glance over to you as the pink coon starts stroking the feline's member, but you only grin back. Sven, taking this as permission, relaxes a little. Candy, who caught the glance and your reaction, nibbles Sven's ear again and whispers something to him, making the snowmeow blush a little at the ears, but also slide his tail aside to give you a better view. With the tail out of the way, Candy nuzzles down Sven's chest and waist before reaching his groin. The pink boy-toy starts licking and sucking on Sven's cock, using his ample experience to set the feline moaning and mewling in pleasure in moments.";
			say "     Sven, having trouble supporting himself in the rush of pleasure, leans back against the wall behind his bunk and runs his paws through Candy's head-fur and pink hair. Candy bobs up and down over the hard, gray cock, working his muzzle and tongue over it while rolling those heavy orbs in his paw[if coonsex > 0]. Having been on the receiving end of one of raccoon's blow jobs, you know just how powerful they are and that the inexperienced kitty won't be able to hold out for long under such expert tongue-work[else]. Clearly the raccoon's expert tongue-work is more than the inexperienced kitty was prepared for and he won't be able to hold out for long[end if]. You watch as Candy slips his free paw behind Sven to grope his ass, then slide it under the tail. When your pet stiffens and mrowls, bucking hard into the coon's muzzle, you grin, knowing Candy's buried at least one finger in the kitty's tight rump. Sven's cock throbs and ballsack twitches, pumping his hefty load down the coon's throat, who moans in pleasure and swallows it all down.";
			WaitLineBreak;
			say "     Lost in the haze of the afterglow, Sven quite passively rolls onto his bunk with his ass up as the coon guides him into position. You briefly consider stopping them, but are enjoying the show too much to do that. Candy spreads the purring kitty's cheeks and presses his muzzle under that fluffy tail, giving his pucker a few licks. Again, that expert tongue gets to work, making the snowmeow moan and mewl. The candy coon strokes his shaft lightly, spreading his sweet precum over it, but resists fully stroking it. He instead moves atop the kitty-boy and gets it lined up with that slick hole. Sven pushes back into that first thrust with another mrowl of satisfaction before Candy starts humping him. The coon's paws roam through the kitty's lovely fur, caressing and teasing him as he enjoys the soft pelt. The coon's tries to pace himself, clearly enjoying his first chance with the snowmeow and his first chance to top in quite some time, but eventually it gets to be too much and the pink boy-toy drives his cock fully into the kitty and drains his balls into that eager ass as Sven unleashes another heavy load onto his messy bunk.";
			say "     The two pass off into slumber still cuddled atop one another, quite spent from their wild romp. Sven and Candy's fluffy tails intertwine as the coon nuzzles at the snowmeow's shoulder. The coon's semi-hard cock remains buried in the kitty's slick, cum-filled bottom. As you watch them sleep, you are surprised to see a little color start to creep into Sven's monochrome pelt as he takes on a [if lust of Sven is 1]baby blue tint[else if lust of Sven is 2]golden hue[end if] to his spotted markings.";
			now HP of Sven is 10;
			increase score by 10;
	if HP of Sven is 50 and lastSvendrink - turns >= 12:
		now HP of Sven is 51;
		if player is in Porn Store:
			say "     Waiting around at the porn store while you debate your next move, you notice Lisa come up to Sven. She puts her arms around him and nibbles at his ear. As she does, she whispers something to him and lets a paw wander down to his shorts. You grin as she pulls him gently towards the back room. Having seen this coming and knowing how bashful the kitty is, you pretend to be watching out the window while watching their faint reflections in it. He wrings his tail nervously and fidgets for a bit as she keeps scritching him, but follows her along. From inside, you can half-hear some moan, mewls and squeaks coming from the pair.";
			say "     When Sven emerges some time later, he blushes considerably as he runs his paws over his new coat of snow leopard fur. He's taken off his shirt now, probably too hot with his plush fur, and adjusts his shorts. His hands are more paw-like and his face has a distinctly feline muzzle. Noticing you looking, he grins shyly before turning away to act busy. When Lisa comes out a few minutes later, she gives his rump a squeeze before taking her usual spot.";
			increase score by 10;
		now lastSvendrink is turns;
	if HP of Sven is 51 and lastSvendrink - turns >= 12:
		now HP of Sven is 52;
		now lust of Sven is 3;
		if player is in Porn Store:
			say "     As you ponder what you need to do next, you spot Lisa cuddling up to Sven again. She wraps her arms around him and dips a paw into his shorts. Again using the reflection from the window to watch, you spot her fondling the kitty quite a bit. Which is a little surprising, given her tastes. She nibbles the kitty's ear and steers him off to the back with much more ease than the first time. From the back, you again catch the sounds of the two in the back. It seems to be louder and more energetic than the other time.";
			say "     It is some time before they emerge even after the noises stopped. You are quite surprised by the changes Sven, who emerges in a red bathing suit with the female body to fill it. The snowmeow hides her face behind her tail, now covered in pink leopard markings. But it can't cover her ample rack or the four smaller breasts below the main pair. Her crotch is smooth, with a perceptible camel toe showing in the tight swimwear. Around her neck is a pink collar with a round, silver bell on it. Lisa wraps her arms around her bashful pet and runs her paws over the kitty's new body, making her shiver and mewl. 'Allow me to introduce the new and improved Svetlana,' the mousetaur says with a grin.";
			say "     Sven, or Svetlana now, smiles shyly at you, opening her mouth to say something. Lisa's paw dips down between the kitty's legs to tease over her covered pussy, rubbing and teasing her until there's a growing wet patch in her swimsuit. 'She's so much more fun now that my pet kitty's got a nice, wet pussy. You should give her a try sometime.' She teases the snowmeow like this for a little while before eventually tiring of the game for now to tend to the store.";
			increase score by 10;
			now HP of Sven is 53;
		move Sven to dark basement;
		move Svetlana to Porn Store;

after going to Bunker while HP of Sven is 9:
	now HP of Sven is 10;
	say "     You return to find Candy snuggled up beside Sven on the kitty's bunk. He is chatting with the [if lust of Sven is 1]baby blue[else if lust of Sven is 2]golden[end if] snowmeow, tracing over his markings. Waitaminit! It seems that Sven's markings have become colored and it's clearly somehow the pink raccoon's doing. You stride over to them, not really upset with the change since you find it makes your pet even more lovely and unique, but wanting to confirm your suspicions. Sven blushes behind his tail a little, but glances coyly up at you, giving you a flash of his now [if lust of Sven is 1]blue[else if lust of Sven is 2]yellow[end if] cock poking from his sheath.";
	say "     Candy, as brazen as ever, runs his paw through Sven's chest-fur and smiles up at you. 'Sweet Sven and I were just getting better acquainted. He's such a lovely kitty,' he churrs, scritching under Sven's chin, getting him to purr and relax further. 'I want to thank you so much for finding me such a beautiful playmate to keep me company while you're out. And don't worry, I know he's your special kitty pet, so I'll keep good care of him for you.' He traces over one of Sven's colorful rosettes again. 'He's much prettier with a bit of color now, don't you think?' You have to agree, both because it's true and to set your pet's mind at ease.";


Section 3 - Sven the Fuck-Toy

the fuckscene of Sven is "[SexWithSven]".

to say SexWithSven:
	[puts Snow Leopard as lead monster in case of impregnation]
	repeat with y running from 1 to number of filled rows in table of random critters:
		choose row y in table of random critters;
		if name entry is "Snow Leopard":
			now monster is y;
			break;
	if HP of Sven < 4:
		say "     Sven squirms a little in his seat and blushes as you start to bring up the subject of sex. He nibbles at the end of his tail and mumbles something about how he doesn't think that'd be a good idea. You do spot that telltale bulge in his shorts though, which makes you hopeful you can coax him into some fun once he settles down.";
	else if player is neuter:
		say "     As you presently don't have a gender of your own, you should perhaps seek obtaining one before playing with the Nordic kitty.";
	else if HP of Sven is 4:
		say "     Sven squirms a little in his seat and blushes cutely as you bring up having sex with him. He nibbles at the end of his tail and eyes your crotch, mumbling something about suddenly getting thirsty again. A hand drifts to his crotch and rubs the bulge there. 'I... I do not know... I mean, I have not yet,' he says shyly, blushing even redder. 'But if it was with you,' he adds with audible longing and admiration in his quiet voice. You spot a little happy trail of white fur that you don't remember seeing before as he continues to subconsciously fondle himself. You suspect the shy fellow will continue changing if you start playing with him.";
		say "     [bold type]Do you want to proceed?[roman type][line break]";
		LineBreak;
		say "     ([link]Y[as]y[end link]) - Fuck him.";
		say "     ([link]N[as]n[end link]) - Leave him be.";
		if the player consents:
			LineBreak;
			now HP of Sven is 5;
			now lastfuck of Sven is turns;
			say "     Deciding that you've waited long enough, you lean forward and kiss the shy fellow while sliding a hand into his lap, rubbing over the bulge there. He moans softly and opens his mouth, welcoming in your tongue. His other hand moves to your crotch to grope you in return, tentatively running his fingers across your genitals.";
			if cocks of player > 0:
				say "     Stroking your cock to full hardness, he brings his face to it the moment you break the kiss. He licks and nuzzles at it, moaning softly. His tongue plays across your hard length, savoring the taste of you and licking up any leaking precum he can get. 'I... It's... you taste so good,' he purrs before taking your shaft into his mouth, licking and sucking with a lustful thirst for your seed. You rub his ears and scritch them, which makes him purr even louder[if cunts of player > 0]. Your pussy is not left out as his fingers stroke your wet folds before he tentatively slips one into you to further please you[end if].";
				say "     As you watch him work your cock in his mouth with growing skill, you find yourself wondering if this shy fellow would make a good pet. He certainly seems submissive enough. With those thoughts growing in the back of your mind, your excitement builds and you unleash blast after blast of your thick, [cockname of player] cum into his mouth. He makes pleasant moans as he tastes your seed, swallowing it all down eagerly. Releasing your shaft, he licks his lips and blushes a little, but purrs very contentedly. You spot a sticky stain at the front of his shorts and watch him lick his own cum from his now paw-like hand.";
			else:
				say "     Teasing and stroking your wet pussy, he brings his face to it the moment you break the kiss. He licks and kisses at it, moaning softly. His tongue plays across your wet folds, savoring the taste of you and licking up your flowing juices. 'I... It's... you taste so good,' he purrs before spreading your lips and diving his tongue into your dripping cunt. He licks and laps at you with a lustful thirst for your sweet waters. You rub his ears and scritch them, which makes him purr even louder.";
				say "     As you watch him work your pussy with his mouth with growing skill, you find yourself wondering if this shy fellow would make a good pet. He certainly seems submissive enough. With those thoughts growing in the back of your mind, your excitement builds and you have a powerful orgasm, releasing a hot rush of your juices onto his tongue. He makes pleasant moans as he laps it all up, eagerly swallowing down as much as he can get. After licking your pussy and thighs clean, he leans back and blushes a little, but purrs very contentedly. You spot a sticky stain at the front of his shorts and watch him lick his own cum from his now paw-like hand.";
		else:
			LineBreak;
			say "     Deciding it may be best not to risk it, you ruffle Sven's ears lightly and leave him be. He seems both relieved and disappointed at once. Noticing his wayward hand, he pulls it from his shorts and hides it behind his back.";
	else if HP of Sven is 5 and lastfuck of Sven - turns < 8:
		say "     Sven blushes cutely as you bring up sex again, but mumbles something about wanting to think about what happened before going ahead more. You do grin as you he subconsciously fondles himself while saying this, assuring you that the shy fellow will come around soon.";
	else if HP of Sven is 5:
		now HP of Sven is 6;
		now lastfuck of Sven is turns;
		say "     When you come up to Sven again, you smile as you look over his more feline features. He blushes behind his tail and runs a paw lightly over the front of his shorts. You brush your hand lightly across his muzzle and he nuzzles against it, purring happily. Deciding to follow up on your idea from last time, you lean in and scritch his ear while whispering in the other. 'You are such a pretty kitty. You liked the taste you got before, didn't you, kitty? It was your first time, wasn't it?' He moans softly as you nibble his ear and replies with a soft 'Yes.' You slide a hand stroke his fluffy tail. 'And if you promise to be my good kitty, my special kitty, you can have another taste,' you whisper softly in his ear, drifting your hand from his tail to rub over the very hard bulge in his shorts.";
		say "     Sven mewls softly and nibbles his lip nervously as he struggles with his shyness for a few moments. You can see in his eyes as the idea starts to set in and soon enough he nuzzles you back, promising to be a good kitty. You smile and guide his head to your crotch, which he happily starts to lick and nuzzle, rumbling loudly as you pet his ears.";
		if cocks of player > 0:
			say "     With his mouth around your cock, he licks and sucks as if thirsting for your cum while rolling your balls around in one paw[if cunts of player > 0]. His other hand is busy at your pussy, stroking and rubbing your female slit[end if]. He's still fumbling around a little, but is quite enthusiastic about his task. And his technique is improving. You rub his ears and whisper what a good kitty he is, what a fine pet he could be for you, while advising him on how to better please you. Eager to please his hero, he listens attentively to all this and takes it all in, changing and improving his technique to make you happy.";
			say "     You grip the back of the snowmeow's head and start driving your cock into his growing muzzle, grinning at the sight of you further changing this young man into your personal feline play-toy. You can feel his tongue getting rougher and more feline in texture, further stimulating your erection. As you watch, his soft fur spreads further up his forearms and his feet become paws as well, falling out of his shoes. His attention to you soon sends you over the edge and you unleash your hot seed down his throat. He moans lustfully and gulps it all down.";
			say "     You rub his ears as you guide him off your cock and have him lay back on his cot. He mewls cutely up at you, smiling and licking his lips. You slide down his shorts, uncovering his cock and find it a steely gray like the other snow leopards[']. It is an impressive nine inches with hefty balls below it. You run your fingertips slowly along its underside and speak softly to him again. 'You want to be my pretty kitty, don't you? More than that, you want to be my sexy pet.' You continue teasing his cock as you speak to him, keeping him on the edge, as if only promising his release when he agrees. 'I've seen you looking at me. You want your big, strong hero to protect you and use you. You want to be a slutty kitty for me to fill with cum whenever I please, don't you? Beg to be my slutty pet... I'll make you feel soooo good.'";
			say "     All the attention on his poor, virgin body soon gets to be too much for him and he nods vigorously, mewling and moaning that he'll be your special kitty, your slutty pet, your sexy fuck-toy. Smiling happily, you kiss his glans. 'Good kitty. You may cum now,' you purr as you wrap your fingers around his cock, pumping firmly over his thick shaft. It throbs in your hand, leaking precum down it and soon enough, he's spraying his seed all across his body as the small patch of white fur spreads across it, covering him entirely in the beautiful coat of a snow leopard. When he's spent and done, you get up slowly, scritch his ears and ponder getting a new collar your feline fuck-toy.";
		else:
			say "     With his mouth around pressed to your crotch, he licks and sucks at your pussy as if thirsting for your juices while stroking his paws over your ass. His tongue dives into you, slipping as far into your cunt as it can reach to lap up your female cum. He's still fumbling around a little, but is quite enthusiastic about his task. And his technique is improving. You rub his ears and whisper what a good kitty he is, what a fine pet he could be for you, while advising him on how to better please you. Eager to please his hero, he listens attentively to all this and takes it all in, changing and improving his technique to make you happy.";
			say "     You grip the back of the snowmeow's head and grind your pussy against his growing muzzle, grinning at the sight of you further changing this young man into your personal feline play-toy. You can feel his tongue getting rougher and more feline in texture, further stimulating your sensitive clit. As you watch, his soft fur spreads further up his forearms and his feet become paws as well, falling out of his shoes. His attention to you soon sends you over the edge and your hot juices flow over his tongue and soak his muzzle. He moans lustfully and eagerly laps it up.";
			say "     You rub his ears as you guide him off your cock and have him lay back on his cot. He mewls cutely up at you, smiling and licking his lips. You slide down his shorts, uncovering his cock and find it a steely gray like the other snow leopards[']. It is an impressive nine inches with hefty balls below it. You run your fingertips slowly along its underside and speak softly to him again. 'You want to be my pretty kitty, don't you? More than that, you want to be my sexy pet.' You continue teasing his cock as you speak to him, keeping him on the edge, as if only promising his release when he agrees. 'I've seen you looking at me. You want your big, strong hero to protect you and use you. You want to be a slutty kitty for me to use as my plaything whenever I please, don't you? Beg to be my slutty pet... I'll make you feel soooo good.'";
			say "     All the attention on his poor, virgin body soon gets to be too much for him and he nods vigorously, mewling and moaning that he'll be your special kitty, your slutty pet, your sexy fuck-toy. Smiling happily, you kiss his glans. 'Good kitty. You may cum now,' you purr as you wrap your fingers around his cock, pumping firmly over his thick shaft. It throbs in your hand, leaking precum down it and soon enough, he's spraying his seed all across his body as the small patch of white fur spreads across it, covering him entirely in the beautiful coat of a snow leopard. When he's spent and done, you get up slowly, scritch his ears and ponder getting a new collar your feline fuck-toy.";
	else if ( HP of Sven is 6 or HP of Sven is 7 ) and lastfuck of Sven - turns < 8:
		say "     The snow leopard stretches out on his bunk, letting his tail only partially hide his cock and ample balls. 'I'm really looking forward to pleasing you again, [if cocks of player > 0]master[else]mistress[end if]. I just need to rest up a little more first. This is all so new and wonderful to me. I do not want to spoil it by not being able to give you my best,' he purrs softly in his Nordic accent before blushing and hiding behind his thick tail. You decide not to press the matter, knowing you'll be [if HP of Sven is 6]enjoying your kitty again soon enough[else if HP of Sven is 7]giving your kitty his present soon enough[end if].";
	else if HP of Sven is 6:
		now lastfuck of Sven is turns;
		say "     Deciding another session with your budding pet is in order, you smile and walk on over to him. He blushes a little hides his face behind his tail and gives you a brief flash of his stiff member. He licks his lips and nuzzles into your crotch right away, earning a gentle ear scritching. 'Mmm... that's my good, thirsty kitty. Lick me for your treat.'";
		if cocks of player > 0:
			say "     Sven's feline tongue plays across your [cockname of player] cock, licking and teasing it to full erection quickly before taking it into his muzzle. He bobs his head up and down while his tongue and palate work along your throbbing member[if cunts of player > 0]. While his muzzle tends to your cock, he slips a paw back to tease and caress your wet folds before slipping a pair of softly furred digits into it[end if]. You release a soft groan; he's quickly getting better at this. You pet his head and ears encouragingly, calling him your playful kitty and your pretty slut[if cock length of player > 6 and cock length of player < 13]. This seems to encourage him further and he pushes your cock fully into his mouth and down his throat. You groan again, louder, at the tighter grip and the increased licking and sucking from your pet snowmeow[else if cock length of player > 12]. This seems to encourage him further and he pushes as much of your huge cock into his mouth and down his throat as he can. You groan again, louder, at the tighter grip and the increased licking and sucking from your pet snowmeow[else]. This seems to encourage him further and he takes your full length into his muzzle to lavish it with attention with his rough tongue. You groan again, louder, at the increased licking and sucking from your pet snowmeow[end if]. As his muzzle works you over, he pumps and strokes at his throbbing, ten inch cock while releasing muffled mewls of pleasure. When your climax comes, he goes off as well, pumping hot feline seed from his ample balls while sucking down your cum. Once finished, he releases your shaft and licks his muzzle, purring contentedly while you scritch his tummy. You are reminded again to look for a collar for your feline pet.";
		else:
			say "     Sven's feline tongue plays across your wet folds and dips into your pussy. He runs his soft paws over your thighs before slipping a finger into you to tease your clit. His tongue and teeth tease your sensitive pussy while that softly furred digit strokes your inner walls. You release a soft groan; he's quickly getting better at this. You pet his head and ears encouragingly, calling him your playful kitty and your pretty slut[if cunt width of player > 5]. He inserts a second finger into you, and then a third, then slides his whole paw into your wide pussy. Again and again, he stuffs you nicely with the soft touch of his fur over the firm, full feeling of his paw pounding into you. You groan again, louder, at the pleasure of it filling you along with the licking and sucking from your pet snowmeow[else if cunt width of player > 2]. He inserts a second finger into you and then a third into your ample pussy. Again and again, he stuffs you nicely with the soft touch of his fur over the firm, full feeling of his fingers stroking inside you. You groan again, louder, at the pleasure of them filling you along with the licking and sucking from your pet snowmeow[else]. He inserts a second finger into your wet pussy. Again and again, he stuffs you nicely with the soft touch of his fur over the firm, full feeling of his fingers stroking inside you. You groan again, louder, at the pleasure of them filling you along with the licking and sucking from your pet snowmeow[end if]. As his paw and muzzle work at your pussy, lapping up your juices, he pumps and strokes at his throbbing, ten inch cock while releasing muffled mewls of pleasure. When your climax comes, he goes off as well, pumping hot feline seed from his ample balls while drinking down your sweet waters. Once finished, he flops back to lick his muzzle and paw, purring contentedly while you scritch his tummy. You are reminded again to look for a collar for your feline pet.";
	else if HP of Sven is 7:
		now HP of Sven is 8;
		now lastfuck of Sven is turns;
		if Candy is in Bunker, now lastSvendrink is turns;
		say "     As you approach Sven this time, he seems to notice something in how you approach him and mewls softly, stretching out on his cot like a lounging feline. Sitting beside him, you rub his tummy and smile as he purrs happily. 'I have something special for you, kitty,' you say softly as you pull out the collar. His eyes lock onto the baby blue strap and he releases a soft mew, almost unheard. He nibbles at his lip a little as you lean in to stroke along the soft fur of his neck.";
		if cocks of player > 0 and cunts of player > 0:
			say "     As you prepare to give the sexy snowmeow his new collar, you try to decide if you'd prefer to top him or ride him in celebration.";
			say "     [bold type] You look forward to using your feline in any way you can, but what special reward to give your virgin kitty for his first time?[roman type][line break]";
			LineBreak;
			say "     ([link]Y[as]y[end link]) - Top him.";
			say "     ([link]N[as]n[end link]) - Ride him.";
			if the player consents:
				LineBreak;
				say "[CollarFuck]";
			else:
				LineBreak;
				say "[CollarRide]";
		else if cocks of player > 0:
			say "[CollarFuck]";
		else:
			say "[CollarRide]";
		say "     [bold type]You find yourself considering giving your kitty a drink to slake his thirst, but a different one than before.[roman type][line break]";
		LineBreak;
		say "     ([link]Y[as]y[end link]) - Yes (WS).";
		say "     ([link]N[as]n[end link]) - No way.";
		if the player consents:
			LineBreak;
			now lust of Sven is 2;
			if cocks of player > 0:
				say "     Deciding to exert your dominance over your new pet, you motion for him to get on his knees in front of you. When you bring your cock to his muzzle, he takes it into his mouth readily, licking and sucking it clean. Stroking his ears, you hold his head in place and tell him to be a good kitty and to drink it all down. He mewls softly and blushes as you release your bladder, letting your hot urine flow into his muzzle.";
				say "     Being the thirsty kitty that he is, he can't help but drink it down. His ears dip down submissively and he blushes brightly, but doesn't try to pull away and even starts sucking for more. 'That's my good, thirsty kitty,' you say in a throaty voice, pleased with your pet. When you are almost empty, you release his head and spray the last of your piss across his body. He does not pull away, even purring as you mark him as yours. Once you're done, he leans back against the cot and purrs contentedly, licking his lips as he strokes a paw over his wet fur.";
			else:
				say "     Deciding to exert your dominance over your new pet, you motion for him to get on his knees in front of you. When you bring your sticky pussy to his muzzle, he presses his muzzle to it readily and starts licking it clean. Stroking his ears, you hold his head in place and tell him to be a good kitty and to drink it all down. He mewls softly and blushes as you release your bladder, letting your hot urine flow across and into his muzzle.";
				say "     Being the thirsty kitty that he is, he can't help but drink it down. His ears dip down submissively and he blushes brightly, but doesn't try to pull away as most flows down his throat. The rest runs down his neck and chest, marking him as yours. He even licks away the last few drops before you release him. Once you're done, he leans back against the cot and purrs contentedly, licking his lips as he strokes a paw over his wet fur.";
		else:
			LineBreak;
			now lust of Sven is 1;
			say "     You put aside those thoughts and focus on the plan at hand of moulding the cute fellow into a proper play-toy for your amusement. You gently press him back onto the cot and run your hands up his chest, scritching as you go and making him shiver in delight. When you reach his collar, you trace your fingers along it, then scritch the underside of his muzzle. He purrs loudly at this, eyes closed in feline pleasure. You whisper in his ear again what a sexy kitty he's become and how pleased you are with your new fuck-toy before ending with a promise to play with him again soon. As he drifts off into a contented catnap, you get up and leave him on the cot soaked in the scents of sex.";
		increase score by 50;
	else if ( HP of Sven is 8 or HP of Sven is 10 ) and lastfuck of Sven - turns < 6:
		say "     The snow leopard stretches out on his sex-scented bunk, letting his tail only partially hide his cock and ample balls. 'I'm really looking forward to pleasing you again, [if cocks of player > 0]master[else]mistress[end if]. I just need to rest up a little more first. This is all so new and wonderful to me. I do not want to spoil it by not being able to give you my best,' he purrs softly in his Nordic accent as he traces a paw across his ample balls and half-hard cock while only half-hiding it with his tail. You decide not to press the matter, knowing he's your kitty to enjoy from now on.";
	else if HP of Sven is 9:
		say "ERROR-Sven-9F: You should not be able to fuck me! Exiting and re-entering the bunker should resolve this.";
	else if HP of Sven is 8 or HP of Sven is 10:
		say "[SoloSven]";
	[Confident Sven]
	else if HP of Sven is 30:
		say "     While he seems like he'd be quite receptive to the offer, it'd still be best to talk to him first.";
	else if HP of Sven is 31:
		say "     Deciding to take Sven up on his open invitation, you take a seat on his bunk and ask the fluffy kitty if he'd like some company. He smiles and purrs softly, running a paw [if breast size of player is 0]across your chest[else]along your back[end if]. 'I'd love that,' he rumbles, sliding closer. He leans in, a little tentatively at first, before pushing his muzzle quickly to your lips. He kisses you passionately, putting his arms around you and running his paws over your body as you run your fingers through his soft, warm fur.";
		if cocks of player > 0:
			say "     While your hands slip down to get him out of his shorts, his paws do the same to you, divesting you of your gear and baring your body to him. With a soft paw around your [cock size desc of player] shaft, he strokes you to full erection before nuzzling down to your crotch. You can feel his warm breath across your sensitive flesh moments before his muzzle slides over it. He moans happily as his textured tongue plays across your shaft while getting it slick with saliva.";
			WaitLineBreak;
			say "     After several minutes of cock-sucking delight, Sven eases his muzzle off your shaft and lays back on the mattress. Spreading his legs and raising his hips, he offers his ass to you. 'Please fuck me. I want it in me.' Greatly aroused after the blow job, you're more than happy to oblige the sexy feline and move to mount him.";
			say "     His near-virginal ass is tight at first, but it relaxes quickly to allow you in. His expression changes to one of blissful satisfaction as your [cock of player] meat sinks into his rear. The feline rumbles and purrs with delight as you start thrusting into him, pumping your [cock size desc of player] shaft in and out of his [if cock length of player > 36]considerably stretched hole and overstuffed belly[else if cock length of player > 24]considerably stretched hole[else if cock length of player > 12]well-stuffed hole[else]quivering hole[end if]. After running your hands over his chest and down to his hips, you move them to grip his hips to aid in your pounding the needy feline.";
			WaitLineBreak;
			say "     As the two of you make love like this, Sven slips a paw to his own hard and throbbing erection. Thanks to his transformation, his shaft has become quite impressively large, a little over a foot in length. Add to that the plump balls of a Snow Leopard, but scaled up a little more thanks to having retained his earlier height. He strokes and pumps at that pulsing shaft of his, purring in increasing loudness as he's fucked in the ass by his friend.";
			say "     It's not long before the big kitty is pushing his hips up into your thrusts and pumping his shaft frantically. Eyes clenched shut, he moans and mewls as his asshole clutches down around you. A moment later, the first of many gooey blasts of feline seed spray from his cock, splattering across his fluffy face and chest. Having his anus clamp down around you while you're treated to this erotically messy sight is enough to push you over the edge and you cum partway through the snow leopard's orgasm, sending your own hot seed into his bowels. Once spent, he sags back onto the mattress, panting heavily with an expression of dazed delight on his muzzle. After painting his bowels with your semen, you pull out while giving him a tender kiss and leave him to recover.";
		else:
			say "     While your hands slip down to get him out of his shorts, his paws do the same to you, divesting you of your gear and baring your body to him. With his cock freed, you take hold of his gray rod. Within your grip, it rises to full hardness and stands slightly over a foot in length. Similar to the other snow leopards around, Sven's also got an extra-hefty package beneath his hard shaft. The sight and feel of it only excites you all the more.";
			WaitLineBreak;
			say "     The feline's paws move to your hips and gently guide you to sit in his lap. Straddling him, you keep his shaft lined up while sinking your hot, wet cunny down onto it. You both moan softly in delight as the thick manhood slides into your cunt. After taking the first few slides up and down several inches of it, you push yourself lower and start riding him in earnest. Your hands move to his shoulders for support as you bounce up and down on the kitty's pulsing pole.";
			say "     Sven's paws run over your body, purring happily as he does[if breast size of player > 0]. His paws find their way to your bosom to play with your nipples while caressing your [short breast size desc of player] breasts. Cupping one, he leans in and brings his muzzle to your breast, soon licking and sucking on your hard nip to make you moan in pleasure[else]. His paws eventually find their way to your hips after groping your ass playfully. Holding your hips, he steadies you while encouraging you to ride him harder and faster[end if]. The sound of his purring grows louder as the two of you make love.";
			WaitLineBreak;
			say "     It's not long before the big kitty is pushing his hips up even as you slam down. Eyes clenched shut, he moans and mewls as his shaft throbs and pulses inside you as his climax arrives. Blast after gooey blast of feline seed sprays from his gray cock, splattering against your cervix and flowing into your womb. Feeling him seeding you so heavily is enough to push you over the edge and you cry out in orgasm partway through the snow leopard's release, adding your hot juices to the sticky mess leaking around his pulsing rod. Once spent, Sven sags back onto the mattress, panting heavily with an expression of dazed delight on his muzzle. After allowing the last quivers of your orgasm to pass, you pull off of him and give him a tender kiss before leaving him to recover.[impregchance]";
		increase HP of Sven by 1;
		now lastfuck of Sven is turns;
	else if HP of Sven >= 32 and HP of Sven < 50 and lastfuck of Sven - turns < 6:
		say "     The snow leopard smiles and stretches out on his sex-scented bunk, letting his tail only partially hide the plump bulge in his crotch. 'While I'm really looking forward to that, I need to rest up a little more first. This is all so new and wonderful to me, but I do not want to spoil it by not being to perform my best,' he purrs softly in his Nordic accent as he traces along his side.";
	else if HP of Sven >= 32 and HP of Sven < 50:
		say "[ConfidentSvenSex]";
	[Sven at Porn Store:]
	else if HP of Sven is 50:
		say "     Sven squirms a little in his seat and blushes as you start to bring up the subject of sex. He looks away, but ends up looking at the wares again, and he reddens and hides his face behind his snow leopard tail. He mumbles something about how he doesn't think that'd be a good idea. You do spot that telltale bulge in his shorts though, which makes you hopeful you can coax him into some fun once he settles into his new home.";
	else if HP of Sven is 51:
		say "     Sven squirms a little in his seat and blushes as you start to bring up the subject of sex. He nibbles at the end of his tail and glances to the store's back room, then mumbles something about how he doesn't really think that he should right now. You do spot that telltale bulge in his shorts though, which makes you hopeful you can coax the kitty into some fun once he settles into his new home.";
	else if HP of Sven > 51:
		say "ERROR-Sven-52F: You should not be able to proposition me!";


to say CollarFuck:
	say "     You place your hands on his shoulders and roll him over onto all fours. Almost instinctively, he raises his ass and his tail moves out of the way. As you line up your cock with his ass, you nibble his ear and show him the collar again, making certain to he sees the [']FUCKTOY['] label on its tag. As you rub your prick against his back entrance, leaking pre onto his tight tail-hole, you say 'I'm going to make you my special kitty now. My feline fuck-toy. You want it, don't you?' you whisper in his ear as grind your cock even harder, making it clear he'll need to agree to one to get the other.";
	say "     The snow leopard mewls lustfully and presses his ass back, letting his tail-hole spread open a little for your [cockname of player] cock. 'Yes! Do it! I'll be your pet, your fuck-toy, anything! Just fuck me, please.' Smiling happily, you slide the collar around his neck even as you drive your cock deep inside your virgin kitty, making him mrowl in delight. As soon as you latch it shut, he grinds back against you and you start pounding away.";
	WaitLineBreak;
	say "     His ass is deliciously tight, a delight to fuck. He kneads his paws at the cot's mattress, mewling and moaning in pleasure. You lick and nibble his ear as you pound away at him, telling him what a good kitty fuck-toy he is while you stroke at his throbbing cock. His inner walls grip around you firmly each time you press into him and his shaft and balls twitch. You try to draw it out as long as you can. But when your pet yowls and starts blasting his ample load onto the fire blanket, his ass grips you so tightly you find yourself pushed over the edge. You send shot after shot into his feline ass, filling him [if cock width of player > 10]enough to make his tummy bulge[else if cock width of player > 5]with enough to stuff his ass fully[else]with your thick cum[end if].";
	say "     As you ease your cock out of your sexy snowmeow, he moans and pants, clearly a little overheated by all the exertion, but also purring up a storm. As you pat his freshly creamed ass, you are struck by a particularly naughty idea.";


to say CollarRide:
	say "     You place your hands on his shoulders and straddle him. He mewls and blushes as you press your pussy against his cock, sliding it along his throbbing length. Your juices leak out over it, getting him slick as you show him the collar again, making certain to he sees the [']FUCKTOY['] label on its tag. As you rub your damp folds against his prick, you say 'I'm going to make you my special kitty now. My feline fuck-toy. You want it, don't you?' you whisper in his ear as grind down on his cock even harder, making it clear he'll need to agree to one to get the other.";
	say "     The snow leopard mewls lustfully and grinds up against you, instinctively thrusting to try to get in that wet cunt he can feel. 'Yes! Do it! I'll be your pet, your fuck-toy, anything! Just fuck me, please.' Smiling happily, you slide the collar around his neck even as you line yourself up with his throbbing shaft and sink his virgin cock deep inside you, making him mrowl in delight. As soon as you latch it shut, he thrusts up into you and you start riding that large, feline cock.";
	WaitLineBreak;
	say "     His cock is deliciously large, [if cunt width of player > 5]enough to please even your ample pussy[else if cunt width of player > 2]a snug fit for your pussy[else]a tight fit for your small pussy, but are able to stretch yourself down onto it with only a little pain and a whole lot of pleasure[end if]. You run your hands through his fluffy chest fur while he moans and mewls in pleasure. You lean in and tell him what a good kitty fuck-toy he is as you nibble his ear, then sit back up and tweak the hard nipples you've found hidden under his thick fluff of fur. You can feel his cock twitch and his balls throb each time you press down onto his lap. You try to draw it out as long as you can. But when your pet yowls and starts blasting his rich seed deep inside you, making your tummy swell a little with his cum, you find yourself pushed over the edge. Your pussy clamps down around him, milking him for enough cum to make your tummy swell with his seed as it stuffs your womb full[if cocks of player > 0] while you blast your own seed across his chest and face[end if].[impregchance]";
	say "     As you ease off your sexy snowmeow's cock, he moans and pants, clearly a little overheated by all the exertion, but also purring up a storm. As you pat his freshly drained balls, you are struck by a particularly naughty idea.";

to say SoloSven:
	if HP of Sven is 10 and lastCandyfucked - turns > 5 and SvenCandyMsg is 0:
		say "     Deciding to have a little fun with your snowmeow pet, you glance over to Candy, wondering if you should invite the coon in on your fun[if coonsex > 0]. It has been a while since you two had some fun together, so he'd probably be up for more[else]. You haven't really played around with the coon since getting him here and he'd probably enjoy repaying you for saving him[end if]. The two certainly get along very well and won't become jealous if you were only to play with one of them. But it might be fun to have a little playtime with them both together. It's certainly something worth considering.";
		now SvenCandyMsg is 1;
	now sextablerun is 0;
	blank out the whole of table of fucking options;
	if cocks of player > 0:
		choose a blank row in table of fucking options;
		now title entry is "Fuck him";
		now sortorder entry is 1;
		now description entry is "mount your snowmeow pet";
		choose a blank row in table of fucking options;
		now title entry is "Lap kitty";
		now sortorder entry is 2;
		now description entry is "give the kitty a ride in your lap";
	choose a blank row in table of fucking options;
	if cunts of player > 0:
		now title entry is "Ride him (vaginal)";
	else:
		now title entry is "Ride him (anal)";
	now sortorder entry is 3;
	now description entry is "get his feline shaft inside you";
	if cocks of player > 0:
		choose a blank row in table of fucking options;
		now title entry is "Blow job";
		now sortorder entry is 4;
		now description entry is "have your kitty suck you off";
	if cunts of player > 0:
		choose a blank row in table of fucking options;
		now title entry is "Cunnilingus";
		now sortorder entry is 5;
		now description entry is "have your kitty eat you out";
	if HP of Sven is 10 and lastCandyfucked - turns > 5:
		choose a blank row in table of fucking options;
		now title entry is "Threesome w/Candy";
		now sortorder entry is 6;
		now description entry is "invite Candy over for a threesome";
	sort the table of fucking options in sortorder order;
	repeat with y running from 1 to number of filled rows in table of fucking options:
		choose row y from the table of fucking options;
		say "[link][y] - [title entry][as][y][end link][line break]";
	while sextablerun is 0:
		say "Pick the corresponding number> ";
		get a number;
		if calcnumber > 0 and calcnumber <= the number of filled rows in table of fucking options:
			now current menu selection is calcnumber;
			choose row calcnumber in table of fucking options;
			say "[title entry]: [description entry]?";
			if player consents:
				let nam be title entry;
				now sextablerun is 1;
				if SvenCandyMsg is 1 and nam is not "Threesome w/Candy":
					say "     You decide to give Sven some personal attention this time and head on over to him. As you start heading that way, you see Candy take an interest. The pink coon takes a comfortable seat to watch the entertainment.";
				if nam is "Fuck him":
					say "[SoloSvenFuck]";
				else if nam is "Lap kitty":
					say "[SoloSvenLapFuck]";
				else if nam is "Ride him (vaginal)":
					say "[SoloSvenRide]";
				else if nam is "Ride him (anal)":
					say "[SoloSvenRideAnal]";
				else if nam is "Blow job":
					say "[SoloSvenMOral]";
				else if nam is "Cunnilingus":
					say "[SoloSvenFOral]";
				else if nam is "Threesome w/Candy":
					say "[SvenTrio]";
					now lastCandyfucked is turns;
				if SvenCandyMsg is 1 and nam is not "Threesome w/Candy":
					say "     Having finished up with your pet snowmeow, you glance over to the pink raccoon. He has been watching the show and is jerking off with churrs of delight as he eyes your well-used, messy kitty. His slender fingers pump over his hot pink cock, working it faster and faster until he finally groans and sprays his seed onto the floor, filling the room with his cotton candy scent.";
					now SvenCandyMsg is 2;
				increase level of Sven by 1;
		else:
			say "Invalid Option. Pick between 1 and [the number of filled rows in the table of fucking options].";
	now lastfuck of Sven is turns;
	wait for any key;
	clear the screen and hyperlink list;


to say SoloSvenMOral:
	say "     Attentive to you as you stride over, he is out of his cot and nuzzling at your hips right away, purring happily. You smile and stroke your kitty's ears, telling him he's a good kitty. As he nuzzles and licks at his crotch, you run your fingers through his [if lust of Sven is 2]hair[else]head-fur[end if].";
	say "     The eager feline licks and sucks at your cock, getting it fully hard before taking it into his muzzle[if cunts of player > 0] while his paws stroke and tease at your ass and pussy[end if]. He's gotten quite good at this now in just a short time, between his lustful thirst and his need to please you. You continue to stroke his head and ears as you moan feline compliments to your sex pet. He bobs his head steadily over your cock while his raspy tongue slides all over it, focusing on every sensitive spot he's learned.";
	say "     His softly furred paws travel over your rear, caressing your hips and thighs[if cunts of player > 0] before sinking a pair of fingers into your cunt[end if]. He makes sure to pace his licking and sucking, letting you build increasingly to greater heights. When finally your climax does come, you blast your cum down his throat as you drain your aching balls with a loud groan of ecstasy. Smiling around your cock, he makes sure to swallow it all down.";
	if lust of Sven is 2 and thirst of player < 30:
		say "[SvenWS]";
	else:
		say "     You smile happily down at your wonderful kitty, scritching him under his muzzle as he purrumbles loudly. He moves his muzzle away from your groin and licks his lips, enjoying your lingering taste on his tongue. He lays back on the cot, purring as you scritch and pet him as he strokes himself off while you watch, spraying a huge amount of cum from his large balls onto his chest. You leave him like that, sticky with cum and purring like a sexy feline fuck-toy that's been well used.";

to say SoloSvenFOral:
	say "     Attentive to you as you stride over, he is out of his cot and nuzzling at your hips right away, purring happily. You smile and stroke your kitty's ears, telling him he's a good kitty. As he nuzzles and licks at his crotch, you run your fingers through his [if lust of Sven is 2]hair[else]head-fur[end if].";
	say "     The eager feline licks and fingers your pussy, getting you quite excited before alternating between diving his tongue and sliding [if cunt width of player > 5]a paw into your wide pussy[else if cunt width of player > 2]three fingers into your ample pussy[else]a pair of fingers into your wet pussy[end if]. He's gotten quite good at this now in just a short time, between his lustful thirst and his need to please you. You continue to stroke his head and ears as you moan feline compliments to your sex pet. He tweaks your clit while his raspy tongue slides everywhere it can get, focusing on every sensitive spot he's learned.";
	say "     His softly furred paw travels over your rear, caressing your hips and thighs. He makes sure to pace his licking and fingering, letting you build increasingly to greater heights. When finally your climax does come, you spray your hot juices over his tongue and paw with a loud groan of ecstasy. He eagerly laps up as much as he can get, working to get you nice and clean.";
	if lust of Sven is 2 and thirst of player < 30:
		say "[SvenWS]";
	else:
		say "     You smile happily down at your wonderful kitty, scritching him under his muzzle as he purrumbles loudly. He moves his muzzle away from your groin and licks his lips, enjoying your lingering taste on his tongue. He lays back on the cot, purring as you scritch and pet him as he strokes himself off while you watch, spraying a huge amount of cum from his large balls onto his chest. You leave him like that, sticky with cum and purring like a sexy feline fuck-toy that's been well used.";

to say SoloSvenFuck:
	say "     Deciding on that sexy, spotted ass of his, you give his rump a light swat and he's onto all fours for you right away. He holds his tail up and wags his ass at you, mewling his desire to be mounted. You climb atop him and nibble at his ear while grinding your cock against those softly-furred cheeks. His tail-hole parts readily for his master's cock, easily stretching open to take you in while still remaining deliciously snug to thrust into. Between this and his padded, furry ass, you eagerly pound away at him.";
	say "     His soft moans and mewls as your cock slides into him again and again are delightful, exciting you further. You drift a hand underneath him to tickle his balls and tease his cock with a few light touches before taking hold of it and pumping it eagerly. As you fuck him, you tell him again how he's a good kitty and your sexy slut. A steady flow of precum dribbles from his cock as you reiterate his place beneath you with every thrust.";
	say "     You have a good, long fuck session with your fuck-toy, reducing him to a mewling slut by the time your climax comes. You blast your hot load into him, filling him with your thick seed. The feeling of his master cumming inside him is too much and he's spraying his own load onto his cot but a moment later. When you're finally drained your balls into him, [if cock width of player > 10]filling him with enough to make his tummy swell. As you pop your cock free, a gush of it overflows from his overstuffed hole and runs down his thighs and over his balls[else if cock width of player > 5]stuffing him so full that some trickles out as you pull your spent shaft free[else]leaving your hot cream deep inside your pet. You pat his ass lightly as you slip your cock free[end if]. He purrs softly as he stretches out on the sticky, cum-stained cot, soaking in the thick cum he's left on it.";

to say SoloSvenLapFuck:
	say "     Approaching Sven with that look in your eyes, he gives a playful mew and rolls onto his side. He blushes behind his tail as he puts his sexy body on display for you. His bashful display of need is as enticing as ever, getting you hard at the prospect of what is to come. You give his feline ears a scritch, drawing happy purrs from your pet.";
	say "     Taking a seat on his cot, you guide his head to your lap. Needing no direction beyond this, he takes your [cock of player] cock into his muzzle. He licks and sucks at your throbbing rod, purring all the louder as he does. This soft rumble is very arousing, gently running through your shaft to provide subtle stimulation to your prostate and balls as well.";
	say "     But you desire more than a simple blow job from your kitty and so you have him pull back well before your peak. Putting your arms around your put, you pull Sven up into your lap. He sighs contentedly and leans back against your [bodydesc of player] chest as your [cock size desc of player] cock slides [if cock length of player > 20]slowly [end if]into his feline bottom. He gives a soft mewl as you start bouncing him upon your pulsing rod[if the number of bunkered people > 2]. Realizing his erection is hard and so blatantly on display for the others as he's buggered by his master, he blushes brighter than ever and bashfully hides behind his fluffy tail[end if]. The fact that he also gets even harder and dribbles copious amounts of pre doesn't go unnoticed by you either.";
	say "     You give the sexy snowmeow some teasing nibbles on his ear as you thrust in and out of him. You run your hands over his body and down to his hips. Taking his stiff cock in one hand and cupping his enlarged balls in the other, you lewdly play with the kitty's manhood. By the time you achieve orgasm, his release is not far behind. The snow leopard's copious load is sprayed out across the ground before him as further proof of just how much the subby kitty loves taking it up the ass. By the time you're done emptying your [cum load size of player] load into him and pull out, he's left as a purring [if cock width of player > 20]and bloated [else if cock width of player > 10]and plumped [end if]kitty fluffball on his cot with your excess seed leaking from his well-used hole.";

to say SoloSvenRide:
	say "     Deciding on that big, gray cock of his, you wrap your fingers around it and start stroking. He shifts over and stretches out on his back, letting you straddle him as you move into position over his hard rod. Lying across his chest, you nibble at his ear and grind yourself down onto his cock. As you line up with his cock, he softly mewls his desire to fuck and fill his mistress's hot pussy. You sink yourself down over his big cock [if cunt width of player > 5]with ease, letting it fill your wide cunt[else if cunt width of player > 2]with a moan as the thick meat stuffs your cunt[else]slowly, taking your time to adjust to his thick meat in your tight cunt[end if].";
	say "     Once you've got his penis inside you, you start riding it while caressing your kitty's ears and scratching his cheeks. He purrumbles in pleasure, bucking lightly up into you as you ride, but letting you set the pace[if cocks of player > 0]. He brings a paw to your shaft, not wanting to neglect it while you play with him. He strokes and caresses it with quite some skill from all his practice[end if]. His cock feels so good inside you, long, thick and hard. And you make sure to tell him that, saying how pleased you are with your good kitty, your sexy slut.";
	say "     You have a good, long fuck session with your fuck-toy, reducing him to a mewling slut by the time your climax comes. Your pussy clamps down around his shaft, milking and tugging at it as your juices soak his crotch fur. The feel of your cunt spasming around his throbbing rod is too much and he's spraying his hot load into you moments later[if cocks of player > 0] even as you drain you own balls onto his face and chest-fur[end if]. The ample supply from his large balls flows up into you, causing your tummy to swell as it fills your womb. As you pop yourself off his spent shaft, there is a large gush of snowmeow cum that soaks his fur before you can clench your vagina tight to keep the rest of it. He purrs softly as he stretches out on the sticky, cum-stained cot, soaking in the thick cum he's left on it.[impregchance]";

to say SoloSvenRideAnal:
	say "     Deciding on that big, gray cock of his, you wrap your fingers around it and start stroking. He shifts over and stretches out on his back, letting you straddle him as you move into position over his hard rod. Lying across his chest, you nibble at his ear and grind yourself down onto his cock. As you line up with his cock, he softly mewls his surprise at having his master readying to get fucked by him. You caress his muzzle and tell him that he's been such a good kitty that he deserves a special treat. You give him a tongue-filled kiss and sink yourself down over his big cock with a moan as the thick meat stuffs your ass.";
	say "     Once you've got his penis inside you, you start riding it while caressing your kitty's ears and scratching his cheeks. He purrumbles in pleasure, bucking lightly up into you as you ride, but letting you set the pace. He brings a paw to your shaft, not wanting to neglect it while you play with him. He strokes and caresses it with quite some skill from all his practice. His cock feels so good inside you, long, thick and hard. And you make sure to tell him that, saying how pleased you are with your good kitty, your sexy slut.";
	say "     You have a good, long fuck session with your fuck-toy, reducing him to a mewling slut by the time your climax comes. Your anus clamps down around his shaft, milking and tugging at it even as you drain you own balls onto his face and chest-fur. The feel of your asshole spasming around his throbbing rod as your semen streaks his fur is too much and he's spraying his hot load into you moments later. The ample supply from his large balls flows up into you, causing your tummy to swell as it warms your bowels. As you pop yourself off his spent shaft, there is a large gush of snowmeow cum that soaks his fur before you can clench your asshole tight to keep the rest of it. He purrs softly as he stretches out on the sticky, cum-stained cot, soaking in the thick cum you've both left on it.[mimpregchance]";

to say SvenWS:
	if cocks of player > 0:
		say "     Grinning down at your kitty, you can't help but feel he needs another drink. As you gently take his head into your hands, he glances up at you and purrs softly, knowing what's to come. He starts licking and sucking softly, readily drinking down your piss as you release your bladder. He swallows it down eagerly, always such a thirsty kitty[if level of Sven / 2 is even]. This time, you decide to pull your cock free before you finish and spray the last of it onto him, marking him as your fuck-toy. He lays on his back, rolling in the wet puddle, lost in a blissful haze while stroking his throbbing cock. He ends up spraying a huge amount of cum from his large balls onto his chest. You leave him like that, sticky with cum and purring like a sexy feline fuck-toy that's been well used[else]. You keep his muzzle wrapped around your cock until you're fully drained this time, filling your lustful snowmeow with every single drop of your hot urine. He smiles up at you, purring happily as he lays back on the cot, stroking his full tummy and licking his lips to enjoy the strong, lingering taste in his mouth. He strokes himself off with his other paw, spraying a huge amount of cum from his large balls onto his chest. You leave him like that, sticky with cum and purring like a sexy feline fuck-toy that's been well used[end if].";
	else:
		say "     Grinning down at your kitty, you can't help but feel he needs another drink. As you gently take his head into your hands, he glances up at you and purrs softly, knowing what's to come. He starts licking and sucking softly, readily drinking down your piss as you release your bladder. He swallows it down eagerly, always such a thirsty kitty[if level of Sven / 2 is even]. Before you finish, you push his head lower. Holding your pussy open with a pair of fingers, you let the remainder of the hot fluid spray down onto your pet's head. He dips his ears submissively, but purrs all the louder as you mark him as your fuck-toy. He lays on the floor and starts grooming himself, licking your urine from his paw after each swipe while the other pumps at his cock, soon adding a huge amount of snowmeow cum from his large balls that he'll have to lick off[else]. You keep his muzzle pressed to your groin while you piss, letting him lap up every drop he can get. While some does leak down his muzzle to run down his neck, he swallows down every drop of your hot urine he can get. He smiles up at you, purring happily as he lays back on the cot, stroking his full tummy and licking his lips to enjoy the strong, lingering taste in his mouth. He strokes himself off with his other paw, spraying a huge amount of cum from his large balls onto his chest. You leave him like that, sticky with cum and purring like a sexy feline fuck-toy that's been well used[end if].";

to say SvenTrio:
	say "     With a grin, you walk over to Candy and put your arm around him, resting one hand on his skirted rear and the other taking his paw. He doesn't object and even starts to prance merrily as he sees you steering him towards Sven's bunk. The kitty sits up as you come over, smiling in anticipation of both he and the coon getting to share your company.";
	if remainder after dividing ( coonsex + level of Sven ) by 3 is 0:			[results cycle - oral]
		if cocks of player > 0:
			say "     You give Candy's ears a scritch and guide him down onto his knees in front of Sven. The coon, being presented with the large, [if lust of Sven is 1]baby blue[else if lust of Sven is 2]yellow[end if] cock, immediately sets to work licking and sucking at it. The colorful snowmeow mrowls in pleasure and squirms in delight. Taking a seat beside your pet, you run a hand through the soft fur of his back and nibble his ear. You then tap the coon's shoulder and point out your stiff [if cocks of player > 1]cocks[else]cock[end if] ready and waiting for him as well.";
			say "     Candy grins in pleasure as he slides his muzzle slowly off Sven's shaft, giving it a final flick with his tongue before switching to yours. His soft lips and warm muzzle slide down over you and he sets his well-practiced tongue to work on you now. He licks, bobs and sucks over your cock, making you moan with delight now. A raccoon paw drifts over to the snow leopard's cock, stroking it as you are tended to until his turn comes again.";
			say "     Just as you're starting to get really excited, Candy moves off, switching back to Sven's cock. His nimble fingers are very talented and enjoyable as well, keeping you hard as you watch the coon bob his muzzle over the snowmeow's shaft. Candy's other paw has drifted down to the heavy orbs beneath that thick meat he's stuffing into his mouth with ease. As with you, once Sven's excitement starts to build too high, the coon's muzzle switches back to you[if cocks of player > 2], taking another of your cocks this time[else if cocks of player is 2], taking your other cock this time[end if].";
			say "     He keeps this exchange up several times, always pushing you both higher and higher until finally you're both panting and moaning loudly for release. He grins up at you and pumps your cocks hard and fast, aiming them at his open mouth. You go off almost simultaneously, both spraying your pent-up loads onto and into the coon's muzzle[if cock width of player > 10]. Candy's face gets largely painted white by your combined impressive outputs[end if]. The girly coon moans in pleasure, catching as much as he can in his muzzle while pumping your cocks for all they'll give before making a show of swallowing it down for you. You spot a sticky puddle on the floor where Candy's creamed his panties from delight at sucking off his two favorite friends.";
			say "     You get up and leave Candy and Sven to snuggle on the bunk while your pet lickgrooms the cum from the coon's face. You grin and head off to take care of other things, content in the knowledge that the coon and the snowmeow will keep each other company while you're away.";
		else:
			say "     You give Candy's ears a scritch and guide him down onto his knees in front of Sven. The coon, being presented with the large, [if lust of Sven is 1]baby blue[else if lust of Sven is 2]yellow[end if] cock, immediately sets to work licking and sucking at it. The colorful snowmeow mrowls in pleasure and squirms in delight. Stepping up beside Candy, you put one foot on the bunk beside Sven, offering your wet pussy to your kitty. Sven buries his muzzle in your groin, running his raspy tongue over your dripping slit. You stroke his ears and run your fingers through his hair as he licks and teases your sensitive pussy.";
			say "     Candy takes his time while giving the snow leopard one of his expert blow jobs. You have a good view of the show, watching as the coon bobs his muzzle up and down over that [if lust of Sven is 1]blue[else if lust of Sven is 2]golden[end if] rod and playing with those heavy balls. He glances up at you from time to time as well, though only to gauge your arousal level so Sven can finish when you do.";
			say "     Sven's technique, still improving every time, is quite enjoyable, with your lustful pet trying everything he can to please you as much as possible. He starts to alternate between diving his tongue and sliding [if cunt width of player > 5]a paw into your wide pussy[else if cunt width of player > 2]three fingers into your ample pussy[else]a pair of fingers into your wet pussy[end if]. He laps up your juices, thirsty for all you'll give him. You scritch your pets ears and tell him what a good kitty he is between telling the coon to keep it up.";
			say "     As you feel your orgasm washing over you, you moan loudly and press Sven's muzzle to your pussy, crying out that you're about to cum. This signal sends Candy into overdrive, bobbing and sucking wetly on the feline cock. As your climax strikes, your hot juices flow over Sven's muzzle and wash over his lapping tongue, setting him off moments later. The girly coon's cheeks swell with Sven's unleashed load.";
			say "     You grind your pet's face into your pussy until your orgasm passes and you release him. Candy, with his muzzle still stuffed with Sven's cum, leaps onto the cot with him. He kisses the [if lust of Sven is 1]baby blue[else if lust of Sven is 2]golden yellow[end if] snowmeow and shares the kitty's heavy load with him. As they share this sticky, cummy kiss, the coon pumps his hot pink cock until he's shooting his load onto the snow leopard as well. You decide to leave them like that, kissing and snuggling in the afterglow of the threesome. You are content in the knowledge that the coon and the snowmeow will keep each other company while you're away.";
	else if remainder after dividing ( coonsex + level of Sven ) by 3 is 1:		[results cycle - Sex A]
		say "     Candy snuggles up beside the snow leopard, running his paws through the kitty's fur and grinding the bulge in the front of his skirt against him. Nibbling Sven's ear, he uses a paw to slip his panties down, freeing his cock and grinding it under the snow leopard's tail. The coon, clearly intent on mounting the kitty again, is getting right to it. Deciding it'd be best to get into position now before they get too far along, you ";
		if cocks of player > 0:
			say "move in behind the coon, lining up your hard shaft with his rear and grinding it against him firmly. You guide your pet to lay down on the bed with the pink boy-toy lining up his cock under his fluffy, [if lust of Sven is 1]baby blue[else if lust of Sven is 2]golden yellow[end if] spotted tail. And you are behind the pink raccoon, tapping your glans against his back door.";
			say "     All three of you moan together as you start sinking your [if cock length of player > 23]huge [else if cock length of player > 12]large [end if]cock into the coon, sending his pink member into the snowmeow's fluffy bottom[if cock length of player > 23]. The girly raccoon groans quite loudly as you continue to stuff your huge length into him, stretching him wide to take it, but his flexible and well-trained hole eventually takes it all, much to the little guy's delight[else if cock length of player > 12]. The girly raccoon churrs in pleasure as you continue to stuff your large meat into him, stretching him considerably to take it. His flexible and well-trained hole takes it all in with only a little effort, much to the little guy's delight.[else]. The girly raccoon churrs in pleasure as you stuff your full length into him, stretching his flexible and well-trained hole with ease[end if]. With your shaft snug inside the boy-toy's bottom, you start thrusting steadily, driving the coon's cock into your pet every time as if you're fucking them both.";
			say "     You nibble at the raccoon's ears as you thrust into him, enjoying the delicious sounds of delight coming from the two slutty guys beneath you. You tell them what a pleasure it is to have them under you, to be fucking them like they deserve, how much you want to fill their asses over and over again. Their purrs and churrs of delight get louder and more excited as you continue like this, gradually picking up the pace. When finally you can't take any more, you drive hard and deep into the coon, unleashing your load, setting him off to do the same for the snowmeow at the bottom. Your hot load blasts into the pink coon, [if cock width of player > 10]making his belly swell from your large output[else if cock width of player > 5]stuffing his ass fully with your creamy cum[else]painting his bowels with your seed[end if]. This sets off the coon soon after, pounding hard and fast into the snowmeow as he fills him with his sweet cum and driving your pet to make a creamy mess on his cot again as he cums as well.";
			say "     You pull out slowly and Candy keeps his rump raised, holding your cum inside him as he moans softly, enjoying the feel of it inside him. He nuzzles at Sven's ears, nibbling them lightly and stroking his soft fur as they stay snuggled on the cot, enjoying the afterglow and the warm feeling of fullness from a wet load of semen inside them.";
		else:
			say "move in front of your pet kitty and take his stiff, [if lust of Sven is 1]blue[else if lust of Sven is 2]golden[end if] cock in your hand. You guide your pet to lay atop you, lining up his erection with your wet folds while the coon lines up with the kitty's back door.";
			say "     All three of you moan together as Candy slides his cock into Sven's feline bottom, sending the kitty's cock sliding into your wet and waiting pussy. Your pet's sizable cock sinks into your eager cunt, [if cunt width of player > 5]enough to please even your ample pussy[else if cunt width of player > 2]a snug fit for your pussy[else]a tight fit for your small pussy, but are able to stretch to take it with only a little pain and a whole lot of pleasure[end if]. Your pet lets Candy set the pace, moving his hips to thrust into you each time the coon thrusts into him. He purrs and nuzzles you happily as he enjoys being sandwiched in this sexy three-way.";
			say "     You run your arms along their sides, smiling up at them both as they ride atop you as if both fucking you at once. Their purrs and churrs of delight get louder and more excited as you continue like this and Candy gradually picks up the pace. You scritch their ears and run your fingers through their fur, telling them how sexy they are, what lovely, slutty playmates they make. When the pace picks up again, rushing towards the end now, you reach back and grab the coon's ass, squeezing it firmly and pulling him down harder into each thrust. This makes Sven mewl sweetly in your ear each time until finally Candy drives deep inside him and unleashes his sweet seed. You can feel the throb of the snow leopard cock inside you as his prostate is pressed against and his ass filled, you are rewarded with a hot load of your own blasting into your pussy and flowing into your womb.";
			say "[impregchance]";
			say "     The three of you lay there for some time, enjoying the afterglow from your wild threesome. Before the others drift off completely, you get them to move off you, leaving them to snuggle while you get back to other matters.";
	else:													[results cycle - Sex B]
		if cocks of player > 0 and cunts of player > 0:
			say "     You snuggle with the two pretty play-toys as run your fingers through their soft fur, nuzzling them each in turn. With such willing partners, you try to decide what you'd like to do with them this time. You slide your hands down to their bottoms, wondering if you'd like to fuck both their adorable asses.";
			say "     [bold type] Letting your fingers drift around to grab their stiff cocks and stroke them, there's also the possibility of getting some coon cock in you with your pet's help.[roman type][line break]";
			LineBreak;
			say "     ([link]Y[as]y[end link]) - Fuck them both.";
			say "     ([link]N[as]n[end link]) - Coon sex.";
			if the player consents:
				LineBreak;
				say "[SvenTrio2fuck]";
			else:
				LineBreak;
				say "[SvenTrioCoonSex]";
		else if cocks of player > 0:
			say "[SvenTrio2fuck]";
		else:
			say "[SvenTrioCoonSex]";

to say SvenTrio2fuck:
	say "     Finding yourself in the mood to top the sexy pair, you get them both on the cot on all fours. It's a tight squeeze, but the little guys manage it well enough by snuggling close. With their asses raised in the air, they intertwine their tails and wave the fluffy, colorful mass tantalizingly to show their eagerness. You run your fingers over their bottoms, teasing their tight puckers to hear them moan before picking to start with Sven.";
	say "     You line up your throbbing member with his back door and ease yourself slowly into him, enjoying the soft moan of pleasure as you do[if cock length of player > 23]. You take your time working your huge cock fully into him getting him good and stuffed with it, making his tummy bulge with your impressive meat filling it[else if cock length of player > 12]. You steadily work your large cock into him, stuffing his tummy nicely with it, making a little bulge show from your large member[else]. You sink your cock into him steadily, working the full length into his eager ass easily[end if]. Once fully in your pet, you thrust away, taking your time to savor the feel of his inner walls gripping around you.";
	say "     You bring a hand to Candy's rear and squeeze it before fingering his tail-hole, helping to get him ready for his turn. He and the sexy kitty wrap their arms around one another, nuzzling and kissing as you play with them. After a minute or so in the snow leopard's ass, you switch over to the coon and mount him now. Much like your pet, his ass takes your cock in until you have it fully inside his squeezing, eager rump. You pound away at his ass now, giving him a good, if short, fucking before going back to Sven again.";
	say "     You alternate like this numerous times, pumping your [if cock length of player > 23]huge [else if cock length of player > 12]large [end if]cock into them for a while before switching to the other. You pump a few fingers into the vacant hole. As you switch, you can see each stroking the other's cock as they take turns sharing your manhood in their needy holes. While taking them both is quite arousing, the constant switching gives you a moment to calm down each time, letting you draw it out so they each get a proper fucking. Eventually, you can feel your climax coming as your aching balls throb with the need to drain.";
	say "     [bold type]You need to decide quickly who to finish in, Sven or Candy.[roman type][line break]";
	LineBreak;
	say "     ([link]Y[as]y[end link]) - Sven.";
	say "     ([link]N[as]n[end link]) - Candy.";
	if the player consents:
		LineBreak;
		say "     Deciding on Sven, you drive your cock into him one last time and start pounding away at him hard and fast. You bury your fingers in his soft fur to grip his cute ass tightly. He mrowls and mewls loudly, knowing what's coming and longing for it. Candy, now free to move, slides around quickly and stuffs Sven's large cock into his muzzle. His paws scritches the kitty's ears and gets him to return the favor for the excited coon. You are barely able to hold back long enough to get their 69 going before you moan loudly and drive your cock hard into the snowmeow, unleashing your hot load into him[if cock width of player > 15]. Your hefty balls blast their seed out from your cock, over-stuffing his tummy so much it swells from your huge load[else if cock width of player > 8]. Your big balls pump their seed out from your cock, stuffing his ass fully with your ample load[else]. Your balls throb and your cock pumps out your seed, spraying your seed into his eager bottom[end if]. You can hear the delicious sounds of their wet moans as they swallow down each other's semen. Once your climax passes and you all bask in the afterglow, you snuggle and kiss on the cot for a while before you get up and head off, leaving them to snuggle while you tend to other matters.";
	else:
		LineBreak;
		say "     Deciding on Candy, you wrap your arms around the pretty coon and lift him to sit upright in your lap, all the while keeping your penis in him. You bounce him on your cock hard and fast, making him moan and churr in delight. Supporting him with one arm, you bring your other hand to his hot pink shaft and pump at it in time to your pounding into him. Sven rolls over onto his back in front of you both, stroking his [if lust of Sven is 1]baby blue[else if lust of Sven is 2]golden[end if] cock while looking up at you both. You nibble along Candy's neck and drive your shaft hard into him one last time before cumming hard, [if cock width of player > 15]over-stuffing his ass enough to make his tummy swell with your excessive cum[else if cock width of player > 8]stuffing his ass completely full with your ample cum[else]painting his inner walls with your thick cum[end if]. As you are filling him, you continue stroking him off until you get him to spray his cotton candy scented load across your pet's soft fur. That whole show and the final climax across his body pushes Sven over the edge and he sprays his ample load across his face and body, getting him even stickier with cum. You pant and lower the spent coon down atop him, then slowly withdraw. You smile happily as you watch them cuddle up together, both smiling back up at you as you all bask in the afterglow. As they start to drift off, you scritch their ears and get up, heading off to take care of other matters.";

to say SvenTrioCoonSex:
	say "     Wanting to get the sexy coon into you for a change, you wrap your arms around him in a hug. He churrs and nuzzles you, allowing himself to be pulled back to lie atop you on the bunk. You scritch his ears and slide a hand between you both to take hold of his cock. You start stroking his shaft[if cocks of player > 0] against yours[end if] making him moan in pleasure. Sven, waiting beside you, grins mischievously as you motion to the coon's tight rump. Slipping the coon's panties off, he hikes up the skirt and lines his cock up with that pink pucker waiting for him. Candy moans softly and wiggles his rear in anticipation. But just as your loyal pet starts sinking his shaft into that welcoming hole, you shift position slightly and guide the coon's cock down into your waiting pussy.";
	say "     The girly coon squirms a little, but largely in delight at having that big, feline cock filling him. You scritch his ears soothingly, telling him to focus on that sexy male atop him and to pretend you're just holding him. 'It's all about that hard cock filling you, pounding away at your tight ass,' you moan in his ear. 'Feel it in there, sliding against your sensitive walls, pressing against your prostate so nicely. That sexy kitty atop you is going to make you feel so good with it, then stuff you so full of his cum. You want that, don't you, pretty coon?' He moans and nods, starting to rock his hips in time to Sven's thrusts, pumping into you. 'That's a good boy,' you purr, 'keep that up and we'll all get what we want.'";
	say "     You continue to whisper lewdly to the coon about how hot Sven's cock in his ass is, keeping him worked up and focused on that pleasure. His thrusting into you picks up, instinctively fucking the warm, tight hole gripping his shaft, much to your delight. Your words have been exciting the snow leopard as well and soon he's rumbling deeply as his thrusts come in hard jabs, making you both moan beneath him. Finally, it is all too much for him and he mrowls loudly, unleashing his hot semen into the raccoon's bottom. This is enough to send the gay coon over the edge and you can feel his cock throb inside you, releasing his sweet semen into your pussy so it can flow into your waiting womb. With visions of this in your mind, your orgasm washes over it, making your pussy clamp down around the hot pink penis, milking it for all it will give.[coonpreg]";
	say "     Candy and Sven end up snuggled atop you and you put an arm around each of them. You all bask in the afterglow from the wild romp. He coon smiles, nuzzling and kissing you both, showing he's not upset with your little fun for him as he got the hot snowmeow cum in his ass as promised. You all drift off for a brief nap together before eventually you have to get up and get back to other matters.";

to say ConfidentSvenSex:	[***]
	say "     Sven smiles as you start hinting about sex and his tail-tip twitches excitedly. Leaning back on his bunk, the white-furred cat shows off his sexy body and markings. Purrumbling playfully, he hooks his thumbs over the waistband of his shorts, pushing them down. 'What did you have in mind, my friend?'";
	now sextablerun is 0;
	blank out the whole of table of fucking options;
	[]
	if cocks of player > 0:
		choose a blank row in table of fucking options;
		now title entry is "Fuck him";
		now sortorder entry is 1;
		now description entry is "Pound the big kitty's ass";
	[]
	if cunts of player > 0 or cocks of player > 0:
		choose a blank row in table of fucking options;
		if cunts of player > 0:
			now title entry is "Ride him (vaginal)";
		else:
			now title entry is "Ride him (anal)";
		now sortorder entry is 2;
		now description entry is "Get his feline shaft inside you";
	[]
	if cocks of player > 0:
		choose a blank row in table of fucking options;
		now title entry is "Get a blow job";
		now sortorder entry is 3;
		now description entry is "Have the fluffy kitty suck you off";
	[]
		choose a blank row in table of fucking options;
		now title entry is "Give him a blow job";
		now sortorder entry is 4;
		now description entry is "Suck off the fluffy kitty";
	[]
	sort the table of fucking options in sortorder order;
	repeat with y running from 1 to number of filled rows in table of fucking options:
		choose row y from the table of fucking options;
		say "[link][y] - [title entry][as][y][end link][line break]";
	while sextablerun is 0:
		say "Pick the corresponding number> ";
		get a number;
		if calcnumber > 0 and calcnumber <= the number of filled rows in table of fucking options:
			now current menu selection is calcnumber;
			choose row calcnumber in table of fucking options;
			say "[title entry]: [description entry]?";
			if player consents:
				let nam be title entry;
				now sextablerun is 1;
				if SvenCandyMsg is 1 and nam is not "Threesome w/Candy":
					say "     You decide to give Sven some personal attention this time and head on over to him. As you start heading that way, you see Candy take an interest. The pink coon takes a comfortable seat to watch the entertainment.";
				if nam is "Fuck him":
					say "[ConfidentSvenSex01]";
				else if nam is "Ride him (vaginal)":
					say "[ConfidentSvenSex02]";
				else if nam is "Ride him (anal)":
					say "[ConfidentSvenSex03]";
				else if nam is "Get a blow job":
					say "[ConfidentSvenSex04]";
				else if nam is "Give him a blow job":
					say "[ConfidentSvenSex05]";
		else:
			say "Invalid Option. Pick between 1 and [the number of filled rows in the table of fucking options].";
	now lastfuck of Sven is turns;
	wait for any key;
	clear the screen and hyperlink list;

to say ConfidentSvenSex01:	[Fuck him]
	say "     Walking up to the young man as he stands before you in very confident nakedness, you slide a hand behind his head and give him a deep kiss. Sven starts a bout of tongue-wrestling by pushing his own into your mouth in friendly exploration, then wiggles it against yours while making out. When the two of you pull apart again after a few quite pleasurable moments, you tell him that you want to fuck him. Sven's tail twitches with excitement and a grin spreads over his muzzle, followed by a loud purr that vibrates through his chest. Running a paw down over your front, he replies, 'How could I say no to a hard cock like this?' Cupping the bulge over your crotch eagerly, the sexy feline feels the hard length of your [cock of player] shaft through your clothes, then crouches down in front of you.";
	say "     'Let's unwrap this bad boy,' the exchange student says in an aroused tone, nuzzling your bulge for a moment before quickly undoing your clothes. Within moments, all fabric gets pushed down and your [cock size desc of player] cock springs up from its confinement, almost hitting Sven in the face. Closing a soft paw around your manhood, he strokes you to full erection before nuzzling down to your crotch. You can feel his warm breath across your sensitive flesh, then his muzzle slides over it. Looking down, you see a blissful expression on the triangular face of your friend, his textured tongue playing across your shaft while getting it slick with saliva.";
	WaitLineBreak;
	say "     After several minutes of cock-sucking delight, Sven eases his muzzle off your shaft and rises to his feet. He gives you a quick kiss, brushing his tongue over yours to share a little taste of your own pre before jumping back on agile paws as you want to draw him into another fun bout of making out. With a wink, the sexy kitty calls out, 'Catch me if you can, stud!' Chuckling, you start to follow and he evades you with playful ease, even taking the time to wiggle his body teasingly once or twice while being chased between the rows of beds down here in the bunker. And that is exactly what decides this little game for you in the end - as he stops for another few seconds at one point, you don't go around the bed between the two of you, instead stepping up on it and throwing yourself forward, bowling Sven over and landing with him in your grasp on a bed in the next row.";
	say "     Both of you are laughing happily as you wrap your arms around the soft-furred form of the snow leopard, at first just holding on to his squirming body as he tries to get away. Yet with both of you naked, wrestling on a bed in full contact with each other's body - including two very hard cocks, it doesn't take long before a whole other kind of game starts. Soon, you're grinding your crotch against his, cocks sliding hotly against one another, and you share some breathless kisses between the two of you. 'Please fuck me. I want it in me,' Sven gasps out in an eager voice, and you are more than happy to oblige the sexy feline and move to mount him.";
	WaitLineBreak;
	say "     Long legs covered in silky smooth fur stroke along the sides of your thighs as the snow leopard spreads them for you, then wraps them around your hips. You line yourself up with trembling fingers while keeping eye-contact with your sexy friend, then push forward into him with a lust-filled grunt. His sexy ass is tight at first, but relaxes quickly to allow you deeper and deeper inside. Sven's expression changes to one of blissful satisfaction as your [cock of player] meat sinks into his rear and a loud pant of, 'Oooohh fuck yeah!' leaves his lips to sound throughout the large room. The feline rumbles and purrs with delight as you start thrusting into him, pumping your [cock size desc of player] shaft in and out of his [if cock length of player > 36]considerably stretched hole and overstuffed belly[else if cock length of player > 24]considerably stretched hole[else if cock length of player > 12]well-stuffed hole[else]quivering hole[end if]. After running your hands over his chest and down to his hips, you hold on tight to aid in your pounding the needy feline.";
	say "     As the two of you make love like this, Sven slips a paw to his own hard and throbbing erection. With a paw around his gray cock, he works it up and down its lengthy shaft and sometimes even playfully smacks his erection against your tummy if you've just thrust balls-deep inside him. His other paw moves to his extra-plump balls and starts playing with them as well. The sexy snow-leopard strokes and pumps at that pulsing shaft of his, purring in increasing loudness as he's fucked in the ass by his friend. Feeling Sven's inner muscles flex and twitch around your cock, you give him harder and harder thrusts as your shared arousal builds up rapidly.";
	WaitLineBreak;
	say "     It's not long before the big kitty is pushing his hips up into your thrusts and pumping his shaft frantically. Eyes clenched shut, he moans and mewls as his asshole clenches down around you. A moment later, the first of many gooey blasts of feline seed spray from his cock, splattering across his fluffy face and chest. Having his anus clamp down around you while you're treated to this erotically messy sight is enough to push you over the edge too and you cum partway through the snow leopard's orgasm, sending your own hot seed into his bowels. Your balls tingle and twitch with every heavy spurt of your load being deposited in your panting partner, staking a creamy claim on his amazing ass.";
	say "     Once his orgasm eventually ebbs off, Sven sags back onto the mattress, panting heavily with an expression of dazed delight on his muzzle. You yourself are at it a few moments longer, painting his bowels with your semen, then pull out while giving the sexy exchange student a tender kiss. After a little bit more stroking and touching, you eventually push yourself up from the bed, leaving Sven to recover while you strut over to the pile of your clothes and get dressed.";

to say ConfidentSvenSex02:	[Ride him (vaginal)]
	setmonster "Snow Leopard";
	say "     Walking up to the young man as he stands before you in very confident nakedness, you slide a hand behind his head and give him a deep kiss. Sven starts a bout of tongue-wrestling by pushing his own into your mouth in friendly exploration, then wiggles it against yours while making out. When the two of you pull apart again after a few quite pleasurable moments, you tell him that you want to ride his cock. Sven's tail twitches with excitement and a grin spreads over his muzzle, followed by a loud purr that vibrates through his chest. Running a paw down over your front, he replies, 'I'd love that.' Rubbing your crotch eagerly, the sexy feline pushes his fingers against the fabric of your clothes and feels for the bumps of your nether lips, then crouches down in front of you.";
	say "     'Let's see what a sexy thing you are,' the exchange student says in an aroused tone, nuzzling your crotch for a moment before quickly undoing your clothes. Within moments, all fabric gets pushed down and your moist pussy is revealed to him, drawing Sven's head forward to give you an eager sniff. He nuzzles your nether lips and purrs loudly, creating an amazing sensation of vibration against your clit that has you moaning in a second. Then you can feel his warm breath across your sensitive flesh as the snow leopard opens his muzzle and gives you a first lick. Looking down, you see a blissful expression on the triangular face of your friend, his textured tongue playing across your sensitive folds and leaving them slick with saliva.";
	WaitLineBreak;
	say "     After several minutes of delightful tongue-work on your pussy and sensitive clit, Sven pulls his muzzle from where it was buried between your thighs and rises to his feet. He gives you a quick kiss, brushing his tongue over yours to share a little taste of your own female juices before jumping back on agile paws as you want to draw him into another fun bout of making out. With a wink, the sexy kitty calls out, 'Catch me if you can, babe!' Chuckling, you start to follow and he evades you with playful ease, even taking the time to wiggle his cock teasingly once or twice while being chased between the rows of beds down here in the bunker. And that is exactly what decides this little game for you in the end - as he stops for another few seconds at one point, you don't go around the bed between the two of you, instead stepping up on it and throwing yourself forward, bowling Sven over and landing with him in your grasp on a bed in the next row.";
	say "     Both of you are laughing happily as you wrap your arms around the soft-furred form of the snow leopard, at first just holding on to his squirming body as he tries to get away. Yet with both of you naked, wrestling on a bed in full contact with each other's body - including a very hard cock and by now literally dripping wet pussy, it doesn't take long before a whole other kind of game starts. Soon, you're grinding your crotch against his, nether lips sliding against the hot length of his shaft, and you share some breathless kisses between the two of you. 'Can't wait to be inside you,' Sven gasps out in an eager voice, one paw closing around the base of his cock to hold it upright - ready for you to mount him. Beneath the now proudly standing erection, you can see those extra-plump balls of his, heavy with snowmeow semen just waiting for you. The sight - and feel, as you reach out to touch him - of Sven's virile manhood only excites you all the more.";
	WaitLineBreak;
	say "     The feline's paws move to your hips and gently guide you to straddle his hips. Moving on top of him, you keep his shaft lined up while sinking your hot, wet cunny down onto it. You both moan softly in delight as the thick manhood nudges apart your pussy lips, then smoothly slides into your cunt. 'Yeah baby!' Sven grunts in arousal, his cock throbbing against your inner walls. You can feel his hands grip your hips a little tighter as the desire to just pull you down on him hard rises in the exchange student, yet he manages to control his urges, leaving you to set your own pace. Of course, you're no less eager to fuck him than Sven is, so he doesn't have to wait long. After taking the first few slides up and down several inches of his cock, you soon push yourself lower and start riding him in earnest. Your hands move to his shoulders for support as you bounce up and down on the kitty's pulsing pole.";
	say "     Sven's paws run over your body, with the snow leopard purring happily as he does[if cocks of player > 0]. He eventually finds his way to your hips after groping your ass playfully. One paw takes hold of your hip and steadies you while the other slips between you to your cock, stroking and caressing your [cock of player] shaft[else if breast size of player > 0]. His paws find their way to your bosom to play with your nipples while caressing your [short breast size desc of player] breasts. Cupping one, he leans in and brings his muzzle to your breast, soon licking and sucking on your hard nip to make you moan in pleasure[else]. His paws eventually find their way to your hips after groping your ass playfully. Holding your hips, he steadies you while encouraging you to ride him harder and faster[end if]. The sound of his purring grows louder as the two of you make love. Soon, it is like his whole body is vibrating under you, including the hard cock buried between your nether lips. In a - very - stimulating emulation of a vibrator, the sexy feline builds your arousal up more and more, quickly driving you to filling the bunker with loud moans.";
	WaitLineBreak;
	say "     It's not too long before the big kitty is pushing his hips up even as you slam down. Eyes clenched shut, he moans and mewls as his shaft throbs and pulses inside you as his climax arrives. Blast after gooey blast of feline seed sprays from his gray cock, splattering against your cervix and flowing into your womb. Feeling him seeding you so heavily is enough to push you over the edge as well and you cry out in orgasm partway through the snow leopard's release, adding your hot juices to the sticky mess leaking around his pulsing rod.[fimpregchance]";
	say "     Once his orgasm eventually ebbs off, Sven sags back onto the mattress, panting heavily with an expression of dazed delight on his muzzle. You yourself are at it a few moments longer, riding out further waves of pleasure with the delightfully full sensation created by his still pretty hard cock and warm load inside you. After allowing the last quivers of your orgasm to pass, you lean down to give the sexy exchange student a tender kiss while gently pulling off his slowly softening cock. There is a little bit of further mess on Sven's crotch as some of his load drips out of your pussy and onto him - but most of his come is planted deep enough to remain in your well-bred pussy and womb. Something tells you that the sated feline doesn't mind getting a bit dirty with you, so you push yourself up from the bed eventually, leaving Sven to recover while you strut over to the pile of your clothes and get dressed.";

to say ConfidentSvenSex03:	[Ride him (anal)]
	say "     Walking up to the young man as he stands before you in very confident nakedness, you slide a hand behind his head and give him a deep kiss. Sven starts a bout of tongue-wrestling by pushing his own into your mouth in friendly exploration, then wiggles it against yours while making out. When the two of you pull apart again after a few quite pleasurable moments, you tell him that you want to ride his cock. Sven's tail twitches with excitement and a grin spreads over his muzzle, followed by a loud purr that vibrates through his chest. Running a paw down your back and squeezing your buttocks, he replies, 'How could I say no to such a nice booty like this?' Cupping the bulge over your crotch eagerly with his other hand, the sexy feline feels the hard length of your [cock of player] shaft through your clothes, then crouches down in front of you.";
	say "     'Let's unwrap this bad boy,' the exchange student says in an aroused tone, nuzzling your bulge for a moment before quickly undoing your clothes. Within moments, all fabric gets pushed down and your [cock size desc of player] cock springs up from its confinement, almost hitting Sven in the face. Closing a soft paw around your manhood, he strokes you to full erection before nuzzling down to your crotch. You can feel his warm breath across your sensitive flesh, then his muzzle slides over it. Looking down, you see a blissful expression on the triangular face of your friend, his textured tongue playing across your shaft while getting it slick with saliva.";
	WaitLineBreak;
	say "     After several minutes of cock-sucking delight, Sven eases his muzzle off your shaft and rises to his feet. He gives you a quick kiss, brushing his tongue over yours to share a little taste of your own pre before jumping back on agile paws as you want to draw him into another fun bout of making out. With a wink, the sexy kitty calls out, 'Catch me if you can, stud!' Chuckling, you start to follow and he evades you with playful ease, even taking the time to wiggle his body teasingly once or twice while being chased between the rows of beds down here in the bunker. And that is exactly what decides this little game for you in the end - as he stops for another few seconds at one point, you don't go around the bed between the two of you, instead stepping up on it and throwing yourself forward, bowling Sven over and landing with him in your grasp on a bed in the next row.";
	say "     Both of you are laughing happily as you wrap your arms around the soft-furred form of the snow leopard, at first just holding on to his squirming body as he tries to get away. Yet with both of you naked, wrestling on a bed in full contact with each other's body - including two very hard cocks, it doesn't take long before a whole other kind of game starts. Soon, you're grinding your crotch against his, cocks sliding hotly against one another, and you share some breathless kisses between the two of you. 'Get me wet for your ass,' Sven gasps out in an eager voice, and you are more than happy to oblige the sexy feline and move lower, soon coming face to face with his erect shaft.";
	WaitLineBreak;
	say "     A grin spreads over your face, followed by licking the side of his cock, making Sven groan in pleasure. The sexy snowmeow is already quite wound up so you go slow, using a lot of spit as you lap up and down over his hard length, then take it into your mouth and give a gentle suck. 'Fuck yeah, that feels good!' your friend pants out, hands moving to touch your head and pull you a bit closer to his crotch. Taking this in stride, you bob up and down on his erection, using your tongue to tease it as you do so. Beneath the snow leopard's now wet and glistening erection, you can see those extra-plump balls of his, heavy with snowmeow semen just waiting for you. The sight and feel, as you reach out to cup his balls only excites you all the more. Before much longer, the feline's paws pull you off his cock with some urgency. A look at his panting face tells you why - you were just too good at blowing him.";
	say "     'Nnngghh - I gotta get inside you NOW or I'll just blow in your mouth,' Sven grunts and pulls on you, guiding you to straddle his hips. Moving on top of him, you keep his shaft lined up while sinking your ass down onto it. You both moan softly in delight as the thick manhood nudges against your pucker before your downwards pressure quickly pops his slick dickhead inside to slide into your trembling hole. 'Yeah dude!' Sven grunts in arousal, his cock throbbing against your inner walls. You can feel his hands grip your hips a little tighter as the desire to just pull you down on him hard rises in the exchange student, yet he manages to control his urges, leaving you to set your own pace. Of course, you're no less eager to fuck him than Sven is, so he doesn't have to wait long. After taking the first few slides up and down several inches of his cock, you soon push yourself lower and start riding him in earnest. Your hands move to his shoulders for support as you bounce up and down on the kitty's pulsing pole.";
	WaitLineBreak;
	say "     Sven's paws run over your body, with the snow leopard purring happily as he does[if cocks of player > 0]. He eventually finds his way to your hips after groping your ass playfully. One paw takes hold of your hip and steadies you while the other slips between you to your cock, stroking and caressing your [cock of player] shaft[else if breast size of player > 0]. His paws find their way to your bosom to play with your nipples while caressing your [short breast size desc of player] breasts. Cupping one, he leans in and brings his muzzle to your breast, soon licking and sucking on your hard nip to make you moan in pleasure[else]. His paws eventually find their way to your hips after groping your ass playfully. Holding your hips, he steadies you while encouraging you to ride him harder and faster[end if]. The sound of his purring grows louder as the two of you make love.";
	say "     Soon, it is like his whole body is vibrating under you, including the hard cock buried in your back passage. In a - very - stimulating emulation of a vibrator, the sexy feline builds your arousal up more and more, quickly driving you to filling the bunker with loud moans. It's not too long before the big kitty is pushing his hips up even as you slam down. Eyes clenched shut, he moans and mewls as his shaft throbs and pulses inside you as his climax arrives. Blast after gooey blast of feline seed sprays from his gray cock, splattering your inner walls and soaking your colon with his cum. Feeling him seeding you so heavily is enough to push you over the edge as well and you cry out in orgasm partway through the snow leopard's release, blasting out long strings of [cock of player] cream to make Sven's chest-fur a sticky mess.[mimpregchance]";
	WaitLineBreak;
	say "     Once his orgasm eventually ebbs off, Sven sags back onto the mattress, panting heavily with an expression of dazed delight on his muzzle. You yourself are at it a few moments longer, spurting a few more shots of seed all over him. After allowing the last quivers of your orgasm to pass, you lean down to give the sexy exchange student a tender kiss while gently pulling off his slowly softening cock. There is a little bit of further mess on Sven's crotch as some of his load drips out of your asshole and onto him - but most of his come is planted deep enough to remain in your well-bred hole. Something tells you that the sated feline doesn't mind getting a bit dirty with you, so you push yourself up from the bed eventually, leaving Sven to recover while you strut over to the pile of your clothes and get dressed.";

to say ConfidentSvenSex04:	[Blow job]
	say "     Suggesting that the studly kitty could suck your cock if he'd like, his response is a big smile and bringing his muzzle to your groin. He takes in the scent of your arousal with a soft, rumbling moan. Together, you divest yourself of any gear and bare your [cock size desc of player] shaft to the lustful feline. He nuzzles and licks at it for a while, enjoying tantalizing you while playing with your stiff manhood. Soon enough though this is not enough for the horny kitty and he slathers his tongue across your glans before taking your [cock of player] cock into his maw.";
	say "     Sven licks and sucks at your pulsing rod while bobbing his muzzle slowly over it while [if cockname of player is not listed in infections of internallist]fondling your balls[else]gripping your hips tightly[end if]. His textured tongue feels great across your sensitive flesh and a slides all over it, teasing every square millimeter of it in his desire to enjoy it to the fullest. And to make you enjoy it to the fullest as well, of course.";
	WaitLineBreak;
	say "     You rest a hand atop his head, running it through his long hair and scritching his cute ears while he works your cock over with his hot muzzle. You place the other on his shoulder and start rocking your hips a little, thrusting into the horny kitty's maw. He gives a soft moan and relaxes his throat, letting your thrust deeper.";
	if a random chance of 2 in 3 succeeds:
		say "     When you're about to blow, Sven buries his face in your crotch and sucks down hard on your pulsing shaft. You groan and grip his head and shoulder firmly as you feel the tightness at your balls just before your release. You pump shot after shot of hot, gooey cum into the hungry kitty, feeding him your [cum load size of player] load until your balls are drained. He's left smiling and panting as he cutely licks his muzzle, savoring the tasty treat you've given him.";
	else:
		say "     When you're about to blow, Sven pulls back and pumps your cock vigorously with his paw[if cock length of player > 12]s[end if]. You groan and grip his shoulder firmly as you feel the tightness at your balls just before your release. Shot after shot of hot, gooey cum is pumped from your [cock of player] meat onto the sexy feline's speckled face and into his open maw. Your [cum load size of player] load is splattered across the kitty's face[if cock width of player > 15] with plenty of extra dribbling down onto his chest[end if]. He's left smiling and panting as he cutely lickgrooms his face clean with one of his paws, clearly enjoying licking the paw clean after every wipe.";

to say ConfidentSvenSex05:	[Blow job]
	say "     Walking up to the young man as he stands before you in very confident nakedness, you slide a hand behind his head and give him a deep kiss. Sven starts a bout of tongue-wrestling by pushing his own into your mouth in friendly exploration, then wiggles it against yours while making out. When the two of you pull apart again after a few quite pleasurable moments, you tell him that you want to suck his. Sven's tail twitches with excitement and a grin spreads over his muzzle, followed by a loud purr that vibrates through his chest. Running a paw down your front and rubbing it over your crotch, he replies, 'How could I say no to an offer like that?' You enjoy his touch for a little while longer, then crouch down yourself - all the while still keeping your hands on his soft-furred body, running them down his sides and hips down to the firm thighs of the slender feline.";
	say "     Sven lets out a lusty gasp as you wrap your fingers around his shaft, stroking the hard length up and down to get it fully hard. That doesn't take long with a partner as ready and eager as him, with his cum-slit soon glistening in the shine of a first drop of pre. Beneath the now proudly standing erection, you can see those extra-plump balls of his, heavy with snowmeow semen just waiting for you. The sight - and feel, as you reach out to cup them - of Sven's virile manhood only excites you all the more. Stretching your head forward, you lick over its head, tasting the young snow-leopard's essence on your tongue. His paws move to take hold of you, applying gentle pressure towards his crotch - oh yeah, this kitty likes getting head!";
	WaitLineBreak;
	say "     Happily indulging Sven's desire, you slide your lips over his manhood and take him into your mouth, exploring the length of his shaft with your tongue. 'Oh fuck yeah, take it!' the young man grunts out in obvious pleasure, instinctively giving a few not exactly shallow thrusts of his hips. The bunker room is filled with a few gurgles and slurps as you take a moment or three to adapt to the sudden push of his long cock to the back of your throat, then start to take him more smoothly, bobbing up and down on his cock with your lips wrapped around it. Sven never lets go of your head while you suck him, sometimes using the handhold to drive his manhood all the way down your throat and grind against your face.";
	say "     Still, he never forgets that you have to breathe too, so the moments of throat-fucking aren't too long each time, with him soon pulling back and groaning words like, 'Damn that feels nice!' or 'I love your mouth!' and 'Your blow-jobs are amazing!' You simply smile around the feline cockhead still between your lips and look up at him, then get in a few needed breaths through your nose before inhaling most of his dick once more. But the snow leopard's cock isn't the only thing you take care of - with such full and heavy balls, it'd be a shame not to give them some attention. For most of the time of your fun with the exchange student, you have a hand cupping his soft-furred orbs, fondling them appreciatively.";
	WaitLineBreak;
	say "     Giving Sven a full-service blowjob, you drive the young guy to higher and higher levels of arousal while slurping on his cock. It is obvious that he can't last forever like this and before much longer Sven shows some signs of his impending orgasm - his grunts getting more urgent, a tighter grip on your head and heavier throbs of pre onto your tongue. Perfect time to give him a send-off that he won't soon forget. Pulling your lips off his cock for a second, you stick two fingers between your lips and get them really wet with saliva, then get back to sucking Sven. But at the same time, you snake your hand between his legs and grope around for his tail - and what lies beneath. Just as Sven is balls-deep in your mouth once more, his thick cock down your throat, you thrust your slickened fingers in against his pucker. They're in to their knuckles before he even knows what happened and his pucker can tighten - too late to do anything but squeeze around your invading digits.";
	say "     'What - nnghh - fuuuuccCCKKKK!' Sven shouts in surprise, then lust as you suck hard on him at the same time as rubbing the bump of his prostate. This is too much for the young exchange student to take and with an urgent grunt, he starts to come, blasting heavy throbs of snow-leopard cum straight into your stomach. His hands clench tight around your head for a few seconds, then relax far enough that you can pull a little bit and take the further trobs of seed on your tongue, tasting the creamy treat before swallowing it down. This is when the sexy kitty shows just how much he has in those big balls of his, as he keeps coming for quite a bit, filling you with a very nice load.";
	WaitLineBreak;
	say "     Eventually, when Sven's cum-shots have ebbed off and no stimulation of his prostate can milk any more out of his long cock, you pull off him with a half-full mouth of feline seed that you purposefully didn't swallow. The purring student finds himself pulled close to you as you stand up, then gets a taste of his own load in an eagerly accepted bout of making out. Sven purrs loudly in your arms as your tongues wrestle back and forth, spreading a snowball of cum and spit between the two of you. Eventually, you pull apart and quickly swallow so both of you can pant for breath. Smiling, your friend tells you, 'Wow, that was... just wow.' He purrs loudly as he gives you a tight hug, then stumbles over to the closest bed and throws himself on it to recover his energy.";

Section 4 - Svetlana

Svetlana is a woman. The description of Svetlana is "[SvetlanaDesc]".
The conversation of Svetlana is { "Mew!" }.
[uses same variables as Sven for easier saving and restoration.]

the scent of the Svetlana is "Svetlana smells of aroused female snow leopard. Lisa's scent clings to her as well.".

to say SvetlanaDesc:
	if HP of Sven < 53:
		say "ERROR-Svetlana-52L - You should not be able to find me yet.";
	if HP of Sven is 53:
		say "     Sven, or should we say Svetlana, has become a fully snowmeow person, but female as well. It seems that Lisa's influence on the kitty has made her more to the mouse's liking. Svetlana wears a red bathing suit that struggles to contain her ample bosom of six breasts. Her snow leopard marking have become pink in color, as has her much longer pink hair. Even her eyes are a bright pink. Her head is fully that of a feline's and her hands have become paws. Around her neck, she wears a pink collar with a round, silver bell on it. The snow leopard seems a little more quiet and nervous around you, though she certainly seems to be enjoying her new body. She clutches her fluffy tail and strokes it when around you. She still blushes a little at some of the toys wares, but seems eye them longingly as well, as if wondering which her murine mistress will share with her next. At these times, her paws wander over her body, tweaking a sensitive nipples or stroking over her damp crotch. To help her keep from being too overheated in the store, Lisa has taken to helping her kitty pet trim her fur. This keeps her a little cooler and shows off her feminine curves better.";
	if HP of Sven is 54:
		say "     Svetlana has become a fully female snowmeow with pink markings on her snow white fur. It seems that Lisa's influence on the kitty has made her more to the mouse's liking. Svetlana wears a red bathing suit that struggles to contain her ample bosom of six breasts. Around her neck, she wears a pink collar with a round, silver bell on it. Her feline head has a pair of bright pink eyes that look at you with admiration. Her hair is long and pink like her markings. She certainly seems to be enjoying her new body, letting her paws freely roam over it to savor her feminine form. She strokes and brushes her plush tail, purring happily, content in her new life here with her mistress. She still blushes a little at some of the toys wares, but seems eye them longingly as well, as if tallying which ones her murine mistress has yet to share with her. At these times, her paws wander over her body, tweaking a sensitive nipples or stroking over her damp crotch. To help her keep from being too overheated in the store, Lisa has taken to helping her kitty pet trim her fur. This keeps her a little cooler and shows off her feminine curves better.";

instead of conversing the Svetlana:
	if HP of Sven < 53:
		say "ERROR-Svetlana-52T - You should not be able to speak to me yet.";
	if HP of Sven is 53:
		say "     [one of]The pink snowmeow strokes her fluffy tail, purring softly.[or]'I am very grateful for bringing me to my mistress. I do not know what would have happened if you had not come along. You're so brave, strong and sexy.' She blushes and hides behind her tail after admitting that aloud.[or]'I want to thank you for bringing me here. It was a little overwhelming at the start, but I'm so happy here now.' She fidgets nervously and clutches her tail between her breasts. 'I... I'd really like to show you how much I appreciate it sometime,' she says softly, her voice trailing off as she blushes brighter and brighter at her ears.[or]'I never thought it would be so hot in this country when I accepted the scholarship. I'm glad my mistress has so much milk for her kitty.'[or]'How long do you think we will have together here before someone comes to rescue us?'[or]'Do you think they will let stay this way? My body feels so much nicer now.'[or]Svetlana fidgets with her fluffy tail while you speak to her. She doesn't seem to pay much attention, her eyes having fallen on a large dildo on display. You spot her subconsciously slip a paw to her crotch, fingering her covered pussy and getting herself damp again down there.[or]Svetlana looks at you with admiration and longing as you chat with her for a bit.[or]Svetlana licks her lips and mumbles something about being thirsty while eying your crotch. She then notices what she's said and blushes behind her fluffy tail before rushing to the back to get another drink from Lisa's supplies.[or]Lisa stretches as she washes the store's windows, giving you a fine view of her tight ass.[or]'I really want to repay you for your help somehow. I guess I could... maybe...' She fidgets nervously and presses her tail into her lap as her voice trails off.[or]'What do you think of the new me? I... I hope you like it.'[or]'Mistress Lisa found this lovely collar for me,' she purrs, flicking the bell to hear it ring.[in random order]";
	if HP of Sven is 54:
		say "     [one of]The pink snowmeow strokes her fluffy tail, purring softly.[or]'I am very grateful for bringing me to my mistress. I do not know what would have happened if you had not come along. You're so brave, strong and sexy.' She blushes and hides behind her tail after admitting that aloud.[or]'I want to thank you for helping me get here. I hope you'll let me show you how much I appreciate it again soon,' she says softly while stroking a finger over her damp crotch, remembering her fun with you earlier.[or]'I never thought it would be so hot in this country when I accepted the scholarship. I'm glad my mistress has so much milk for her kitty.'[or]'How long do you think we will have together here before someone comes to rescue us?'[or]'Do you think they will let stay this way? My body feels so much nicer now.'[or]Svetlana fidgets with her fluffy tail while you speak to her. She doesn't seem to pay much attention, her eyes having fallen on a large dildo on display. You spot her subconsciously slip a paw to her crotch, fingering her covered pussy and getting herself damp again down there.[or]Svetlana looks at you with admiration and longing as you chat with her for a bit.[or]Svetlana licks her lips and comments about how she's starting to feel thirsty while eying your crotch. She gives you a little wink, then playfully hides behind her tail.[or]Svetlana takes a seat on a soft mat Lisa's put out for her. She stretches her feline body and starts licking and grooming her fluffy fur, smiling shyly at you as she does. Her flexible body lets her lick herself all over, giving you a good view of her legs, thighs, ass and more. Knowing you're watching, she blushes but makes a show of it, taking long, slow licks while showing off her body in her skimpy swimsuit.[or]Svetlana flips through the DVD collection, looking for one to watch with her mistress later.[or]'I really hope you'll let me [']repay['] you again soon,' she purrs with a wink before hiding behind her tail.[or]'Mistress Lisa found this lovely collar for me,' she purrs, flicking the bell to hear it ring.[or]Svetlana snuggles up beside you, stroking your side lightly. 'I'm so glad that you like the new me. I... I hope you'll play with me again soon.'[in random order]";


the fuckscene of Svetlana is "[SexWithSvetlana]".

to say SexWithSvetlana:
	if HP of Sven < 53:
		say "ERROR-Svetlana-52F - You should not be able to fuck me yet.";
	if HP of Sven is 53:
		now HP of Sven is 54;
		now lastfuck of Sven is turns;
		increase score by 50;
		say "     Svetlana blushes at her ears as you bring up having sex with her. The newly feminine snowmeow smiles and takes your hand in her paws, and with a little grin to her mistress, practically pulls you off into the back room. Once there, she wraps her arms around you, purring happily and nuzzling your cheek. 'Oh, I was so worried you wouldn't like the new me. But my lovely mistress knew you would. I... I made her promise to let you use me whenever you like if I became her pet.' She licks and nibbles along your neck, running her paws across your sides, guiding you over to a large pile of pillows.";
		WaitLineBreak;
		if cocks of player > 0:
			say "     After divesting yourselves of clothes, the sexy snowmeow slowly slides a paw between your legs, tentatively touching your [if cocks of player > 1]cocks[else]cock[end if] before wrapping her paw around your throbbing meat. 'Mmm... I... my mistress has so many lovely toys, but... I...' she trails off, still stroking it as she sinks to her knees and starts nuzzling and licking it. Guessing her meaning, you smile down at the eager kitty and scritch her ears as she takes it into her muzzle. 'You want to try the real thing, don't you kitty?' She moans an uh-huh and nods as she bobs his muzzle over your cock.";
			WaitLineBreak;
			say "     She licks and sucks your cock, running her raspy tongue over it. She is a little clumsy at the start, but it seems she's been practicing with the toys and soon gets a rhythm that has you throbbing and leaking pre on her tongue[if cunts of player > 0]. While working her muzzle over your cock, she slips a paw to rub your balls and the other back further to your wet pussy. She caresses and strokes those sensitive folds, here showing quite a bit of skill from Lisa's experienced training[else]. While working her muzzle over your cock, she slips a paw to rub your balls as if longing for the creamy seed they hold[end if]. When you can feel that pressure in your balls aching to drain, you ease her off your cock, wanting to save it for the main event.";
			WaitLineBreak;
			say "     Getting the sexy feline to stretch out on the pillows, you climb atop her. She wraps her arms around you, licking and kissing at your face, squirming in anticipation. 'Mistress has me on my pills. She says kittens in the store would be too much trouble right now.' She blushes cutely and looks away. 'So you... you can... please... Fuck me! I need you in me so bad. Give the kitty your cum. Fill me with it,' she moans aloud as her wanton desires come rushing out. She releases such a delicious mrowl of pleasure as you sink your cock into her wet pussy[if cock length of player > 23]. With your penis so massive, you take it slow, letting the kitty stretch to accommodate you, but does seem to do so much more easily than most can, much to your pleasure. Her normally taut tummy stretches around your throbbing rod and she rubs over it, mewling happily at being so well filled by you[else if cock length of player > 12]. Her cunt stretches to accommodate your large penis, but does so relatively easily, her tummy swelling with the bulge caused by your hefty meat[else]. Her cunt takes your penis in easily, but still grips around it quite firmly, taking your full length into her eager body[end if][if cocks of player > 1]. As you are mounting her, your second cock bumps against the feline's tail-hole and she mews and blushes, nodding quickly. With a grin at the wanton need in her gaze, you press it into her back door, fucking both holes at once[end if]. She mewls and moans about how good it feels, how much she's wanted this, wanted you.";
			WaitLineBreak;
			say "     As you pound into her, she [if breast size of player is 0]runs her paws along your sides, squeezing your ass each time you drive your meat into her[else]moves her paws up to your breasts, caressing them while she plays with your nipples. Another thing she would have practiced with Lisa, she's quite adept at making you moan as she runs her paws over your tits[end if]. Her six breasts sway with each hard thrust you make into her beautiful body. Already quite excited from the blow job, you drive your [if cocks of player > 1]cocks[else]cock[end if] into her again and again, loving the sound of her lustful moans and mewls as she purrs up a storm. Sensing your climax coming, she wraps her slender legs around you and pulls you deep inside her, taking your full cock as she climaxes, soaking your crotch in her juices moments before your release[if cock length of player > 23]. With the whole of your giant cock inside her, the bulge in her tummy is quite huge and gets larger as you begin to release your hot seed[end if][if cock width of player > 10]. Your thick cum blasts into her again and again, filling her womb and bloating her belly, much to her delight[else if cock width of player > 5]. Your thick cum blasts into her again and again, flowing up into her womb and filling it completely with your semen, much to her delight[else]. Your thick cum blasts into her again and again, flowing up into her womb, much to her delight[end if][if cocks of player > 1]. You send a similar load into her ass, pumping your cream into her bowels. She smiles up at you, purring like the happy kitty she is and moans 'My hero' softly before drifting off into blissful slumber in your arms.";
		else:
			say "     After divesting yourselves of clothes, the sexy snowmeow slowly slides a paw between your legs to touch your [if cunts of player > 1]pussies[else]pussy[end if]. 'Mmm... my mistress has been teaching me so many wonderful things... so many ways to please the lovely body she's given me. I can't wait to share them with you,' she purrs as she drops to her knees and starts licking at your pussy. Her tongue is quite practiced and very enjoyable, even with only her short tutelage by Lisa. Her fingers and tongue seek out many sensitive spots before she [if cunt width of player > 5]slides a pair of fingers, then a third, and then her whole paw into your wide pussy. Again and again she stuffs you nicely with the soft touch of her fur over the firm, full feeling of her paw pounding into you. You groan again, louder, at the pleasure of it filling you along with the licking and sucking from the eager snowmeow[else if cunt width of player > 2]. She inserts a second finger into you and then a third into your ample pussy. Again and again, she stuffs you nicely with the soft touch of her fur over the firm, full feeling of her fingers stroking inside you. You groan again, louder, at the pleasure of them filling you along with the licking and sucking from the eager snowmeow[else]. She inserts a second finger into your wet pussy. Again and again, she stuffs you nicely with the soft touch of her fur over the firm, full feeling of her fingers stroking inside you. You groan again, louder, at the pleasure of them filling you along with the licking and sucking from the eager snowmeow[end if]. As her paw and muzzle work at your pussy, lapping up your juices, she busily fingers her own snatch while releasing muffled mewls of pleasure. When your climax comes, she goes off as well, soaking her thighs in her juices while drinking down your sweet waters.";
			WaitLineBreak;
			say "     Sinking down onto the cushions, she snuggles with you as you both recover a little from your powerful orgasms. She licks and kisses you, purring happily, for quite some time before nuzzling down to your bosom. The sexy feline runs her raspy tongue over your nipples before starting to suckle at them. Another thing that Lisa's shown the once inexperienced feline, her attention to your breasts is quite pleasurable, soon getting you excited and ready for more fun.";
			WaitLineBreak;
			say "     And it seems Svetlana's ready as well, sending a paw fishing under the pillows and pulling out a long, purple toy with a grin. Lining up the double-ended dildo with your soaked pussy, she slowly starts to feed it into you. She pumps it in and out with one paw while the other teases your folds after having guided it in. After about a dozen strokes, you moan softly in disappointment as she withdraws the toy from you. She turns it around and blushes a little at her ears as she sinks the end that was in you moments before into her own wet snatch. Guiding the other end into you now, she rides in your lap, moaning and mewling lustfully. The toy feels quite good inside you, sliding around inside you to stimulate your sensitive vaginal walls as the kitty pumps herself over her end. Eventually, you both are driven over the edge again, cumming even harder than before. Nuzzling herself atop you, the kitty purrs happily and rests her head against your bosom as she moans 'My hero' softly before drifting off into blissful slumber in your arms. ";
	else if HP of Sven is 54 and lastfuck of Sven - turns < 8:
		say "     Svetlana smiles and blushes coyly from behind her tail. 'I'd love to spend time with you again,' she purrs softly, 'but I need to help around the store for a bit. But do come by again soon. I'd love to thank you again for all your help,' she adds with a grin.";
	else if HP of Sven is 54:
		say "     Svetlana smiles as you come over and suggest a little time in the back room. She glances over to her mistress ";
		if lastfuck of Lisa - turns > 11 and mousefucked > 0:
			say "who grins and runs her paws along her sides. 'Perhaps we should share my little pet this time,' he says softly, running a paw over the kitty's ass, making her mewl and squirm.";
			say "     [bold type]'How about it? Shall we share her?'[roman type][line break]";
			LineBreak;
			say "     ([link]Y[as]y[end link]) - Yes.";
			say "     ([link]N[as]n[end link]) - No.";
			if the player consents:
				LineBreak;
				say "[SvetlanaTrio]";
			else:
				LineBreak;
				say "     You smile and pat Lisa's hand before sliding it aside so you can grope Svetlana's tight bottom yourself. You tell her that you'd like the kitty all to yourself this time. The mousetaur smiles and kisses her pet, telling her to have a good time before letting you both head into the back. She seems fine with it, but perhaps it would be fun to make it up to her later.";
				say "[SoloSvetlana]";
		else:
			say "who grins and nods, waving you both to head on in. As her pet walks past, Lisa does give her a little swat on the rump, making her mewl cutely. 'You two have fun in there.'";
			WaitLineBreak;
			say "[SoloSvetlana]";

to say SoloSvetlana:
	if cocks of player > 0:
		if level of Sven is even:
			say "     Svetlana purrs and nuzzles at your neck, licking and nibbling as you run your hands across her body, sliding down her swimsuit. Uncovering her ample bosom, you stroke her breasts, teasing her nipples until she mewls with need. You then drift a hand down to her pussy and start fingering her, teasing her wet folds before sliding a pair into her. Her hips tremble and her pussy quivers around your fingers as she slides a paw to your cock and strokes it. 'Mmm... please...' she moans as she runs her soft paw over your erection.";
			WaitLineBreak;
			say "     You ease her down onto the pillows, spreading her legs. As you get lined up, you lick her juices slowly off your fingers, enjoying the taste of the lustful snowmeow. She mrowls in delight as you give her something her mistress can't, a real, live cock filling her[if cocks of player > 1]. With a second cock, you probe at her back door, then start sliding into that tight passage when she blushes and nods[end if][if cock length of player > 23]. With your penis so massive, you take it nice and slow, stretching out her belly as you stuff your huge cock into her. She rubs over the bulge, loving the feel of your massive meat stuffed inside her[else if cock length of player > 12]. Her cunt stretches to accommodate your big penis, but does so relatively easily. Her tummy bulges a bit with your hefty meat inside her[else]. Her cunt takes your penis in easily, but still grips and squeezes around you quite firmly, taking your full length into her eager body[end if]. She arches her back and wriggles in pleasure on the mound of soft pillows as you fuck her good and hard.";
			WaitLineBreak;
			say "     As you pound into her, she [if breast size of player is 0]runs her paws along your sides, squeezing your ass each time you drive your meat into her[else]moves her paws up to your breasts, caressing them while she plays with your nipples. Another thing she would have practiced with Lisa, she's quite adept at making you moan as she runs her paws over your tits[end if]. Her six breasts sway with each hard thrust you make into her beautiful body. Already quite excited from the blow job, you drive your [if cocks of player > 1]cocks[else]cock[end if] into her again and again, loving the sound of her lustful moans and mewls as she purrs up a storm. Sensing your climax coming, she wraps her slender legs around you and pulls you deep inside her, taking your full cock as she climaxes, soaking your crotch in her juices moments before your release[if cock length of player > 23]. With the whole of your giant cock inside her, the bulge in her tummy is quite huge and gets larger as you begin to release your hot seed[end if][if cock width of player > 10]. Your thick cum blasts into her again and again, filling her womb and bloating her belly, much to her delight[else if cock width of player > 5]. Your thick cum blasts into her again and again, flowing up into her womb and filling it completely with your semen, much to her delight[else]. Your thick cum blasts into her again and again, flowing up into her womb, much to her delight[end if][if cocks of player > 1]. You send a similar load into her ass, pumping your cream into her bowels. She smiles up at you, purring like the happy kitty she is and moans 'My hero' softly before drifting off into blissful slumber in your arms.";
		else:
			say "     Svetlana purrs and nuzzles at your neck, licking and nibbling as you run your hands across her body, sliding down her swimsuit. Uncovering her ample bosom, you stroke her breasts, teasing her nipples until she mewls with need. As your hand drifts down to her pussy, she drops to her knees and starts nuzzling and licking at your crotch, lavishing attention on your cock. You put your hand to her head and start stroking it, rubbing her ears, making her purr. She runs her raspy tongue all over [if cocks of player > 1]them[else]it[end if], licking every square centimeter from your tip, along your shaft, to the base, to your balls[if cunts of player > 1], to your pussies[else if cunts of player is 1], to your pussy[end if] and back to your asshole.";
			WaitLineBreak;
			say "     The sexy snowmeow moves away after a final kiss to your glans and stretches out on the pillow mound, guiding your cock to her muzzle and spreading her legs so you can return the favor to her. She takes your cock into her mouth slowly, letting her tongue play across it as it slides past her lips. You moan in pleasure and bury your face between her thighs, licking at her honey pot. Her juicy puss is very wet for you, her hero, and has a rich and arousing taste. You slip a pair of fingers into her to tease her clit while you lick at it[if cock length of player > 23]. You rock your hips, gently at first, but always insistently as you sink more and more of your cock into her muzzle and down her throat until it stuffs her belly. She always seems able to take more and sucks thirstily upon it while kneading your balls[else if cock length of player > 12]. You rock your hips, gently at first, but always pressing more of your long cock into her muzzle and down her throat until it's fully stuffed inside her. She always seems able to take more and sucks thirstily upon it while kneading your balls[else]. You rock your hips, gently at first, but always pressing more of your cock into her muzzle. She takes it all in and sucks thirstily upon it while kneading your balls[end if][if cocks of player > 2]. Your other cocks rest between her ample breasts, cradled by the warm, furry globes and sliding between them as you thrust into her muzzle[else if cocks of player is 2]. Your other cock rests between her ample breasts, cradled by the warm, furry globes and sliding between them as you thrust into her muzzle[end if][if cunts of player > 0]. Her fingers wander back briefly to tease your wet folds and thrust a pair of fingers into you, but remain largely focused on your balls, quite intent on draining them for the thirsty kitty[end if].";
			WaitLineBreak;
			say "     You pump your cock into her eager muzzle while trading your fingers for your tongue, lapping up her juices and wriggling against any sensitive spot you can find. As you feel your climax approaching, you swap your tongue for a trio of fingers, pounding them away into her dripping puss. She makes such delightful[if cock length of player > 23], if greatly muffled,[else if cock length of player > 12], if rather muffled,[else], if somewhat muffled,[end if] mewls as you do this. You pump your throbbing meat into her harder and faster as she pulls at your hip and gently squeezes your balls. When your climax comes, you blast [if cock width of player > 10]your massive load into her, causing her belly to swell from the volume of your output[else if cock width of player > 5]your thick cum down her throat, filling her tummy with your warm seed[else]your warm seed down her throat[end if]. She has a powerful orgasm, gushing feline juices across your hand and face as she cums long and hard. As your orgasms subside, you lick one another clean before she snuggles up in the arms of her brave hero.";
	else:
		if level of Sven is even:
			say "     Svetlana purrs and nuzzles at your neck, licking and nibbling as you run your hands across her body, sliding down her swimsuit. Uncovering her ample bosom, you stroke her breasts, teasing her nipples until she mewls with need. As your hand drifts down to her pussy, she drops to her knees and starts nuzzling and licking at your crotch, lavishing attention on your wet folds. You put your hand to her head and start stroking it, rubbing her ears, making her purr. She runs her raspy tongue over [if cunts of player > 1]them[else]it[end if], licking your sensitive folds before diving in. She presses her muzzle between your legs and sends her raspy tongue deep inside you, teasing your inner walls and lapping up your juices.";
			WaitLineBreak;
			say "     Having gotten a good taste of your juices, she moves back and lays down on the cushion pile, motioning for you to join her. In a sensual sixty-nine, she puts her head between your thighs and gets back to lapping at your [if cunts of player > 1]pussies[else]pussy[end if] while you do the same for her. You nibble along her pussy lips and run your tongue across them before teasing her clit and diving in. With her training from the mousetaur, the pink kitty uses her rough tongue deftly, sending quivers of delight through your body as she licks you[if cunts of player > 2]. She sends a paw back to tease your other pussies, alternating a pair of fingers into each of them[else if cunts of player is 2]. She sends a paw back to tease your other pussy, pumping a pair of fingers into it[end if]. Not to be outdone, you push a pair of fingers into her snatch and pump quickly, grinning as you get a mewl as you withdraw them suddenly. When you place these wet digits at her tail-hole, she moans softly and wriggles in pleasure as you sink them into that tight hole. You finger, stroke, lick and tease one another like this through several orgasms until finally you both have a crashing series of climaxes that leave you panting and moaning softly. Svetlana purrs contentedly as she snuggles herself into your arms and drifts off to sleep with her beloved heroine.";
		else:
			say "     Svetlana purrs and nuzzles at your neck, licking and nibbling as you run your hands across her body, sliding down her swimsuit. Uncovering her ample bosom, you stroke her breasts, teasing her nipples until she mewls with need. You then drift a hand down to her pussy and start fingering her, teasing her wet folds before sliding a pair into her. Her hips tremble and her pussy quivers around your fingers as she slips a paw to your wet folds and strokes them. 'Mmm...' she moans as she kisses you.";
			WaitLineBreak;
			say "     Releasing you, she gets onto all fours on the pillows and waves her rump at you. With her pink tail held high, you can see her dripping puss and pink tail-star ready and waiting. You move behind her and rub your hands over his tight, feline bottom as she fishes under the cushions and pulls out another toy. This one is a strap-on with one dildo for the wearer, but a pair going forward. She blushes a little as she starts putting it on you, sinking that toy into your wet puss. 'This one doesn't quite fit right on my mistress, so she can't use it on me, but it should... There!' she exclaims happily once she gets it properly fitted on (and in) you.";
			WaitLineBreak;
			say "     As you run your hands over the two false phalli attached to it, Svetlana blushes a little and hides behind her tail, quietly turning around and offering her bottom to you. You grin and get the toys lined up, and with a little lube added to the top one, start sinking them into her pussy and tail-hole. She mrowls in delight, kneading at the pillows as you plow into her again and again. Noticing her swaying tits, you put a hand on them and start tweaking her nipples, making her mewl softly each time. While you can't directly feel her quivering pussy and squeezing tail-hole, her spasms of delight travel up the firm core of the toys to make the one in you shift and move.";
			WaitLineBreak;
			say "     As your excitement builds, you sit up and grip her ass, pounding into her harder. Taking notice of a small button on the side of the strap-ons pad, you press it, turning on the vibrator in the anal toy, making the kitty beneath you yowl in delight. These vibrations are echoed in the other dildos, stimulating both pussies as well. With this added stimulation, Svetlana doesn't last much longer and soon has a powerful series of orgasms, lustfully loud and you soon follow with a series of your own. When you both come down from this, you lower yourself down onto the pillows and snuggle with her, keeping the strap-on stuffed inside her, letting the vibrator hum away as she drifts off to sleep in her brave heroine's arms.";
	increase level of Sven by 1;
	now lastfuck of Sven is turns;


to say SvetlanaTrio:
	if cocks of player > 0:
		say "     Once in the back room, you run your hands over Svetlana's body, slipping her swimsuit off to uncover her ample bosom. Fondling her breasts, you suck at her nipples, making her mewl while she and Lisa help you get undressed. Lisa runs her paws over [if cunts of player > 0]you both[else]her pet[end if] and guides you to lay back on the pillows. The snow leopard runs her paws over your [if cocks of player > 1]cocks[else]cock[end if] and straddles you with her back to you[if cock length of player > 23 and cocks of player > 1]. Lisa helps guide one of your massive cocks into her pink pet's pussy and another into her tight ass. Svetlana moans and pants as your giant penises stretches her belly out considerably to fit them[else if cock length of player > 23]. Lisa helps guide your massive cock into her pink pet's, who moans and pants as your giant penis stretches her belly out to fit it[else if cock length of player > 12 and cocks of player > 1]. Lisa helps guide one of your large cocks into her pink pet's pussy and another into her tight all. Svetlana moans and pants as your big penises are stuffed into her, filling her so much there is a noticeable bulge[else if cock length of player > 12]. Lisa helps guide your large cock into her pink pet. Svetlana moans and pants as your big penis is stuffed into her, forming a small bulge in her tummy[else if cocks of player > 1]. Lisa strokes her pink pet's hips and kisses at your belly as the kitty sinks down onto your cocks, taking one into her wet pussy and another into her tight tail-hole with a satisfied moan[else]. Lisa strokes her pink pet's hips and kisses at your belly as the kitty sinks down onto your cock, taking it into her wet pussy with a satisfied moan[end if]. She works herself down your [if cocks of player > 1]cocks[else]cock[end if] gradually, leaning back as she does until she's resting her back on you.";
		WaitLineBreak;
		say "     You rock your hips and thrust into her softly while the mousetaur moves atop you both, offering her lovely bosom to the pink kitty. As Svetlana switches from one nipple to the next, you spot some dribbles of milk leaking out from the released nipple, showing that the kitty's nursing for her mistress's mouse milk. Excited by the sight of the feeding kitty, you buck harder, pounding your cocks into the mewling kitty. You keep a firm grip on her ass with one hand and keep your other arm around her waist for support.";
		WaitLineBreak;
		say "     When she's done feeding her thirsty pet, Lisa turns around and brings her ample pussy over the kitty, who dives in and licks at it eagerly. You nibble on the kitty's ear and watch her slip two, then three fingers into that dripping cunt, teasing and stroking it with the skill of someone quite familiar with pleasing her mistress's every pleasure point. You can feel Lisa rubbing one of your paws at her pet's stuffed pussy as her digits brush around your cock, but focus on pleasing her kitty in return. Unsurprisingly given the amount of stimulation she's receiving, Svetlana is driven to a crashing series of orgasms first, writhing in lustful pleasure atop your [if cocks of player > 1]cocks[else]cock[end if]. This is more than you can take and you go off next, blasting your hot seed deep into her cunt[if cocks of player > 1] and bowels[end if][if cock width of player > 10], making her belly bulge with your voluminous output of thick cum[else if cock width of player > 5], stuffing her womb full of your thick cum[end if]. Lisa is the last to finish, cumming so hard from Svetlana's well-trained ministrations that she squirts out her female juices across her pet's face and even gets some onto yours, so you can get a taste of them as well. You all snuggle up together on the pillows, resting together to recover after your sexy threesome. Svetlana purrs happily in the arms of her two lovers: her loving mistress and her brave hero.";
	else:
		say "     Once in the back room, you run your hands over Svetlana's body, slipping her swimsuit off to uncover her ample bosom. Fondling her breasts, you suck at her nipples, making her mewl while she and Lisa help you get undressed. Lisa runs her paws over [if cunts of player > 0]you both[else]her pet[end if] and guides you to lay back on the pillows. The snow leopard runs her paws over your breasts, caressing them as she teases your nipples until they're hard. She and the mousetaur each take a breast and start sucking at your nipples while their paws roam your body, seeking to please their sexy, female friend[if cunts of player > 1]. You feel paws at your pussies as they each finger you, diving their furry digits into your wet cunts over and over again[else if a random chance of 1 in 2 succeeds]. You feel a paw, probably Lisa's, at your pussy. The playful mouse strokes and teases at your wet folds, tweaking your clit and pushing you to a quick orgasm[else]. You feel a paw, probably Svetlana's, at your pussy. The playful kitty slips a pair of fingers into your wet cunt over and over again, hard and fast, as she pushes you to a quick orgasm[end if].";
		WaitLineBreak;
		say "     As you bask in the afterglow, Lisa pounces atop her pet, burying her in her bosom and getting the kitty to suckle her tits. You moan and tease your over-sensitive puss as you watch the thirsty kitty nursing, suckling out her mistress's mouse milk. You move around behind them and start licking at their pussies, which they've been grinding against one another, lapping up their mixed juices from them. You dive several fingers into them, switching from one pussy to the next until they both cum hard. Then it's you on your back in the pillow mound while they both eat you out. They playfully take turns, pacing themselves until you have a wild, crashing orgasm that leaves you dizzy. You all snuggle up together on the pillows, resting together to recover after your sexy threesome. Svetlana purrs happily in the arms of her two lovers: her loving mistress and her brave heroine.";
	increase level of Sven by 1;
	now lastfuck of Lisa is turns;
	now lastfuck of Sven is turns;


[	HP of Sven				]
[	0-3: At home			]
[ 4 - 29: Pet Sven			]
[	4: At Bunker			]
[	5: Sex once				]
[	6: Pet, no collar		]
[	7: Pet, collar obtained	]
[	8: Pet, collar worn		]
[	9: Pet transition		]
[	10: Plays w/Candy		]
[ 30 - 49: Confident Sven	]
[	30: At Bunker			]
[	31: Spoke w/player		]
[	32: Sex w/player		]
[ 50 - 98: TG Sven			]
[	50: At Porn Store		]
[	51: Settling in			]
[	52: Transition			]
[	53: Svetlana			]
[	54: Sexed up Svetlana	]
[	99: Taken				]
[	100: Lost in city		]

[	Lust of Sven	]
[	0: Normal		]
[	1: Baby Blue	]
[	2: WS-Gold		]
[	3: Pink			]


Section 5 - Endings

when play ends:
	[Sven special cases]
	if Sven is in the bunker and HP of Sven < 30 and bodyname of player is not "Snow Leopard" and bodyname of player is not "Siamese Cat" and bodyname is not "Snow Bat":
		if humanity of player < 10:
			if ( bodyname of player is "Pantherherm" and angiearoused is 3 ) or ( felinoid companion is tamed and bodyname of player is "Felinoid" ) or bodyname of player is "Rubber tigress" or bodyname of player is "Plush Lion":
				increase score by 0; [blank - Special Sven succumb endings as per species of player]
			else if HP of Sven > 3 and HP of Sven < 8:
				say "     When you succumb to your infection, Sven's loyalty to you makes him waver, but he manages to make his escape from the bunker, running off into the city. What rational thought you have left doesn't think much of his chances and expect he'll end up in the arms of a lustful snow leopard or taken as a fuck-toy by one of the many other creatures out there.";
			else if HP of Sven < 7 and HP of Sven < 30:		[Sven the fuck-toy]
				say "     Being the loving and adoring pet that he is, Sven accompanies you after you succumb to your infection. You play lustfully with him often and his humanity fades away more and more, becoming your lustful and loyal servant in your future endeavors. Bound to you, he remains loyally with you, fulfilling your sexual needs as best he can between any other lovers or mates you may have. Having grown attached to your sexy snow leopard, you are always careful not to fuck him so much that he ends up transforming. Despite your instinctual urges, you find his [if HP of Sven is 10]colorful [end if]snow leopard body beautiful and take care to preserve it... a courtesy you don't extend to others you may find.";
		else:
			if HP of Sven < 8:	[Sven not pet]
				say "     After an uncomfortable period in military holding area, Sven is released with you and the others. The hot and muggy compound provided few chances for relief for the overheated kitty. He spends some recovery time with you before eventually moving back to Europe. He maintains correspondence with you [if Candy is in the bunker]and Candy [end if]and seems to be enjoying his new, partially feline body and his new life. Coming from a well-to-do family, he has few financial worries and instead travels around Northern Europe, enjoying his increased love for the majestic beauty of his native lands[if Candy is in the bunker]. Coming across a letter to Candy that was left out, you do see that the coon's been encouraging him to enjoy his new body to the fullest and this letter includes a rather detailed account of the kitty's encounter with a group of sexy skiers[end if]. When you start to hear of groups of snow leopards popping up across Scandinavia, you aren't surprised and suspect that the snow leopard's anti-infection treatment didn't hold well under the snowy climate. You wish him and his feline lovers well.";
			else if HP of Sven > 7 and HP of Sven < 30:		[Sven the fuck-toy]
				say "     After an uncomfortable period in military holding area, Sven is released with you and the others. The hot and muggy compound provided few chances for relief for the overheated kitty. You bring him along with you into your new life and help him to recover through long, lustful sessions of lovemaking to satisfy his un-quenched thirst for sexual fluids. Sven becomes a wonderful pet, always eager to satisfy your lusts and any kinky desire you have. The beautiful kitty lounges around your home naked, shyly teasing from behind his tail. His coy playfulness always draws the attention of your visitors, making him a wonderful means to coax them into a three-way. When you become acquainted with a zookeeper, Sven has them playing with him after only a few visits, and after that, you're slipping your pet into the zoo to play with the big cats there. You enjoy watching your pet mount the females and be taken by the males. You even paid for using Sven as a stud on their female snow leopards, though the kitty always seems to be looking forward to having a strong male atop him.";
			if HP of Sven is 10:							[Addition for Sven and Candy]
				say "     Candy visits often, having grown quite fond of the sexy snowmeow during their shared time in the infected city. While the pink coonboi has his own lovers now, he always has time for your special kitty. Whenever business or other obligations take you away from him, you happily leave Sven with Candy, safe in the knowledge that he'll be cared for and have a good time with the girly coon. And you always enjoy listening to Sven shyly tell you every sordid detail of his visit and how the coon and his myriad lovers made use of your sexy pet's body. These seem to get more elaborate and involved as time goes on, as the coon makes bigger and bigger plans to celebrate the kitty's visit with lustful orgies centered around the exotically colorful snowmeow.";
	[other Sven the fuck-toy pet interactions]
	if Sven is in the bunker and HP of Sven < 30 and bodyname of player is not "Siamese Cat":	[Siamese union w/Sven blocks these]
		if humanity of player < 10:
			increase score by 0; [Interactions while succumbed, if any, would go here]
		else:
			if HP of Sven > 7:								[Other Sven interactions]
				if SarahSlut is 4:			[Sarah pet]
					say "     Sven and Sarah don't get along well, at odds as cats and dogs often are. Initially, when you're just starting to get settled in, they are quite irritating, as there is little space for them to avoid one another. You start to worry that won't be able to get them to reconcile and will have to take some drastic measures. Not wanting to lose either of them, you fret over it for quite some time.";
					say "     And then one night, one of Sarah's anthro pups snuggles up with the sleeping kitty in his plush, over-sized cat bed. The two become almost inseparable, the cute puppy girl following the kitty around the house and sleeping beside him every night. Sven and Sarah's become less irritated with each other and are soon friends, if never lovers. In time, when little Anja grows up into a mature, sexy husky girl, her relationship with Sven changes and they become lovers as well. Anja bears numerous litters of hybrid pups and kittens, all of whom make wonderfully submissive and lustful pets for any form of play. The husky-patterned kitties and snowmeow-spotted doggies are very popular and add to your kennel's offered love pets.";
				if ColeenCollared is 1:			[Coleen pet]
					say "     During her time with you, Sven is also at odds with Coleen, though she does give him a slightly different look when he's not watching than Sarah does. You are a little more hopeful they'll be able to bridge the gap before she goes, but it doesn't look like it's going to happen. But then, the night before you're to have the general visit, you hear a commotion and rush to Sven's cat bed. There you find Coleen having pinned the kitty down and riding his feline cock eagerly. The snowmeow mrowls in delight and you can smell his arousal, as well as the beginning of the husky's heat. It seems she decided to take this last chance to sate her lusts with him despite their rocky relationship. With her more aggressive nature and military training, she would easily be able to pin your kitty pet and be bred by him. They go at it all night long, ensuring the general will be quite surprised by her litter of husky-snowmeow hybrid pups in a few months.";
				if Sandra is in the bunker:		[Sandra rescued]
					say "     You come home one day to find Sandra the bunny girl spread out on your couch with Sven pounding away eagerly at her pussy. From the look, and smell, of things, they'd been going at it for quite a while. The rabbit, having come over to visit you while in heat and wanting to share her lustful need with you, arrived while you were out. Despite their somewhat shy, timid natures, they soon gave in to their arousal and had a long, lustful breeding session leaving her bloated with snow leopard cum. Her swollen tummy doesn't go away completely, growing into hybrid cabbits in her sated womb. They are lovely pair of white bunnies girls with long snowmeow tails and markings. The twins, despite their timid, quiet natures, always seem to get themselves pulled into wild, erotic escapades.";
				if pink raccoon is tamed:		[pink raccoon pet]
					say "     Your coon pet gets along well with Sven, snuggling up to him often and after some initial trepidation on the kitty's part, gets them to have sex together. The beautiful snowmeow becomes the pink coonboi's preferred lover, after yourself, loving the feel of the kitty's big cock in him or filling the snow leopard's ass with his sweet-scented seed. The girly raccoon spends hours doting over your kitty, scritching, brushing and petting him, attention that your pretty pet enjoys so much and always rewards the coon by another romp to satisfy their lusts for cock.";
				if felinoid companion is tamed and hermaphrodite is not banned:	[felinoid companion w/o herm blocked]
					say "     Sven soon draws the attention of Klauz, who nuzzles and snuggles up with the other feline. Over the next few days, they grow closer and closer, spending more time nuzzling and grooming one another. On the evening of the third day, you come home to find the feral feline mounted atop Sven, pounding away at him. Glad they're getting along so well, you take a seat to watch the show, but soon realize that things are not quite as they were. Growing breasts sway from Sven's chest and the felinoid is driving his cock into your snow leopard's new, virgin pussy. Their mating is repeated several times, until Sven, now a sexy snowmeow herm, is well bred and filled with kittens. She bears him many litters of [if HP of Sven is 10]colorful [end if]snow leopard kittens and is fucked often, used to slake his lusts between the new play-toys you lure home for him to enjoy.";

Sven ends here.
