Version 2 of Zigor by Stripes begins here.
[Version 2.3.1 - Finale repeat variation]
"Adds a Leather Wolf NPC named Zigor to the Flexible Survival game."

Section 0 - Event	[Transposed from Red Events]

Leather Wolves is a situation.
The sarea of Leather Wolves is "Red".
when play begins:
	add Leather Wolves to badspots of girl;
	add Leather Wolves to badspots of guy;
	add Leather Wolves to badspots of furry;

Instead of resolving a Leather Wolves:
	say "     Some noise up ahead attracts your attention and you creep closer. Hunkering down behind a pair of cars, you look at the small pack of wolfmen gathered in front of a leather store. At some point, several of the mannequins have been stripped of their outfits and the wolves seem to be wearing them. Somehow their leather gear is shaped to cover large parts of their lupine faces and transformed bodies. A pair of them are indulging in sex on the leather harness they've hung from a building-side flagpole. Others are stroking themselves off or fingering their pussies while they watch. As you study the pack more closely, you come to realize that they are not merely wearing the leather, but that it is part of them at the same time.";
	say "     While you might want to check out the leather goods store you've found, there's a bit too much activity here right now. Perhaps you'll be able to check it out later once the wolves are done having their fun. You make note of the place and consider stopping by again in the future.";
	say "     (Now [bold type]Cuero Lobo[roman type] is known.)[line break]";
	now Cuero Lobo is known;
	increase score by 10;
[	say "     With this pack established here, there's clearly no safe way to search the immediate area further and you quietly backtrack.";
	increase score by 1;]
	Now Leather Wolves is resolved;


Section 1 - Leather Store

Cuero Lobo is a room. It is fasttravel. It is private.
The description of Cuero Lobo is "[cuerolobodesc]".

the scent of Cuero Lobo is "The store smells of cured leather, oil and lupine arousal.".

to say cuerolobodesc:
	if HP of Zigor is 0:
		say "     Finding your way back in the area of that leather store, you approach it cautiously. Scoping it out, you find that the pack of leather wolves has moved on, taking their harness with them. There is a sign on the window that says 'Out of Stock' but another that says they're open. Curious and feeling it's probably safe to approach, you head inside. The store interior has largely been denuded of material, leaving mostly empty mannequins and display photos on the wall, though a few pieces remain. The scent of leather, oils and lupine sex still hangs in the air. The store is not as unoccupied as it first appeared though, there being one of those leather wolves reclining casually with his feet up on the counter.";
		say "     'Hola! Welcome to Cuero Lobo, my friend. I am Zigor,' he says with a rich Spanish accent, rolling his r's and smiling. He, like the others you saw outside previously, is partially covered in leather gear that is somehow a part of him. 'I'm sorry, but we are fresh out of stock these days. Demand for our quality items is quite high, you must understand. We hope to resume business once all the excitement settles down a little and we're able to provide more to our ever-eager clients. But perhaps you'd like to stay to keep me company while we wait,' he says in that alluring, sensual accent of his.";
		now HP of Zigor is 1;
	else:
		say "     This leather goods store has been almost completely denuded of its wares by the lustful mobs, its racks and displays emptied and the mannequins disrobed. The photos on the wall show several of their more elaborate items, many of them quite kinky. Looking more closely, many of them are actually very explicit photos, probably having replaced the more acceptable sample images that were once in the frames. The store is manned by Zigor, a leather-bound wolf with a sexy accent.";


Section 2 - Zigor the Leather Wolf

Zigor is a man. Zigor is in Cuero Lobo.
The description of Zigor is "[zigordesc]".
The conversation of Zigor is { "Hola!" }.
The icon of Zigor is Figure of Zigor_icon.
zigseat is a number that varies.		[seat configuration: 0 = normal, 1 = taur]
zigorcycle is a truth state that varies. zigorcycle is usually false. [Monitors if Zigor's training has been cycled.]
zigorhadiyaquest is a truth state that varies. zigorhadiyaquest is usually false. [Msg about leather jacket for Hadiya's quest]

the scent of the Zigor is "The wolf smells strongly of oiled leather and lupine arousal.".

to say zigordesc:
	say "     Zigor the leather wolf has the build of an average, fit human being, but altered to have lupine features, most prominently his head, hands, feet and tail. Given that he's wearing/bonded to a leather outfit that covers most of him, you can only see portions of his pelt. His fur contains a mix of gray, black, brown and rust colors that make him stand out from the other wolves you've seen. The leather portions of his hide cover his chest, legs and forearms. It is made of black leather with even some metal rings and straps built into it as well as a separate leather patch that partially covers his plump, pierced sheath. The wolf has a rich, sensual voice and speaks with a distinctly Spanish accent that turns you on every time you hear it.";


Instead of conversing the Zigor:
	if HP of Zigor is 0:
		say "ERROR-Zigor-0L: You should not be able to find me!";
	else if HP of Zigor is 1:
		say "     Zigor smiles as you chat with him for a little while. 'My store has always done quite well, our goods being the best around,' he says with pride. 'And we have only become more popular lately. We can hardly keep up with demand. That first night, our store was mobbed by so many eager customers. Oh, it filled my heart with joy to see them all clamoring for the wares, many of them trying them out right away. Oh, it was such a sight,' his already sexy voice adding extra sensual emphasis to his words.";
		say "     'Now, our stock unfortunately too low for sales at the moment. But because I like you, I might be convinced to show you some items from my personal collection downstairs. I have a room set aside where my special guests and try them out. Doesn't that sounds like fun,' he says softly, rubbing his leather-clad body against yours while running his padded fingertips along your side. 'I promise to make you cry out with such painful delight,' he adds, his lupine fangs showing as he grins.";
		now HP of Zigor is 2;
	else if ( HP of Hadiya is 9 or HP of Hadiya is 59 ) and zigorhadiyaquest is false:
		say "     You bring up the fact that you're looking for a small-sized leather jacket to the wolf proprietor, but he just shakes his head. 'As I've told you, I don't have much in the way of materials right now and my stock is depleted. Not that I'd have something that size in my stock. I have a more [']mature['] clientele,' he rumbles in that sexy accent of his, running a paw over your chest. 'Try the mall if you're looking for something in children's sizes,' he adds with a dismissive wave of his paw.";
		now zigorhadiyaquest is true;
	else if HP of Zigor is 2:
		say "     [one of]'I named my store [italic type][']Cuero Lobo['][roman type], or [']Leather Wolf['], because I thought it evoked strength and power. Little did I know I'd one day become a [italic type]cuero lobo[roman type] myself to make it all the more fitting.'[or]'This is one item that customers particularly enjoy,' he says, pointing to one of the photos on the wall, showing some very kinky leather gear trussing up a [one of]man[or]woman[at random] while they are disciplined and fucked. 'I would love to see you in one of those someday,' he adds with a sensual rumble and a hard squeeze of your ass.[or]'Perhaps I could interest you in a more personal session with my collection downstairs?' he says in that sensual voice of his.[or]'We are working hard to restock our wares, but the demand is so high now.'[or][if player is submissive]'You look like you'd take very well to my private chamber. The discipline of a strong, firm wolf is just what you need, carino,' he says, giving your ass a hard squeeze. Your submissive urges cause you to moan, making you long to let him have his way with you[else]'I think you should join me downstairs. The strong ones like you are all the more fun to break and the discipline from a strong, firm wolf is just what you need to do it, carino,' he says, giving your ass a hard squeeze. His offer sounds very enticing, making you strongly consider seeing just what he means[end if].[or]'That first night was such fun. So many eager customers coming in here, trying out our wares right in the store. You should have been there. It would have been nice to see them all taking turns with you,' he says with a toothy grin.[or]Zigor runs his eyes up and down you. 'Mmm... I have trouble deciding what to tie you up in first, mi mascota,' he says with a rather predatory smile.[at random]";
	else:
		say "     [one of]'I named my store [italic type][']Cuero Lobo['][roman type], or [']Leather Wolf['], because I thought it evoked strength and power. Little did I know I'd one day become a [italic type]cuero lobo[roman type] myself to make it all the more fitting.'[or]'This is one item that customers particularly enjoy,' he says, pointing to one of the photos on the wall, showing some very kinky leather gear trussing up a [one of]man[or]woman[at random] while they are disciplined and fucked. 'I would love to see you in one of those someday,' he adds with a sensual rumble and a hard squeeze of your ass.[or]'You should join me for another personal session with my collection downstairs,' he says in that sensual voice of his.[or]'We are working hard to restock our wares, but the demand is so high now.'[or][if player is submissive]'Someone like you was meant to enjoy all the painful delights of my private collection, carino,' he says in that sexy accent of his while grabbing your ass[else]'I look forward to having you for another session with the painful delights of my private collection, carino,' he says in that sexy accent of his while grabbing your ass[end if]. The offer is very tempting, your body longing for more of the wolf's tough love.[or]'That first night was such fun. So many eager customers coming in here, trying out our wares right in the store. You should have been there. It would have been nice to see them all taking turns with you,' he says with a toothy grin.[or]Zigor runs his eyes up and down you. 'Mmm... I have trouble deciding what to [if a random chance of 1 in 3 succeeds]tie you up in next[else if a random chance of 1 in 2 succeeds]strike you with next[else]train you with next[end if], mi mascota,' he says with a with a rather predatory smile.[at random]";


Section 3 - Sex Mechanics

the fuckscene of Zigor is "[sexwithZigor]".

to say sexwithZigor:
	if HP of Zigor < 2:
		say "     You should probably get to know him a little before making such an offer.";
	else if player is not male:
		say "     'I apologize. I thought I mentioned this, but my collection is only available to those of a more masculine persuasion at the moment,' he says with regret. 'Surely you can find someone out there who can help you with that,' he adds.";
		say "[bracket]Only M/M content at present - The Mgmt.[close bracket][line break]";
	else if lastfuck of Zigor - turns < 8:
		say "     'I know you long for more, but this is about teaching you discipline. If you cannot wait until the next session, then you aren't learning and I will have to be more... zealous... in my methods.' Despite his sexy, sensual tone, his lupine teeth show as he emphasizes his point.";
	else if HP of Zigor is 2:
		say "[zigor_S1_00_MM]";
		now lastfuck of Zigor is turns;
		now HP of Zigor is 3;
	else if HP of Zigor < 8:	[Stage 1]
		say "     Asking Zigor for another session in his private dungeon, he motions for you to wait by the door downstairs. Flipping the sign on the window, he calls out for [randomwolfgimp] to [one of]stand guard[or]mind the store[or]keep an eye on things[at random] while he's occupied[if HP of Zigor is 3]. Another leather wolf comes out, looking quite similar to the previous one and again covered by a gimp mask. He pays you little mind and says nothing, moving to guard against intruders[else]. The masked, leather-bound wolf exits from the [one of]back room[or]stockroom[or]leatherworking room[at random] and moves to guard the front door[end if]. Knowing you won't be disturbed, you follow Zigor down the stairs and into the dark basement.";
		if HP of Zigor is 6 or ( HP of Zigor is 7 and a random chance of anallevel in 5 succeeds ):	[HP of 6-7 - buttplug training]
			say "[zigor_S1_analtraining]";
		else if HP of Zigor is 4 or ( HP of Zigor > 4 and a random chance of anallevel in 5 succeeds ):		[HP of 4 - anal]
			say "[zigor_S1_02_MM]";
			now libido of player is ( libido of player + libido of player + 100 ) / 3;
		else:		[HP of 3 - oral]
			say "[zigor_S1_01_MM]";
		if HP of Zigor < 7, increase HP of Zigor by 1;
		now lastfuck of Zigor is turns;
	else:		[Stage 2]
		say "     After flipping the store sign to [']closed['] and calling for [randomwolfgimp] to come to the front, you are brought down into your dominator's private dungeon. With the silent, masked wolf there to [one of]stand guard[or]mind the store[or]keep an eye on things[at random], you know you will neither be disturbed nor be saved from Zigor's painful dominance. And still you descend, a thrill of excitement and anticipation already running through you, already getting hard at the thought of it.";
		if HP of Zigor is 8:		[intro to second level - suspended and whipped]
			say "[zigor_S2_00_MM]";
			now HP of Zigor is 9;
		else if a random chance of 1 in 4 succeeds:	[occasionally reuse old ones]
			say "[one of][zigor_S1_01_MM][or][zigor_S1_02_MM][at random]";
		else if HP of Zigor is 9:			[oral]
			say "[zigor_S2_01_MM]";
			now HP of Zigor is 10;
		else if HP of Zigor is 10:			[anal]
			say "[zigor_S2_02_MM]";
			now HP of Zigor is 11;
		else if HP of Zigor is 11:			[orgy/gangbang]
			say "[zigor_S2_03_MM]";
			now HP of Zigor is 12;
		else if HP of Zigor is 12:
			say "[zigor_S2_04_MM]";
		now lastfuck of Zigor is turns;


Section 4 - Sex w/Zigor - Stage 1

to say zigor_S1_00_MM:	[stage 1 intro - padded bench/riding crop - MM]
	say "     Deciding to accept Zigor's offer, you tell him you'd like to view his collection. Smiling at this, he flips the open sign to closed and calls out for [randomwolfgimp] to come out and watch the store. A few moments later another leather wolf arrives from the back of the store. He is almost completely covered in leather fetish gear, to the point of even having a lupine gimp mask fused over his face. His amber eyes spare you only a momentary glance before standing silently on watch in the room. Surprised by his appearance, you turn your gaze from him only when Zigor calls for you to follow him through another door and down the stairwell.";
	say "     Unlocking the basement door, Zigor leads you into a lantern-lit, dungeon-like room outfitted with an array of kinky BDSM gear. You'd suspected you'd find something like this down here, but nowhere near to this extent. Set up around the room is an array of chains, slings and other restraining devices. A rack along one wall has shelves of whips, paddles and other pain-inducing items. A small table next to that has an array of dildos, butt plugs and other sex toys orderly arranged atop it. There are several black cabinets and locked trunks as well, probably holding even more startling gear. Even moreso than upstairs, the whole room smells strongly of leather and lupine sex.";
	WaitLineBreak;
	say "     As you're trying to take it all in, Zigor suddenly grabs you and pushes you down overtop of a padded bench. With a speed that must come from considerable practice, he has your wrists snapped into the leather shackles even before the stars clear from your eyes. 'As this is your first time, I thought we'd start with something simple, mi mascota,' he says in that sexy voice of his. He removes anything covering your ass before groping it with a paw. But just as you start to relax, there comes a hard, painful SWAT! as something strikes your butt cheek. Looking back, you see him raise the riding crop again and bring it down on your other cheek.";
	say "     The throbbing sting of the blows are echoed by the throbbing of your cock, quickly growing hard. After a few more stinging swats, Zigor pauses for a moment to stroke your [cock of player] penis, spreading your leaking precum across it. 'Mmm... I knew you'd like this,' he says with that sensual Iberian accent of his. 'The proper amount of discipline is what people like you need to bring out the best in them.' He brushes the leather flap of the riding crop across your manhood, over your balls and then between your cheeks. He resumes lashing you with the crop as he continues to stroke you off. As he continues, the line between pain and pleasure blurs more and more until you're crying out for him to hit you again the next time he pauses. Grinning toothily, he gives you a hard swat across the balls. You scream loudly, cumming hard as tears run from your eyes. He pumps you for all you'll give, catching [if cock width of player < 25]most of it in a bucket under the bench[else]as much as he can in a bucket under the bench[end if].";
	say "     The wolf gently caresses your sore ass with one paw as he undoes the shackles. 'You did well enough for your first time, I suppose. But I expect better of you in the future,' he adds, squeezing your rump painfully in emphasis. 'Return for another session tomorrow.' You moan and nod, unsure how you failed, but finding yourself wanting to do better regardless. And with that, he pulls you off the table and shoves you out the door, forcing you to stumble up the stairs with your balls still aching. Despite the pain, it is a pleasant ache that you want to feel again soon.";


to say zigor_S1_01_MM:	[stage 1 - stocks/oral - MM]
	say "     Once inside, he orders you over to the wooden stocks in one corner of the room. The restraint [if scalevalue of player is not 3]has been fitted with boards where the holes have been scaled to fit your wrists and neck[else]has holes cut into the boards for your wrists and neck[end if][if HP of Zigor is 3]. When you hesitate, he lashes your ass with a flog, prompting you to climb into it[else]. You obediently move over to it and climb into it[end if]. Resting your chest across an angled, leather-padded bench, you place yourself in the holes and your dominator locks you into it. With you trapped, he takes his time to run his flog across your cheek while giving you a wolfish grin. He then strides around behind the medieval restraint, moving out of your line of sight. You're left staring at the wall for a while, making you wonder if he's left you alone before suddenly receiving a harsh lashing across your ass, making you cry out in pained surprise.";
	say "     You are lashed and whipped for quite some time, broken up by brief respites of him stroking your erect cock. The lupine dominator strikes you all over, paying particular attention to your ass, [if breast size of player > 0]breasts[else]pecs[end if] and sides, though few spots are spared from the flog's touch. The heat of every lashing seems to make your [cock of player] penis ache all the more even as your eyes water from the pain.";
	say "     Once you're aching all over and about to cum from it, he stops and moves back around in front of you. You can see he's removed the patch from his loins, uncovering his white sheath and the black cock emerging from it. Grabbing your head roughly, he forces his cock into your mouth. 'Take it, my pet. Suck it like you need it to live, you slutty bitch. But if you bite,' he says in warning while rubbing his scourge across your cheek again, 'you will truly know my wrath.' His voice gets hard like steel, hard like that wolf cock stuffed in your mouth, as he growls menacingly at you. You nod quickly and start sucking at his cock, your unsatiated arousal making you lustful for his lupine seed. You're doing well until it whips you again suddenly across the back, causing you to moan. You resist the urge to clench your teeth, but the effort makes your jaws ache even more. Thankfully, after his extended torture of you, he's quite close himself and you're able to finish him off before your jaw muscles give out. And your reward is the delicious rush of his wolf cum into your mouth and down your throat, which you gulp down hungrily.";
	say "     His balls drained, Zigor takes your cock in hand and strokes you off, rewarding you for being such a good, cocksucking pet. On edge for so long, it only takes a few pumps to get you to climax. Your [cum load size of player] load is shot into a bucket beneath you, the last few shots aided out of you by lashes from his flog across your ass. Once you're spent, he leaves you in the stocks. You can only stare at the wall as he casually cleans up the mess and straightens the room while the painful lashings fade to dull aches as your body quickly heals. It's hard to tell how long you're there, losing track of time before finally being freed and allowed to return back upstairs.";


to say zigor_S1_02_MM:	[stage 1 - sling/anal - MM]
	let baby be 0;
	if child is born or gestation of child is not 0, now baby is 1;
	say "     Once inside, he grabs you by the back of the neck before your eyes can adjust to the low light and pushes you onto a leather sling. In it, you are suspended face down off the ground at waist height[if scalevalue of player > 3]. Given its size and reinforced chains, it has clearly been made after the outbreak to hold [body size of player] mutants like yourself[end if][if HP of Zigor is 4]. When you try to get up, you're given a smack on the back of the head by the wolf as he growls for you to stay where he puts you[else]. Knowing what's coming, you get settled into the sling and hold out your arms and legs for your dominator[end if]. Picking up some manacles and shackles, he places them around your ankles and wrists, tightening the chains enough that you can swing, but are unable to resist or escape. With you secure, he strides over to his shelf and selects a [one of]hard[or]leather[or]wooden[or]long[or]wide[at random] paddle with considerable care while you are forced to watch him mull over his decision, increasing your trepidation and anticipation further. His choice made, he gives it a hard SMACK! across your rear, making you cry out.";
	say "     Your rear is tenderized by several more painful blows, each one accompanied by a twitch of your cock and a spurt of precum. The stinging of your rump is soothed by the soft caress of his sheath fur and the dribbling precum leaking from his emerging shaft. Getting himself lined up, he thrusts hard into you without preamble, the suddenness of the penetration only adding to the aching pleasure you're feeling. He fucks you hard and fast, rocking you in the sling. From time to time he pulls on the chains to force himself in harder or swats your shoulder, back or thigh with the paddle. Despite, or perhaps because of the pain, the rough fucking feels wonderful, your asshole clenching tightly around his lupine penis with every blow, allowing you to feel every push, throb and grind it makes inside your oversensitive ass.";
	say "     After a good, long session of painful fucking, he drives his foot long cock into you, knot and all. With a howl and his claws sinking into your tender ass, he cums. His lupine seed blasts into you, filling your ass with his creamy load. This sends you over the edge and you cry out, cumming messy streaks of cum onto the floor as you spill your [cum load size of player] load onto the stone floor. Zigor hardly waits for his knot to go down before yanking it out hard, causing you to cry out even as his oily cum leaks out to soothe it. He leaves you suspended like that for a while, disciplining you with more blows from the paddle. It is only once you're hard again that he releases you, aching and aroused, to go back upstairs.[mimpregchance]";
	if baby is 0 and gestation of child is not 0:
		now facename of child is "Leather Wolf";
		now bodyname of child is "Leather Wolf";
		now skinname of child is "Leather Wolf";


to say zigor_S1_analtraining:
	say "     Once inside, he directs you to the padded bench you used on your first visit with a hard swat from a switch he pulled off the wall. With a whimper of delight, you get naked and onto it as quickly as you can[if HP of player is 6], earning a second lashing as you're not quite fast enough for your dominator's liking[end if]. As quick as before, he has you shackled down onto it, leaving you at his not-so-tender mercies.";
	if player is not twistcapped:
		say "     He drags the switch slowly between your ass cheeks, but does not swat you as you whimper and raise your ass for him. He instead starts spreading some lube across your pucker and then pushing one finger and then another into it[if HP of player is 6]. At first, you are rather surprised at how tender and sensual he is about this. But when he selects a dauntingly large buttplug from his collection you realize what his true intentions are[else]. Knowing what is to come, you do your best to relax, enjoying his sensual touch while you can before he selects a dauntingly large buttplug to be used on you[end if]. He has a very cruel grin on his lupine face as he lubes up the massive toy before jamming it hard against your back entrance. The earlier preparation is nowhere near enough to cope with such a big toy and you're left whimpering and moaning in a mix of pleasure and pain as he works it steadily deeper with hard pushes while stroking your dangling cock with his other paw.";
		say "     'That's it, little mascota,' he whispers sensually in your ear as he gives it another hard push. 'Your body needs to be trained. These are such interesting times; you need to be -he drives the increasingly thick plug another inch into you- prepared to accept it.' He gives a chuckling growl and gives the toy another push. It hurts, but it is a good hurting and your cock is rock hard and dribbling with pre from the wolf's constant stroking. As the session goes on, it gets more and more difficult for you to deal with the thick base of the latex plug, but [if HP of Zigor is 6]Zigor keeps pushing to stretch you out[else]you do you best to accommodate the dominant wolf's toy[end if].";
		say "     After what feels like hours of stretching, your anus crests the widest point and quickly yanks the rest of the toy into your ass as it closes back down around the narrower portion. This slams the toy buried deep inside you against your prostate, setting you off into a screaming climax as your reward for finally succeeding. The whole of your lower body, aching from the effort of your training, quivers and trembles as you spray your [cum load size of player] messily onto the ground and into the waiting bucket. As you're cumming, the leather wolf moves in front of you and forces his cock down your throat, feeding you his seed after a few thrusts.";
		increase XP of Zigor by 1;
		if XP of Zigor is 3:
			say "     'It pleases me to see you coming along so well, cachorro. That should help with your ordeals in the city as well as let us move on to some more intense pleasures,' he says with a toothy smile in that sensual accent of his. He gives your ass a firm squeeze with his claws digging in, causing your ass to clench and squeeze down around that extremely large buttplug it is holding with ease. As he leaves you there to enjoy the sensation of fullness and being delightfully stretched inside, you eye his collection with a hunger for the various huge toys.";
			say "     [bracket]You have gained the [bold type]Twisted Capacity[roman type] feat.[close bracket]";
			add "Twisted Capacity" to feats of player;
			increase score by 20;
		else:
			say "     After several lashings across the ass with the switch, he relents. 'You did well enough, I suppose,' the wolf says in his sensual, Iberian accent. 'Perhaps we'll have you try something [if XP of Zigor is 1]a little bigger[else]with real girth to it[end if] next time.' Feeling the sore ache from your ass despite the nanite infection, you are filled with both trepidation and anticipation for more. He leaves you tied up and stuffed for quite some time, your ass gradually becoming used to the added extension. During this time, your eyes drawn to his collection and those even larger toys awaiting you.";
	else:
		if XP of Zigor is 3:	[got feat from him]
			say "     He drags the switch slowly between your ass cheeks, but does not swat you as you whimper and raise your ass for him. He instead starts spreading some lube across your pucker and then pushing one finger and then another into it[if HP of player is 6]. At first, you are rather surprised at how tender and sensual he is about this given what you've come to expect and desire from him[else]. Having been through this before, you do your best to relax, enjoying his sensual touch[end if]. As your accommodating anus relaxes and stretches, the surprised wolf plunges further into you. 'It seems that someone has already stretched you out quite nicely, pequeno juguete,' he says while teasingly rubbing at your prostate.";
		else:			[got feat elsewhere]
			say "     He drags the switch slowly between your ass cheeks, but does not swat you as you whimper and raise your ass for him. He instead starts spreading some lube across your pucker and then pushing one finger and then another into it. Having undergone your training, your accommodating anus relaxes and stretches, allowing the sensual wolf to plunge further into you. 'It seems that you are indeed stretched out quite nicely, pequeno juguete,' he says while teasingly rubbing at your prostate.";
		say "     'I have something I have been saving for just this occasion,' the wolf says sexily, giving your ass a swat with the switch as added emphasis. He strides over to his collection and pulls out a huge, knotted dildo. It looks much like his own cock, but enlarged and wired to a handheld remote. This he lubes up quickly before easing it inch by delightful inch into your anus. He pauses from time to time to give you another few lashings. These cause you to moan in pleasure as your stuffed hole clenches momentarily around the thick toy inside you. Once it's buried into you to the top of the knot, he takes a moment to caress your cock and balls, telling you to be a good sub and take it all. You nod eagerly, your lust-filled mind wanting that thick bulb in you so badly. Zigor grins at your respond and gives it a hard push, forcing it all into you with a wet plop and a loud cry from you.";
		say "     With that big thing buried and knotted inside you, he's free to stride around you, remote and switch in hand. The dildo begins to vibrate inside you, sending tingles of erotic bliss through your lower body. As he starts lashing you, he punctuates each blow by turning up the vibrator briefly, tying your pain into your pleasure. From time to time, he pauses before you, stuffing his cock down your throat and having you suck his leaking meat. This goes on for quite a while, the wolf expertly keeping you from cumming as he draws out your punishing delight. Once he's satisfied with your continued training, he takes your mouth again and lashes you wildly, keeping the vibrator on max until you both have powerful, sticky climaxes that leave you both tired and panting. Your balls drained, he gradually eases the dial down until its off and removes the knotted dildo from you before sending you back up the stairs on unsteady legs with another swat of the switch.";
		now XP of Zigor is 4;
		now HP of Zigor is 8;


Section 4 - Sex w/Zigor - Stage 2

to say zigor_S2_00_MM:	[stage 2 - suspended/whip/gag/vibrator - MM]
	say "     Once inside, he shoves you face first against a wall hard enough to bruise you. As he pulls your arms upright, he grinds himself against you, rubbing that leather covered bulge in his crotch against you. He shackles your wrists together with leather manacles separated by only a short length of chain. 'And now that your training has come along, it's time to progress to more [']intense['] training,' he says with a sensual, intense growl and [if breasts of player > 0]pinches your nipples[else]digging his claws into your ass[end if]. Reaching down to rub your [cock of player] erection, he licks your ear. 'With some more discipline, I'm sure I can bring the very best out of you,' he rumbles in that sensual accent of his. His paw shifts to your balls, giving them a painful squeeze. As you cry out, a ball gag is jammed into your mouth and tied firmly. 'As delightful as your cries are, I'm not in the mood for them today.'";
	say "     And with that said, he grabs the chain connecting your manacles and drags you roughly across the floor to a suspended hook. Hanging you onto the hook, he winches you up until you're suspended freely. A plump, vibrating toy is jammed into your asshole with little preamble, the penetration still somewhat painful despite your intense training due to the suddenness. Your ankles are then cuffed together, bound tightly against one another. Belts are then lashed around your lower legs and then your thighs, each of them being used to strike you harshly before being locked tightly. Each blow makes your [cock size desc of player] shaft twitch and precum spurt from your [cock of player] cock, the sharp pain exciting you. By the time he's done trussing you up, your legs are tightly bound together, ensuring that vibrator has no room to escape.";
	WaitLineBreak;
	say "     Zigor strides over to a rack of disciplinary tools, taking his good time in deciding what to use on you. He examines several paddles, lashes and crops, mulling over his decision while that toy continues to buzz inside you. It provides a continuous source of low-level pleasure while the aching in your arms slowly grows, all while knowing this is but the preamble and you are left anticipating what is to come. After drawing it out, Zigor leaves the display case without choosing any of them. 'No, I believe we'll need something a little stronger this time,' he says with a toothy grin, opening up an engraved chest on another shelf. He pulls a long leather whip from it and gives it a rapid flick, lashing it through the air with a sharp crack.";
	say "     The next crack of the whip is aimed at you, striking your side and stinging painfully. Your loud cry is muffled by the ball gag, but there is still a loud groan. 'What is that, my pet? You want it again?' he asks. You shake your head, but he swings again, striking the underside of your arm. The lashings continue, the wolf striding around you, landing blows across you all over, front, back and sides and top to bottom. Zigor is quite skilled with the whip, his blows always striking his target. Never once does he hit the same place nor does he strike your bonds. The only exception to this is your ass, upon which he is particularly focused at the end. Tears wet your eyes from the pain of it, but the continuous vibration adds a layer of pleasure as well to your discipline. The whipping session is brief, but far more painful and intense than anything he's done before. You hurt all over, but most especially at your rock-hard cock, your balls churning with need for release.";
	WaitLineBreak;
	say "     After taking his time to clean and oil his whip, he winds it back up and returns it to its engraved case before striding over to you. The leather wolf smiles and licks his chops as he eyes his handiwork. 'Mmm... that felt good. It has been some time since I gave someone a proper lashing. It seems you enjoyed it as well,' he rumbles, running a fingertip across your [cock size desc of player] erection. That said, the sexy wolf opens his muzzle wide and stuffs your cock into his mouth. His skillful tongue plays across your manhood while he rubs your balls in his padded paws. After everything you've been through, you don't last long, spilling your [cum load size of player] payload down his throat. Once he's gotten it all, he licks his chops. 'Oh, what a delicious reward your pain yields.'";
	say "     The wolf lowers you down onto the floor. Still tightly bound, you can do nothing but lay there and watch as he strokes his large, lupine cock until his seed is splattered across you[if wslevel is 1]. He leaves streaks of white across your whole body, though he makes a point to spray much of it across your face[else]. After leaving streaks of white across your face and body, he sighs softly and releases more fluid onto you, this time painting you up and down with his piss. He makes a point his spray at your mouth. Even with the gag in your mouth, some of it seeps around, giving you a taste of the acrid fluid[end if]. When he's drained, he removes your gag and offers you his cock. 'Lick me, perra cachonda,' he says, offering you his cock. In your lustful need, you obey, pressing your lips around it and lick it clean.";
	say "     'Very good. If you learn well, I will not need to be quite so harsh with you in the future. Consider this... incentive to accept your training. Let that wonderful ache and my scent be reminders of whom you belong to, mi mascota,' Zigor says in that soft, sensual voice of his as he caresses your messy face. He leaves you there for some time, which you appreciate, your body feeling too sore to move quite yet, though the nanites are helping you to recover quickly. All the while, the toy inside you continues to buzz away, providing constant pleasurable reinforcement, making you look forward to your next session.";


to say zigor_S2_01_MM:	[stage 2 - spreader/pain choice/oral - MM]
	let dchoice be 0;
	say "     Once inside, Zigor simply points towards one end of the room and gives your rear a hard swat. Obediently, you head off in that direction and wait at the open section of floor. On a nearby table is a small selection of the wolf's crops, paddles and flogs, clearly arranged out for you. You see as well that several heavy rings have been driven into the stone floor around you. Looking between these sends an involuntary shiver of excitement through you, the wolf's scent around you clouds your mind with arousal and his disciplinary harsh training making you long for more of it. By the time Zigor joins you a few moments later, chains and a spreader bar in paw, you've gotten quite hard and dripping.";
	say "     After tossing the heavy bars onto the table with a clang, he gropes you from behind, one paw on your junk and the other gripping your chin. He turns your head sharply towards the table and its arrayed disciplinary tools. 'One of those will be yours to enjoy, mi mascota. Which of them does my pet desire to feel this time?' he says with that sensual accent of his, licking your ear. Looking them over, your eyes are drawn to a few in particular - a [link]riding crop (1)[as]1[end link], a [link]wooden paddle (2)[as]2[end link], a [link]heavy flog (3)[as]3[end link] and a [link]leather truncheon (4)[as]4[end link]. Remembering the pained pleasures you've enjoyed down here before, part of you longs for [link]all of them (5)[end link]";
	if player is dominant:
		say " though some small corner of you still wishes to [link]refuse (0)[end link] entirely";
	say ".";
	now calcnumber is -1;
	while calcnumber < 0 or calcnumber > 5:
		say "Choice? (0-5)>[run paragraph on]";
		get a number;
	now dchoice is calcnumber;
	if dchoice > 0 and dchoice < 5:		[chose one]
		say "     Having made your choice, Zigor fondles your shaft and nips at your neck. 'Very well. Let us begin. On your knees, my pet,' he growls as he pushes you roughly onto your knees and kicks your legs apart. Your ankles are locked into the spreader bar, which is then connected to one of the floor rings. Manacles are put around your wrists and chained to distant rings to each side of you, leaving your arms spread wide. A tight collar is put around your neck and secured to the spreader bar behind you with another bar, ensuring you're stuck kneeling upright before him. Only once you're nice and trussed up does he pick up the [if dchoice is 1]riding crop[else if dchoice is 2]wooden paddle[else if dchoice is 3]heavy flog[else]leather truncheon[end if] and run his fingers over it in a slow, almost sensual manner before brushing it across your cheek.";
		say "     [if dchoice is 1]Moving around you, Zigor gives you several swats with the riding crop, mainly across your ass. Each one makes your cock twitch and another dribble of precum run down it[else if dchoice is 2]Moving around you, Zigor gives you a solid whack with the wooden paddle across your ass. This is followed by another and another as he starts spanking you, each blow causing your cock to twitch and dribble more precum[else if dchoice is 3]Moving beside you, Zigor gives you a hard lashing with the flog across your back. This causes you to stiffen in your restraints and whimper, though it also causes your cock to stiffen all the more, too. As he gives you another few lashings, including some across your ass, your cock twitches and dribbles of precum run down it[else]Standing before you, Zigor strikes you in the side with the leather truncheon, then jabs it into your gut. You groan and reflexively try to bend over, but your restraints keep you from doing so. You're given another blow, this time to your other side, followed by the soft touch of the leather club sliding across your cock. Your manhood twitches and fresh precum runs down it and onto the club[end if]. You are given several more blows while the wolf rumbles that he'll toughen you up and teach you to be an obedient pup. While each blow is [if dchoice is 3 or dchoice is 4]quite [end if]painful, it is also very exciting and makes you more and more aroused. By the time he's done, you're left sagging in your restraints, panting heavily and drooling precum into the ever-growing pool between your knees.";
		say "     [if dchoice is 1]The wolf presses the riding crop against your chest and slowly drags it up your sternum and under your chin, getting you to raise your head until your mouth is in line with his erection[else if dchoice is 2]The wolf gives your ass another swat, hard enough that you arch your back and cry out. As you do, he grabs your raised head and keeps it held up as he strides around you, bringing his erection in front of your mouth[else if dchoice is 3]The wolf presses the pommel of his flog under your chin and lifts your head until your mouth is in line with his erection[else]The wolf runs the truncheon lightly up your bruised side to your neck. He gives your chin a firm knock on the underside, silently getting you to raise your head lest he crack your jaw with another blow. Lifting your head, you find yourself with his erection pointed at your mouth[end if]. 'Get to sucking, cachorro,' he rumbles with a long, rolling 'R'. Between the wolf's strong scent and your pent-up arousal, you obediently bury his bone in your wet maw, licking and sucking at it greedily. He brushes the [if dchoice is 1]riding crop[else if dchoice is 2]wooden paddle[else if dchoice is 3]heavy flog[else]leather truncheon[end if] across your cheek as if reminding you to do a good job lest you be punished. Not that you need any such enticement in your current state. You are eager to please your dominator and master as well as thirsty for his seed. With the scent of leather and him filling your nose, you can think of nothing more by this point.";
		say "     The wolf holds back much longer than during your earlier sessions, giving you plenty of opportunity to show your devotion to his knotted manhood before he finally rewards you with a sticky flood of his lupine seed. This you swallow down hungrily, licking and sucking for more until finally he's got none left to give. After such an enthusiastic blow job, the wolf sniffs his way down your trapped form, muzzle making its way to your throbbing cock and balls. He gives them a long, slow lick before wrapping his tongue around your shaft and pulling it into his maw. While sucking you, he strokes the [if dchoice is 1]crop[else if dchoice is 2]paddle[else if dchoice is 3]handle of the flog[else]truncheon[end if] against your balls, reminding you of the painful pleasure it's given you. After your long session, you don't hold out long and end up feeding your [cum load size of player] load to the leather-bound lupine. Licking his muzzle as he rises, he frees you of the restraints lets you drop to the stone floor in a heap. Your muscles and joints sore from being locked in them for so long, you are left there for a time to recover before Zigor escorts you back upstairs with a final tap of the [if dchoice is 1]riding crop[else if dchoice is 2]paddle[else if dchoice is 3]flog[else]leather club[end if] on your ass.";
	else if dchoice is 5:			[chose all]
		say "     Telling the wolf that you want them all, he roughly pushes you to the ground and presses a paw onto your head, grinding your face to the floor. 'I told you to choose one, pup,' he growls. 'You are enthusiastic, but indecisive, mi mascota. You need a singleness of thought. You need to focus on one thing and one thing alone - obedience.' Still keeping you under his heel, he grabs the [one of]riding crop[or]flog[at random] and strikes you with it a few times while holding you down. You moan and whimper at the blows, but are quite aroused as well. There is something exciting about the powerful male's dominance over you. Your hard cock is pressed firmly between you and the cool floor.";
		say "     After tenderizing you with several blows, he removes his paw and picks up the spreader bar. 'On your knees and spread your legs, my pet,' he orders even as he yanks you up by the shoulder and kicks your legs apart. Your ankles are locked into the spreader bar, which is then connected to one of the floor rings. Manacles are put around your wrists and chained to distant rings to each side of you, leaving your arms spread wide. A tight collar is put around your neck and secured to the spreader bar behind you with another bar, ensuring you're stuck kneeling upright before him. Once you're nice and trussed up, he picks up the riding crop and runs his fingers over it in a slow, almost sensual manner before brushing it across your cheek.";
		say "     'I shall give you a taste of them all, my pet. Perhaps that will make you more attentive to my instructions in the future,' he rumbles in your ear while groping your shaft.";
		say "     Moving around you, Zigor gives you several swats with the riding crop, mainly across your ass and inner thighs. Each one makes your cock twitch and another dribble of precum run down it. After this, he swaps to the wooden paddle, again starting with your ass with a solid whack. This is followed by another and another, spanking you with it until your rear end is throbbing as much as your [cock of player] shaft. Next comes the flog with hard lashings across your back. This causes you to stiffen in your restraints and whimper, though it also causes your cock to stiffen all the more, too. The whipping continues as he moves to strike your front as well, flogging you across the chest[if breasts of player > 0]. The sting of his lashes across your nipples makes them so hard[end if].";
		say "     Finally, Zigor moves up to the leather truncheon, striking you with it across your sides and then several across your back. You can feel the ache from these and know you'll be bruised for a while from them. A few more strikes are then followed by the soft touch of the leather club sliding across your cock. Your manhood twitches and fresh precum runs down it and onto the club. This brief respite is followed by the wolf jabbing the leather truncheon into your gut. You groan and reflexively try to bend over, but your restraints keep you from doing so. You're left sagging in your restraints, panting heavily and drooling pre into the ever-growing pool between your knees.";
		say "     The wolf, with the riding crop in hand again, slowly drags it up your sternum and under your chin. Pressing the leather flap at the end under your jaw, he gets you to raise your head until your mouth is in line with his erection. 'Get to sucking, cachorro,' he rumbles with a long, rolling 'R'. Between the wolf's strong scent and your pent-up arousal, you obediently bury his bone in your wet maw, licking and sucking at it greedily. He brushes the [one of]riding crop[or]wooden paddle[or]heavy flog[or]leather truncheon[at random] across your cheek as if reminding you to do a good job lest you be punished. Not that you need any such enticement in your current state. You are eager to please your dominator and master as well as thirsty for his seed. With the scent of leather and him filling your nose, you can think of nothing more by this point.";
		say "     The wolf holds back much longer than during your earlier sessions, giving you plenty of opportunity to show your devotion to his knotted manhood before he finally rewards you with a sticky flood of his lupine seed. This you swallow down hungrily, licking and sucking for more until finally he's got none left to give. After such an enthusiastic blow job, the wolf sniffs his way down your trapped form, muzzle making its way to your throbbing cock and balls. He gives them a long, slow lick before wrapping his tongue around your shaft and pulling it into his maw. While sucking you, he strokes the [one of]crop[or]paddle[or]handle of the flog[or]truncheon[at random] against your balls, reminding you of the painful pleasure it's given you. After your long session, you don't hold out long and end up feeding your [cum load size of player] load to the leather-bound lupine. Licking his muzzle as he rises, he frees you of the restraints lets you drop to the stone floor in a heap. Your muscles and joints sore from being locked in them for so long, you are left there for a time to recover before Zigor escorts you back upstairs with a final tap of the [one of]riding crop[or]paddle[or]flog[or]leather club[at random] on your ass.";
	else:						[no choice]
		say "     Shaking your head, you try to resist the urge to accept the wolf's harsh discipline. While the scent of leather and lupine is making you feel lustful and submissive to the strong male, you manage to momentarily pull together enough strength of will to refuse. The wolf growls and pushes you to the ground, pressing a paw roughly onto your cheek and grinding your face onto the floor. 'I told you to choose one, pup,' he growls angrily. 'You came to me for discipline and now you resist me? In my kindness, I offer you your choice of pain and you spurn my generosity? I am most disappointed, gusano. Clearly you need more... vigorous training.' This last he punctuates with a kick to your gut. Despite yourself, you've begun to get hard again, your self-control waning as he becomes more aggressive in his dominance of you.";
		say "     After softening you up with a few more kicks, he grabs you roughly and pulls you up. 'On your knees and spread your legs, you cur,' he orders even as he kicks your legs apart. Part of your increasingly clouded mind tries to get you to pull away, but your hesitation is enough time for Zigor to lock your ankles into the spreader bar and get it connected to one of the floor rings. Manacles are put around your wrist and chained to distant rings to each side of you. They are pulled painfully tight, leaving your arms spread wide. A tight collar is put around your neck and secured to the spreader bar behind you with another bar, ensuring you're stuck kneeling upright before him. Once you're trussed up so tightly your shoulders and chest ache from the strain, he picks up the riding crop and runs his fingers over it in a slow, almost sensual manner before slapping it harshly across your cheek.";
		say "     'Since you refused to choose, perra, I am left with no choice but to give you a taste of them all. Perhaps that will teach you to listen to my instructions in the future,' he rumbles in your ear while squeezing firmly on your balls. Tears wet the corners of your eyes and your erection returns to full mast.";
		say "     Moving around you, Zigor gives you numerous fast swats with the riding crop, mainly across your ass and inner thighs. Each one makes your cock twitch and another dribble of precum run down it. When he notices this, he makes sure to give your ballsack as whack as well, causing you to give a pained whimper of delight. After this, he swaps to the wooden paddle, again starting with your ass with a solid whack. This is followed by another and another, spanking you with it until your rear end is aching as much as your [cock of player] shaft from your deserved punishment.";
		say "     Next comes the flog with hard lashings across your back. This causes you to stiffen in your restraints and whimper, though it also causes your cock to stiffen all the more, too. The whipping continues as he moves to strike your front as well, flogging you across the chest and shoulders again and again hard enough to cover them in welts[if breasts of player > 0]. The sting of his lashes across your nipples makes them so hard each time they're hit[end if].";
		say "     Finally, Zigor moves up to the leather truncheon, striking you with it across your sides and then several across your back. His blows are strong, the wolf holding little back in his quest to properly train his recalcitrant pet. A few ribs are cracked and you know you'll be bruised for quite some time despite your accelerated healing. Lost again to the lustful need to be disciplined, your cock throbs and spurts pre with every blow you receive. Even when he jabs the leather truncheon into your gut, your painful groan is accompanied by an aching fullness of your erection. Your body tries to double-over from the blow to your breadbasket, but your restraints keep you from doing so. You're left sagging in your restraints, panting heavily and drooling pre into the ever-growing pool between your knees.";
		say "     The wolf, with the riding crop in hand again, slaps it across each of your cheeks and growls for you to lift your head. Looking up at your dominator, you find your mouth in line with his erection. 'Get to sucking, cachorro,' he rumbles with a long, rolling 'R'. After the lengthy and painful disciplinary session has left you achingly aroused, you give no thought to resisting and obediently bury his bone in your wet maw, licking and sucking at it greedily. He brushes the [one of]riding crop[or]wooden paddle[or]heavy flog[or]leather truncheon[at random] across your cheek as if reminding you to do a good job lest you be punished, though you no longer need any such enticement in your current state. You are eager to please your dominator and master as well as thirsty for his seed. With the scent of leather and him filling your nose, you can think of nothing more by this point.";
		say "     The wolf holds back much longer than during your earlier sessions, giving you plenty of opportunity to show your devotion to his knotted manhood before he finally rewards you with a sticky flood of his lupine seed. This you swallow down hungrily, licking and sucking for more until finally he's got none left to give. After such an enthusiastic blow job, the wolf gently caresses your cheek. 'I am pleased to see you feeling dutiful again,' he rumbles. 'Let me show you what else obedience earns you,' he says in that suave accent of his while nuzzling down your chest. He sniffs his way down your trapped form, muzzle making its way to your throbbing cock and balls. He gives them a long, slow lick before wrapping his tongue around your shaft and pulling it into his maw. While sucking you, he strokes the crop against your balls, reminding you of the painful pleasure it's given you. After your long session, you don't hold out long and end up feeding your [cum load size of player] load to the leather-bound lupine. Licking his muzzle as he rises, he frees you of the restraints lets you drop to the stone floor in a heap. Your muscles and joints sore from being locked in them for so long, you are left there for a time to recover before Zigor escorts you back upstairs with a final tap of the [one of]riding crop[or]paddle[or]flog[or]leather club[at random] on your ass.";
	if dchoice is 3:
		now HP of player is ( 2 * HP of player ) / 3;
	else if dchoice is 4:
		now HP of player is HP of player / 2;
	else if dchoice is 5:
		now HP of player is HP of player / 3;
	else if dchoice is 0:
		now HP of player is HP of player / 4;


to say zigor_S2_02_MM:	[stage 2 - sling/anal/accessory - MM]
	let baby be 0;
	if child is born or gestation of child is not 0, now baby is 1;
	say "     Once inside, he directs you back to the sling you've used before with a swat on your rear. 'Back into your seat, mi cachorro. I wish to enjoy my needy pet again,' he says sensually. You are told to lay on your back in the sling this time and are secured into it. Straps around your wrists are connected to the heavy chains holding up the swing, leaving you at the wolf's not-so-tender mercies. Zigor runs his paws over your [bodytype of player] body, looking it over as he tries to decide how best to [']enhance['] the experience for you.";
	let x be a random number between 1 and 2; [1 = nipple clamps / 2 = cock ring]
	if x is 1:
		say "     Taking them from a nearby collection of small accessories, the dominating wolf puts a set of nipple clamps onto your [if breasts of player > 2]many [end if]nipples. They [if breasts of player < 4]both[else]each[end if] have a short strip of leather attached to them, making for easy handholds should the wolf wish to tug on them - which he promptly demonstrates after getting them onto you. The stinging pain you feel on your hard nipples sharpens when the clamps are tugged on. After a few tugs, you are left whimpering and panting, your excitement growing and clearly shown by your [cock size desc of player] [cock of player] erection that's ready and waiting.";
	else:
		say "     Taking them from a nearby collection of small accessories, the dominating wolf snaps a leather loop around the base of your ballsack and cock[smn]. With the cock ring on and exerting constant pressure, your manhood stiffens and twitches. There is a soft ache in your balls that you expect to only grow as you become further aroused. That thought alone arouses you, your submissive training making you enjoy the loss of control under the wolf's domination.";
	say "     With you suitably prepared, Zigor gives your cock[smn] a final, playful lick before moving to your hips and raising your legs. He spreads them wide and grinds his lupine shaft against your ass, drooling precum onto it. A few teasing presses of his glans against your anus without penetration has you moaning and begging for the wolf to take you. He only grins at this and [if x is 1]tugs on your nipples clamps[else]strokes your hard shaft[end if] and keeps teasing you. 'If you agree to be my good, obedient pet, perhaps I will give you what you desire,' he rumbles in that sexy accent of his as he pokes just the pointed tip of his canine cock into you. Feeling it so close, even drooling a little precum just inside your back entrance, you moan and try to push back onto that tantalizingly close shaft, but cannot due to your restraints. When your attempts to push back onto it fail, you moan that you'll be a good, obedient pet for him to fuck. Zigor grins at this and thrusts firmly into you, burying much of that large shaft into you in a single motion.";
	say "     Precum [if x is 2]leaks slowly[else]flows heavily[end if] from your cock[smn] as the leatherbound wolf fucks you. His hips pound against yours hard enough to make you sway on the swing, adding to the firmness of the next thrust into you as you come rocking back to him just as he pushes forwards again. The leather wolf keeps a nice, steady pace, clearly having had much practice timing his movements to the swaying of the swing[if x is 1]. While having his way with you, Zigor makes sure to tug on the nipple clamps, each sharp lance of pain sending a rush of excitement through you that has your cock twitch and drool[else]. While having his way with you, Zigor makes sure to stroke and pump at your pulsing rod. Blood trapped by the tight leather, your erection is darker than normal and feels rock hard. Only a little pre leaks out of it though, the tight grip cutting off the flow. You start to whimper as the ache in your balls grows, but they're unable to release it[end if]. Your dominator only gives a pointy-toothed grin at your discomfort and arousal and continues his possessive use of your body.";
	if x is 1:
		say "     Under the constant fucking and teasing, you are pushed to aching arousal that achieves explosive release when Zigor's yanks firmly on the nipple clamps while driving his thick knot fully into your stretched hole. You cry out and cum hard, your first volley of cum spraying past your shoulder and staining the floor past you. Shot after shot of your [cum load size of player] load sprays onto your [bodydesc of player] body, leaving you increasingly sticky with semen. Clearly enjoying the messy state he's driven you to, he growls and cums, shooting his own heavy load into your bowels as he stakes a fresh claim on your ass. In the end, you are left sticky with seed both inside and out.[mimpregchance]";
	else:
		say "     Under the constant fucking and teasing, you are pushed to aching arousal that can only build and build, your semen trapped in your balls by the cock ring. The wolf grins at your moans and whimpers, telling you how sexy he finds them, and drives his knot deep inside you. With his cock buried fully inside you, he cums, shooting his heavy load into your bowels as he stakes a fresh claim on your ass. As you feel his seed filling you, he pops the clasp on the leather strap restraining your loins. You cry out in orgasmic relief and cum very hard, your first several blasts spraying past your shoulder to stain the floor past you. Shot after shot of your [cum load size of player] load sprays onto your [bodydesc of player] body, leaving you increasingly sticky with semen. In the end, you are left sticky with seed both inside and out.[mimpregchance]";
	if baby is 0 and gestation of child is not 0:
		now facename of child is "Leather Wolf";
		now bodyname of child is "Leather Wolf";
		now skinname of child is "Leather Wolf";


to say zigor_S2_03_MM:	[stage 3 - gangbang/orgy - Mx7]
	say "     When you enter the dungeon, you find it already occupied and in use by a half dozen other leather-clad wolves like your master. You stop short at the sight of them, taking in the sight of them and their carnal acts. Three of them are strapped down or chained up while the others inflict punishment, fuck them or both. Your focus shifts rapidly between them as each subby slave's moans of lust draw your attention. The scent of leather and lupine sex is very thick in the air, clouding your mind with your body's training reacts with arousal to it. It is only when Zigor gives you a firm push forward that you stumble into the room and into their midst.";
	say "     'Do not keep our guests waiting, mi cachorro. I invited them specifically for you, after all,' he rumbles sexily in your ear, his paws roaming over your body. His sensual touch helps you relax a little, but you still feel a little uneasy now that the predatory eyes of the three other doms and the lustful gaze of theirs pets are all on you.";
	say "     You are led over to a padded bench that you're quite familiar with at this point. At your master's firm prompting, you place yourself on it and put your wrists and ankles into the cuffs to be shackled down. You're treated to a few more sensual touches to get you aroused before he moves on to working a lupine-shaped toy into your anus. Compared to some he's used, it's just a warm-up, enough to get you extra-randy while opening you up.";
	say "     'Look around, my pet,' he rumbles in your ear with his rich Iberian accent. 'See their lovely playthings - how obedient they are, how much they enjoy their discipline, how pleased their masters are with them. So well trained and decked out in such lovely leather gear. Some of my best work, I must say.' Zigor turns your head from one pair to the next so you can watch them. You have been placed in the center of the room and positioned such that you're able to see each group, though the subby pets can only strain to see you given how they're bound, often tied directly to the straps or metal links built right into their hide.";
	say "     The dominated wolf pets pant and moan in painful delight as their masters have their way with them, but none are allowed release as their masters move back before their sub's orgasm. They whimper with need, but say nothing, left hard and dripping, but awaiting on their masters to finish them off. The dominant wolves instead move to approach you with confidence, their sexy bodies and throbbing cocks making your own manhood throb with desire.";
	say "     One of them, a wolf as black in fur as the leathers of his hide, steps up first, presenting his cock to you with a rumble. Without realizing, you open your mouth for it, but are swatted firmly across the rear by Zigor's riding crop. 'Did I give you permission yet, bobo?' He gives you another whack. 'Your eagerness is good, my mascota, but always obtain your master's permission. Now,' he says, stroking your throbbing cock, 'service these fine wolves like the good sub you are. And no speaking until I permit it.'";
	say "     Even more eager than before now that you've been given permission (and the promise) to be able to service these lupine studs, you open your mouth and welcome in the black's pulsing cock with a lick and a moan of desire. He grabs your head roughly in his metal-studded paws and pounds his thick penis into your open mouth. Wanting to prove yourself and to satisfy your master's friend, you lick and suck on his knotted shaft even as he fucks your face hard.";
	say "     You catch sight of the next of them, a gray of possibly timberwolf stock, move around behind you. He runs his paws over your ass and takes hold of the toy buried inside you. Giggling it around, he grinds it against your prostate teasingly before popping it out. Your spread hole is given a slow lick before the tongue is replaced by something harder and hotter, the leather wolf's cock. He takes it slow, easing his meat into you in a surprisingly gentle manner. Once inside, he just leaves it there - unmoving despite your growing desire to be fucked. You whimper and try to push back and forth, but he moves with you, limiting your stimulation.";
	say "     It is at this time that the third joins in, a darker gray than the other, by lashing you with the flog he was using on his pet earlier. The sudden blow causes your body to shudder and pull at your restrains, as well as have your throat and anus lock momentarily around the pulsing rods stuffed into them. You're lashed a second and then a third time, your body responding in kind. But the third blow also comes with a reward, the wolf in your ass takes thrust into your clenching asshole. It is a tight fuck that makes your insides ache a little, but it is a good ache after your longing to feel him fuck you. More blows come, each with a thrust from the lupine stud buried in your backside.";
	say "     As this continues, Zigor rumbles in your ear about what a good pet and obedient pet you are to service his friends. Encouraged by his words, you try all the harder to satisfy them for him. And seeing your eagerness, Zigor wraps a paw around your shaft and starts stroking it in reward for your efforts. And hearing the lustful whimpers and panting of the trio of restrained pets watching you be fucked by their masters while they're left on edge turns you on all the more.";
	say "     The black stud in your mouth, despite your best efforts and his raging fucking of your mouth, seems to have great endurance and continues to hold out. The timberwolf in your ass has remained stoically restrained and so has also not reached his peak. Under Zigor's skillful touch and the second wolf's controlled fucking, it takes a long time before your climax is approaching. Your [cock of player] cock pulses and throbs in the Zigor's paw, drooling copious amounts of pre, only to have that paw taken away as the lupine shafts in your ass and mouth are withdrawn. You whimper with need and almost beg for them to finish you off, to finish in you. But you obey your master's earlier order to hold your tongue, wanting to prove yourself as obedient as the other pets on display around you. The quartet of wolf studs eye you critically for a few moments while your need to climax ebbs to a dull ache, as if assessing your performance, before Zigor gives a nod and the three move in again, taking new positions.";
	say "     Taking your ass this time, the black wolf drives his saliva-slick cock into your pucker and buries it deep in your ass. He fucks you with the same wildness as he did your face. Your vacated mouth is claimed by the wolf flogging you earlier, who has swapped it for a choke chain he tugs on occasionally. The constriction is sudden and painful, but you keep licking to keep the sadistic wolf satisfied to delay him from pulling again. The last of them, the timberwolf, moves beneath you. Taking your balls in paw, he fondles them while licking and sucking at your achingly hard shaft with surprising vigor given his earlier self-restraint.";
	say "     Under this new assault, you don't last long and are thankfully given permission by your master to cum. Your achingly full balls send their hot load shooting through your shaft, into the lustful wolf's muzzle. Your cry of lustful release ends up cut off though as the choke chain is pulled and the gray wolf cums as well, filling your mouth to overflowing as your constricted throat has trouble getting it down. The black drives himself hard and deep into you, tying with your ass and unleashing blast after blast of lupine spunk into your bowels while he bites down on your neck with a growl. At this point, the pain and the pleasure are equal delights to you and you revel in your long-delayed release.";
	say "     Your only disappointment comes when Zigor pushes away the timberwolf from your cock. 'Do not be greedy. You know I need his seed,' your master growls as he gives him what you can hear as a whack with his riding crop. Your master replaces the muzzle with his paw, stroking you through your release as he gathers the rest of your cum as he has before. The chastised wolf moves in front of you, claiming your mouth after the other wolf has finished and released the chain. You're still struggling to swallow down the thick load in your mouth when the timberwolf's cock is stuffed in there. You smear the gooey cum across the lupine penis and bring him to orgasm while waiting for the black's knot to go down and be popped free.";
	say "     With the three wolf studs spent, you think at first your task must be done, but your master has more in store for you. Each of the three restrained pets are led over and allowed to mate you in turn. Having been long on edge and then forced to watch their masters['] fucking you instead, they are extra-vigorous in their use of your already sticky hole in what must be a rare privilege of theirs to be on top. While their individual masters bring them over, it is Zigor who directs them all, masters and pets alike. Before it's all over, you end up cumming again into the collection bucket. Your aching ass is left sore and leaking cum from the many wolves who've claimed it this session, their combined load oozing out of you. You can feel it [if cockname of player is not listed in infections of Internallist]clinging to your balls and [end if]running down your legs, leaving you feeling like the well-used fucktoy that you are. And once you're released, Zigor pushes you over onto your back and stands overtop you, masturbating his impressive manhood and cumming across your body. Reeking of lupine sex and sticky with the semen of the many wolves, you stagger weakly back up the stairs.";
	if player is mpreg_able, impregnate with "Leather Wolf"; [guaranteed mpreg if possible]


to say zigor_S2_04_MM:		[ stage 4 - offer of finale - MM ]
	now zigseat is 0;
	if bodyname of player is listed in infections of taurlist:
		now zigseat is 1;
	if zigorcycle is false:
		say "     Taken down into Zigor's private playroom once again, you are led to an unusual [if zigseat is 1]bench designed for taurs[else]chair[end if], one that you don't see here during your normal visits. Built of strong metal and padded with leather, it has a series of levers on its side and some large gears and pistons obscured by the shadows beneath it. He motions with a crop for you to take a seat. Obediently, you sit in the raised [if zigseat is 1]bench[else]chair[end if], letting him strap down your wrists, ankles and waist with leather buckles.";
		say "     'Your training has been coming along well, mi cachorro,' he says as he brings his dark manhood to your lips. After slapping your cheek with his meat, he makes a slight motion with his paw, granting you permission to start sucking, which you do without even thinking. You work your tongue and palate over his lupine shaft, eager to please him. After letting you go down on his cock for a few minutes, he has you stop. You give a little whine of disappointment, but obey.";
		say "     'Si. Very good,' he rumbles in your ear, his rich accent smooth and suave as he reinforces his work by taking your [cock of player] cock in hand and stroking your stiff erection. His confident, controlling touch feels so good. Your shaft throbs and drools pre freely. 'It feels good to obey your master, does it not?' he rumbles, letting the crop run along your penis from base to shaft. You nod quickly in response, both from your enjoyment and to avoid punishment. Though the prospect of punishment makes you all the more aroused somehow.";
		say "     'I have prepared something for you, carino. I know you've taken an interest in our wares here and I have said our supplies are low, but as your master, I feel you've earned a special reward.' From a case you failed to notice earlier, he pulls out something made of black leather with a jingle straps and buckles. Holding it up for you to get a good look at it, you can see it is a leather mask, lupine in shape and similar to those you've seen on his wolf staff upstairs. There's spaces for eye holes and ear slits, but most of the rest is leather. Even the muzzle is encased and sealed with a zipper. Permeated with the scents of leather and sex, you can tell there will be no turning back from this. But a part of you - trained and conditioned by the wolf - longs for this.";
	if zigorcycle is true:
		say "     Led down into Zigor's private playroom once again, you are once again met with the sight of that torture seat of metal and leather he used on you previously. [if zigseat is 1]. It has been configured as a bench to suit the size and shape of your currently tauric body. You hesitate momentarily before moving atop it[else]. You hesitate momentarily before getting into it[end if] when the dominant wolf orders you to do so. He secures your wrists, ankles and waist atop it with leather buckles. His touch is gentle but firm as he tightens the straps extra-snug before running over your body in tender caresses.";
		say "     'You have been doing so well with your re-training of late, mi cachorro,' he says as he brings his dark manhood to your lips again. Caressing your cheek, he motions that you may take his cock into your mouth and you do so without even thinking. The tantalizing scent of it, rich and masculine, is too much to resist now that you've been breathing in the heady smells of leather and lupine sex suffusing the air down here. You work your tongue and palate over his lupine shaft, eager to please him. After letting you go down on his cock for a few minutes, he has you stop. You give a little whine of disappointment, but obey.";
		say "     'Si. Very good,' he rumbles in your ear, his rich accent smooth and suave as he reinforces his work by taking your [cock of player] cock in hand and stroking your stiff erection. His confident, controlling touch feels so good. Your shaft throbs and drools pre freely. 'It feels good to obey your master, does it not?' he rumbles, letting the crop run along your penis from base to shaft. You nod quickly in response, both from your enjoyment and to avoid punishment. Though the prospect of punishment makes you all the more aroused somehow.";
		say "     'You are here once again,' he says softly in your ear, 'to see if you've thought over my offer again and come to the proper conclusion. I am hoping that your re-training has helped you understand just what a privilege it is to receive one of my personal creations.' From a case tucked largely out of view, he once again pulls out the bundle of black leather, straps and buckles that is the leather mask he's designed for you. Lupine in shape and similar to those you've seen on his wolf staff upstairs, it is still unique in its own right and individualized just for you. There's spaces for eye holes and ear slits, but most of the rest is leather. Even the muzzle is encased and sealed with a zipper. Permeated with the scents of leather and sex, your training and conditioning by the wolf makes you long to put it on, but a corner of your mind knows that there will be no turning back from this.";
	say "     [bold type]Shall you accept?[roman type][line break]";
	LineBreak;
	say "     ([link]Y[as]y[end link]) - Yes.";
	say "     ([link]N[as]n[end link]) - No.";
	if player consents:
		say "     Succumbing to the temptation, you accept the gift, asking your master to put it on. With a toothy, predatory smile, he places it on your head. 'That's a good pup,' he rumbles sexily as the buckles are snapped and straps tightened. Inside, the leather is smooth and soft, like the best of suede. The mask doesn't really fit right, loose in spots and tight in others, but that is soon to change... or rather you are.";
		say "     The leather, having been treated and tanned with your semen mixed into the dye, bonds readily with your skin. And the lupine scent of your master is there as well, his contribution making your body change. Your face forms a muzzle that fits snugly in its new housing and then merges with it. You can feel the tight leather around your muzzle, now a part of it. Even the cool metal zipper sealing it shut and the d-rings are a part of you. Your vision blurs briefly and your ears ring as they shift as well. Wolf ears poke from the gaps for them and you open your new, lupine eyes to look at the world differently.";
		if zigseat is 0:
			say "     But the transformation only starts there. Zigor's paw finds its way back to your cock, stroking it as it changes, forming a lupine sheath and knot as well as a leather scrotal sac to cradle your [ball size]. Your body becomes fit and firmly muscled under a layer of fur and leather. Much of your chest is covered with the cured black smoothness, though your nipples are left exposed with large o-rings encircling your areolae. Your leathery sections include straps and buckles built in to harness or restrain you as desired by your Iberian master. The thought of being tied up so directly - so intimately - makes you release a muffled moan through the enclosing mask.";
			say "     This transformation continues to spread to your limbs. Your forearms and wrists gain leather guards that can double as restraints. Your legs are more covered, with assless chaps and ankle cuffs adorning them. You feel a swell of power inside you, restrained and controlled by your bonds and your master's will. The sensation fills you with a rush of excitement that bursts forth from your cock as a powerful orgasm.";
		else if zigseat is 1:
			say "     But the transformation only starts there. Zigor's paw finds its way back to your cock, stroking it as it changes, forming a lupine sheath and knot as well as a leather scrotal sac to cradle your [ball size]. Your body becomes fit and firmly muscled under a layer of fur and leather. Much of your humanoid chest is covered with the cured black smoothness, though your nipples are left exposed with large o-rings encircling your areolae. Your leathery sections include straps and buckles built in to harness or restrain you as desired by your Iberian master. The thought of being tied up so directly - so intimately - makes you release a muffled moan through the enclosing mask.";
			say "     This transformation continues to spread to your tauric body and limbs. Your lower body takes on a decidedly lupine shape with much more of it covered in fur, though there is a prominent, saddle-like structure that forms on the back of it. Its formation is accompanied by a strange bulging on your upper back as leather-clad handles grow out from just under your shoulders. Your forearms and wrists gain leather guards that can double as restraints. Your legs are more covered, with assless chaps and ankle cuffs adorning them. You feel a swell of power inside you, restrained and controlled by your bonds and your master's will. The sensation fills you with a rush of excitement that bursts forth from your cock as a powerful orgasm.";
		say "     Zigor seems quite pleased with his work, inspecting your altered form as an artist appraises his masterpiece. You are looked over with critical detail as his paws roam over you. The living leather can feel his touch as much as your furred skin, though each is delightfully different. And while some minor facets do not satisfy him as he tugs on some of your straps and examines the contours of your seams between fur and hide, he seems overall satisfied with his newest leather creation and pet. This critical inspection with its mix of evaluating and sensual touches also provides time to recover from your orgasm and to become hard all over again.";
		say "     Releasing you from the [if zigseat is 1]bench[else]chair[end if] now that you're fully transformed, he orders you to your knees to suck his throbbing cock. You do this with a lustful eagerness made all the faster from your desire to obey your lupine master, but can only release a muffled whimper and rub your muzzled snout against his meat. You struggle to open the zipper, but it won't move for you - a part of you knowing only those permitted by your master can do so. You whimper all the louder, the strong scent of his cock right there, leaking through your nose holes, but denied to you.";
		say "     Zigor grins at your dilemma and growls for you to get on all fours, smacking your furry bottom with the crop. You're given several more hard swats, a delightful punishment for being unable to orally satisfy the alpha wolf. Taking a moment to lubricate your tight, leathery tailhole with some leather oil, he pushes a vibrating plug into your ass. While the wide toy buzzes away softly, keeping you at a fixed level of arousal, he secures your ankles and knees to the floor and your wrists to long chains from the ceiling. With you now kneeling upright, he moves in behind you and replaces the butt plug with his big, lupine cock. He pushes that mighty rod of his deep into your bowels with a satisfied rumble that makes you so happy deep inside.";
		say "     The dominant wolf takes his sweet time enjoying his new prize pet, his paws moving sensually over every part of you. The seams between leather and fur prove to be particularly sensitive, giving you both the smoothness of the oiled hide and the soft brush across fur. He takes great pleasure in savoring his first fuck to claim this new body of yours. It feels like hours that he's fucking you, taking pauses to inflict the delightful pain of his crop, whip and others while the vibrating toy keeps you aroused, but longing for the proper fullness of his wolfhood inside you. Eventually though, his pace switches to a wild and frantic pounding that has him bury and lock his thick knot inside you, fucking you to a muffled (on your part), howling climax that leaves you leaking wolf cum from your battered asshole.";
		say "     When his knot finally goes down and he pulls out, hot lupine seed drains from your abused hole and pools beneath you. You're left suspended like that, your master leaving you tied up in the dark basement while he returns to his atelier. He eventually returns much later with the other dominant wolves to show them his newest creation and sex pet, each of them quite enjoying the opportunity to examine the artisan's newest work. Together they put you through your paces, fucking you multiple times while praising Zigor's craftsmanship even while punishing you for every minor flaw or imperfect attempt to satisfy them. You prove to be quite responsive to this treatment and are a great hit with the wolves, if the strength and volume of their orgasms are to be any true judge[if zigseat is 1]. They seem quite excited at having a tauric leather wolf to join their pack's sex slaves[end if]. You are left aching and satisfied by the end of it, additionally pleased that you are deemed ready to be brought upstairs and put to work with the others in the leatherwork shop.";
		say "     You are his sex slave and his property now - and nothing could please you more than that.";
		now humanity of player is 0;
		now bodyname of player is "Leather Wolf";
		now facename of player is "Leather Wolf";
		now skinname of player is "Leather Wolf";
		now tailname of player is "Leather Wolf";
		now cockname of player is "Leather Wolf";
		now body of player is "[if zigseat is 0]muscled and toned, though much of this is concealed by your leathery bondage suit[else]that of a tauric wolf, muscled and toned, though much of this is concealed by your leathery bondage suit[end if]. It is adorned with several buckles and straps, perfect for restraining or harnessing you as your master sees fit[if zigseat is 1]. Your build-in bondage gear includes a black saddle and handles just beneath your shoulders[end if]";
		now face of player is "almost entirely covered by a muzzled mask of leather, with only your wolf ears and eyes visible through it. Lupine in shape and bonded to your head, it is as much a part of you as the rest of your leather-bound skin";
		now skin of player is "black leather and lupine furred";
		now tail of player is "You have a fluffy wolf tail protruding from just above your furry ass. Even it has a few bands of leather and metal loops on it to tie it up so your ebon tailhole cannot be covered.";
		now cock of player is "lupine";
		if zigseat is 1:
			now scalevalue of player is 4;
			now bodydesc of player is "tauric";
		else:
			now scalevalue of player is 3;
			now bodydesc of player is "strong";
		now bodytype of player is "lupine";
		now SleepRhythm of player is 0;
		wait for any key;
		end the story saying "You have been turned into Zigor's latest leather wolf plaything.";
		now battleground is "void";
		wait for any key;
		now skipturnblocker is 1;
		follow the turnpass rule;
		stop the action;
	else:
		say "     Zigor's gaze turns into a steely glare as he whips the leather mask aside. 'And here I had hoped you were ready to accept your place here, but clearly not. How disappointing,' he says, leaning in to growl that last word into your ear as he throws a lever on the [if zigseat is 1]bench-like[else]chair-like[end if]. Pulling on it sets some gears in motion and there is the soft hiss of compressed air running to the pistons built into it. This causes your seat to lurch, your body to pitch forward and your limbs to be spread at an uncomfortable angle. 'I do not like to be disappointing,' he growls. 'Clearly your training needs more [']reinforcement['].' And with that final word, he yanks on the lever again, this time driving the apparatus to twist your limbs at a painful angle all while raising your ass end into the air[if zigseat is 0]. The wolf unlatches and flips the seat out of the way, leaving him with direct access to your puckered ring[else]. The wolf gives your raised rear a hard slap with his paw, it now angled up, giving him direct access to your puckered ring[end if]. With no more preamble, he presses his hefty lupine prick to your back door and drives hard into you, burying more than half of it in a sudden, stinging thrust.";
		say "     'You should appreciate the time I am spending on you, bobo. I have a store to run and many other leather bitches eager for their master's cock,' he rumbles as he drives the rest of his mighty manhood into you with another authoritative thrust. Grabbing a different lever this time, he gives it a yank down several notches. This twists your limbs, rotating them within their already uncomfortable position. After sending this fresh jolt of pain through you, he starts pounding away before even your stretchable ass can quite adjust to the rapid penetration. Your body rapidly returns to full arousal, the pain and the pleasure becoming blurred, your body simply aching for more stimulation. You begin to look forward to the next click of the levers almost as much as you are to the firm smash of his knot against your spreading hole.";
		say "     While you can tell the wolf was looking forward to taking his time enjoying fucking you, his anger has driven him to take you hard and fast. Despite your painful position, you do your best to drag it out for him, holding back your own release so he might be sated. Eventually though, you can't resist any longer and you beg him to knot you. Grabbing your twisted shoulders, he yanks hard and drives his bulging knot into you with a howl. The hot rush of his seed pours into you with steady, rhythmic bursts that leave you full and leaking. Your dangling cock twitches wildly, splattering your own load across the floor as you give a long, moaning cry.";
		say "     'Perhaps there is still hope for you, mi cachorro. I want you to come back soon to renew your training.' Popping his half-deflated knot from your hole releases a gush of gooey wolf seed. He has you lick his sticky prick clean before pulling a release on the contraption holding you. Your twisted body drops to the sticky floor in a heap. You're left alone in your mess with only the slow clicking as the machine ratchets back gradually, one click every few seconds. It takes a few minutes before returning to its original, [if zigseat is 1]bench-like[else]chair-like[end if] configuration. Between the torture [if zigseat is 1]bench[else]chair[end if] and the violent fucking, it is many more before you're recovered enough to stand and stagger your way back upstairs.";
		now HP of Zigor is 9; [reset cycle]
		now zigorcycle is true;

to say randomwolfgimp:
	say "[one of]Miguel[or]Emilio[or]Fernando[or]Javier[in random order]";


when play ends:
	if bodyname of player is "Leather Wolf":
		say "     You join Zigor's personal collection of sex slaves as his new favorite. You and the others labor silently in his atelier, making new kinky leather creations for his customers and the other dominant wolves. Being Zigor's favorite is a mixed blessing, with him giving more of his particular brand of rough love to you than the others[if zigseat is 1]. You are also particularly popular with the other doms, your master receiving frequent requests from them to play with his special taur plaything[end if]. And should your master's other subs be jealous of your status, nothing is ever said by the other muzzled subs.";
		say "     At first, you're only vaguely aware of the military incursion into the city as an increase in the workload imposed on all of you. Your master becomes quite focused on his workshop and quite strict about every precious scrap from the dwindling supplies being used. The [']grand re-opening['] coincides with the army entering the area and your suave master is able to coax some soldiers into sampling his wares. As well, the other doms are [']aggressively forward['] in their insistence that the soldiers they run into be brought to the shop as well. From there, it is easy for one of the lupine doms to entice them into becoming another sub for them. With this surge in numbers, the leather wolves spread out, many of them forming franchise outlets for Zigor's particular brand of lupine apparel or setting up supply chains to ensure a fresh supply of tanned hide for your master's atelier.";
		if zigseat is 1:
			say "     As these new locations open, your true purpose is revealed. Your strong, tauric body is lashed to a wooden cart and you are made to pull supplies and complete product runs to and from the main store. It is a tough task, but one your well-disciplined mind and body accept as your proper place. It also comes with the added perks of the lashings of the driver and their lustful thanks during and after the long hauls. At those rare times that the other creatures of the city threaten the wolves['] territory and the leatherworking den, you are ridden out by your master as his epic steed as he leads the pack into battle like a noble Spanish general.";


[      HP of Zigor      ]
[ 0 = not been to store ]
[ 1 = seen store        ]
[ 2 = talked to Zigor   ]
[ 3 = session 1         ]
[ 4 = session 2         ]
[ 4 = session 3+        ]
[ 12 = had orgy session - leather gear next ]
[ 13 = game over as leather pet ]

[      XP of Zigor      ]
[ 0 = no anal training  ]
[ 1 = anal training 1   ]
[ 2 = anal training 2   ]
[ 3 = training done     ]
[ 4 = Twisted Capacity  ]


[options:
doggy style locking spreader
sex swing
spreaders
chains/bracelets/anklets
rack
bit gag
...
]


[ carino - sweetheart
mascota - pet
cachorro - pup/cub
bobo (boba) - fool ]
[
length of delay check
]

Zigor ends here.
