Tenrec by StripeGuy begins here.
[Version 1.1 - Typo fixes - Wahn]

"Adds a Tenrec to Flexible Survival's Wandering Monsters table, With Impreg chance"


Section 1 - Monster Responses

when play begins:
	add { "Tenrec" } to infections of guy;
	add { "Tenrec" } to infections of furry;
	add { "Tenrec" } to infections of Tailweapon;    [usable for Tail Strike feat]


To say Tenrec Victory:
	if inasituation is false:
		if player is herm:				[herm]
			say "[Tenrec HermVic]";
		else if player is female:		[female]
			say "[Tenrec FemVic]";
		else if player is male:		[male]
			say "[Tenrec MaleVic]";
		else if player is neuter:		[Neuter]
			say "[Tenrec NeutVic]";
		else:
			say "Weird, some error occurred! Better call on some professional, maybe some Guy with Stripes? A StripeGuy, if you would.";
	else:
		say "";

To say Tenrec NeutVic:
	say "The otter-shrew dusts off his bright yellow coat as you hit the ground, panting lightly. 'Glad I reeled you in at last.' He saunters over, long flat tail undulating like a snake and lifting to maintain balance as he pushes you over with a foot. He pulls your clothes off, taking a look at your [bodydesc of player], [bodytype of player] body. 'The hell is this? Not a cunt or cock on your body!' He snorts, idly tugging on his flushed cock, dribbling musky precum into a growing puddle. 'That just ain't no fucking fun, if you follow my drift there, sugar.' With an annoyed grumble, the fish-scented stud looks left and then right, as if some better equipped whore might be flopped out on display.";
	LineBreak;
	say "'I guess I'll just have to make do.' [one of]The slender tenrec stud whips his tail around your chest, pulling it upwards. 'Come on, open up!' Having been scolded once for being ill-equipped and woozy from your defeat, there is no strength left in you to struggle. On the contrary - and this just might be the effect of his nanite laden musk screwing with your head, you feel a drive to somewhat make amends for the insult you've laid at the feet of this animalistic victor. When his thick, dripping cock reaches your face, you've already opened wide. Without much enthusiasm, the grumbling otter-shrew plunges within, gripping your head so he can really force a fast jackhammer into your face.[or]He rolls you over with a foot, kneeling down to straddle your thighs. 'At least you still got one hole. Shame I've got little else to play with.' With a long-suffering sigh, the tenrec leans in and jams his dripping cock into your asshole. He starts rabbit-thrusting immediately, to get things done with quickly.[at random]";
	LineBreak;
	say "'You'll be in better shape after this. Better to play with, or fish with.' He huffs, quickly reaching his climax. The barking and shuddering is a good indicator, but then again so is the feeling of his hot infectious cum filling you up. With a chuff, the male pulls out of you, not bothering to stop his final spurts from splattering on your [skin of player] skin. 'Come back when you are in better shape, alright?' He re-buttons his coat, and walks back toward his boat, muttering complaints under his breath.";

To say Tenrec FemVic:
	say "The otter-shrew discards his bright yellow coat, setting it aside as you fall, defeated. Without the thick rubber to hold in his scent, the powerful musk from his body billows out. The scent assaults your nose with its rich, fishy odor, lighting up the pathways leading to all your erogenous zones. Your [breasts of player] breasts begin to warm, nipples tingling in anticipation of his touch as his scent envelopes you. The tenrec moves forward using slow steps, his tail undulating behind him and dripping cock leading the way. 'Wrists together, up in the air.' His calm, masculine voice brooks no dissent, and in a lusty daze you lift your arms up. The sleek stud steps up closer, his dribbling cock splashing precum across your [skin of player] skin, setting your cunt[sfn] afire with lust as his dexterous paws knots a bit of rope around your wrists with a sailor's ease. 'Up you go.' With a wide, lusty grin the limber stud dips his head under your arms, resting those newly knotted wrists on the nape of his neck.";
	LineBreak;
	say "His strength is surprising, the tenrec lifting you into the air with only a modest grunt and the power of his legs. Your back slams against sailcloth and timber, your [bodydesc of player] frame quivering in submissive delight at the surge of dominance from the unassuming fisherman. 'You need this cock inside your cunt, don't you lass? No shame in confessing.' The rough, oily fur of his chest grinds against your [breasts of player] breasts as he presses closer, the tip of his tapered length teasing along the folds of your puss[yfn]. Victim of his sensual assault, you can do little but moan in assent. You don't just want that cock, you need it! The fires of lust have been stoked from your tits to your cunt[sfn] and only his seed can extinguish them!";
	LineBreak;
	say "When his fat cock slams into your [cunt size desc of player] cunt, it is more of a relief than anything else! How could you have even thought to fight against the amazing pleasure radiating from your needy snatch! Unbidden, your legs circle around the slender male's waist, drawing that thick cock even deeper into your cunt! This frees up his paws, which immediately roam to grasp and toy with your [breast size desc of player] tits, toying with your nipples like an errant reel. Not content with just tormenting you on two fronts, his thick muscled tail curls up and [if anallevel is 3]swirls around your taut asshole, dimpling the ring before penetrating shallowly[else]swats across your ass in time with his thrusts[end if], driving you to impale yourself all the more enthusiastically. If you weren't properly tied and pinned firmly, you would be flopping like a fish, much to your chagrin! He just has a way of taking control of your body with every thrust and slap of flesh on flesh, his jabbing cock forcing slutty moans and cries of pleasure from you until your throat grows hoarse.";
	LineBreak;
	say "The tenrec keeps his muzzle close to your ears, nibbling and slobbering on your neck as a dominant gesture. 'Yeah, you like that? Just another slut for me.' His hips rock and thrust, forcing your [breasts of player] tits to bounce in his hands, and juice from your cunt[sfn] to splatter across the ground and his crotch. Those juices are all over his cock, too, from the double orgasms he has already fucked into your body. Another one is approaching, seemingly in time with his own, if his panting and barking is an indicator. With a sudden forceful thrust, he sinks in as deeply as your cunt will allow before spraying a copious load of his cum into you. In response, you gush with a load of femjuices, flooding outward to splatter across the floor. With a low, satisfied groan, the tenrec lowers you to the ground and settles you right in the puddle of your combined juices. 'Ah, much better.' With a low hiss, he draws out from your cunt and gives the knots around your wrists a tug. Freed of the rope and from his amazing cock, you are left to recover in the mess you've both made. 'Consider that just a taste of the sign-on bonus you'll receive when you come on board.' He smirks, picking up his jacket and walking off.[fimpregchance]";

To say Tenrec MaleVic:
	say "The otter-shrew snorts though his small nose, whiskers flicking from side to side as you slump over in defeat. 'Why didn't you just give up? That was barely a fight - but you seem like barely a male so I suppose that is fair.' He drops his coat to the ground, claws clicking as he strolls over. 'Up you go, and over...' He is surprisingly strong, dragging your [bodydesc of player] body up and onto a convenient pile of folded up nets and sails. Folded over it, you are at his mercy, the tenrec's clever paws lifting your tail and spreading the asscheeks beneath. 'Look at that...' he churrs, appreciatively, [if anallevel is 3]his breath hot across your rosebud. With a deep rumble he swipes his tongue out, gently rimming your manhole[else]stroking his fingers across your rosebud with a skillful teasing to stoke your flames of arousal[end if]. You have to wonder why you bothered fighting, when the male's teasing already has you so horny, your [cock size desc of player] [cock of player] prick dribbling a steady stream onto the sailcloth.";
	LineBreak;
	say "Those surprisingly strong paws trace their way up your asscheeks as the tenrec stops priming your pump, having put you in the proper mindset. Brain swirling with a submissive need to be penetrated, to get your asshole filled to the brim, you let out quiet begging moans. 'I know, your ass is hungry. You gotta get bred.' Already dizzy, the world begins to spin when you shake your head enthusiastically. Teasingly, the ottershrew hotdogs his fat prick between your asscheeks, rocking his hips back and forth. His hefty ballsack softly collides with your [ball size], and with that touch this encounter becomes decidedly gay. You are well past that fear though, the haze of your lust and need overwhelming all your other concerns! You pant, you moan, you beg in half-whispers as the tapered head of his cock teases on your well-primed asshole.";
	LineBreak;
	say "He sinks into you with a slow, measured motion that is almost as torturous as the teasing. You need his full length inside of you, and you need it now! If only you had the strength to take it, but you have already proved that you are weak in comparison to him. He is deserving of the control that you should have given him, control over your sweet ass wrapped around his fat prick, control over your dripping cock, your desires, even your will. A thought bubbles to the surface, the same way his overflowing precum leaks from your anal ring. The nanites are already working on you, altering the way you think and act. Already things are spiraling out of control, moans and barks coming out of your mouth unbidden when the tenrec starts to jackhammer, his burbling tip playing on your prostate like a joy buzzer. One of his paws drops down, reaching around your hip to give the rock hard [if cock length of player is 1]inch of meat[else][cock length of player] inches[end if] you're sporting a friendly reach around. 'You could get this every day, if you come join the crew.'[mimpregchance]";

To say Tenrec NeutVic:
	say "The otter-shrew dusts off his bright yellow coat as you hit the ground, panting lightly. 'Glad I reeled you in at last.' He saunters over, long flat tail undulating like a snake and lifting to maintain balance as he pushes you over with a foot. He pulls your clothes off, taking a look at your [bodydesc of player] [bodytype of player] body. 'The hell is this? Not a cunt or cock on your body!' He snorts, idly tugging on his flushed cock, dribbling musky precum into a growing puddle. 'That just ain't no fucking fun, if you follow my drift there, sugar.' With an annoyed grumble, the fish-scented stud looks left and then right, as if some better equipped whore might be flopped out on display.";
	LineBreak;
	say "'I guess I'll just have to make do.' [one of]The slender tenrec stud whips his tail around your chest, pulling it upwards. 'Come on, open up!' Having been scolded once for being ill-equipped and woozy from your defeat, there is no strength left in you to struggle. On the contrary - and this just might be the effect of his nanite laden musk screwing with your head, you feel a drive to somewhat make amends for the insult you've laid at the feet of this animalistic victor. When his thick, dripping cock reaches your face, you've already opened wide. Without much enthusiasm, the grumbling otter-shrew plunges within, gripping your head so he can really force a fast jackhammer into your face[or]He rolls you over with a foot, kneeling down to straddle your thighs. 'At least you still got one hole. Shame I've got little else to play with.' With a long-suffering sigh, the tenrec leans in and jams his dripping cock into your asshole. He starts rabbit-thrusting immediately, to get things done with quickly[at random].";
	LineBreak;
	say "'You'll be in better shape after this. Better to play with, or fish with.' He huffs, quickly reaching his climax. The barking and shuddering is a good indicator, but then again so is the feeling of his hot infectious cum filling you up. With a chuff, the male pulls out of you, not bothering to stop his final spurts from splattering on your [skin of player] skin. 'Come back when you are in better shape, alright?' He re-buttons his coat, and walks back toward his boat, muttering complaints under his breath.";

To say Tenrec FemVic:
	say "The otter-shrew discards his bright yellow coat, setting it aside as you fall, defeated. Without the thick rubber to hold in his scent, the powerful musk from his body billows out. The scent assaults your nose with its rich, fishy odor, lighting up the pathways leading to all your erogenous zones. Your [breasts of player] breasts begin to warm, nipples tingling in anticipation of his touch as his scent envelopes you. The tenrec moves forward using slow steps, his tail undulating behind him and dripping cock leading the way. 'Wrists together, up in the air.' His calm, masculine voice brooks no dissent, and in a lusty daze you lift your arms up. The sleek stud steps up closer, his dribbling cock splashing precum across your [skin of player] skin, setting your cunt[sfn] afire with lust as his dexterous paws knots a bit of rope around your wrists with a sailor's ease. 'Up you go.' With a wide, lusty grin the limber stud dips his head under your arms, resting those newly knotted wrists on the nape of his neck.";
	LineBreak;
	say "His strength is surprising, the tenrec lifting you into the air with only a modest grunt and the power of his legs. Your back slams against sailcloth and timber, your [bodydesc of player] frame quivering in submissive delight at the surge of dominance from the unassuming fisherman. 'You need this cock inside your cunt, don't you lass? No shame in confessing.' The rough, oily fur of his chest grinds against your [breasts of player] breasts as he presses closer, the tip of his tapered length teasing along the folds of your puss[yfn]. Victim of his sensual assault, you can do little but moan in assent. You don't just want that cock, you need it! The fires of lust have been stoked from your tits to your cunt[sfn] and only his seed can extinguish them!";
	LineBreak;
	say "When his fat cock slams into your [cunt size desc of player] cunt, it is more of a relief than anything else! How could you have even thought to fight against the amazing pleasure radiating from your needy snatch! Unbidden, your legs circle around the slender male's waist, drawing that thick cock even deeper into your cunt! This frees up his paws, which immediately roam to grasp and toy with your [breast size desc of player] tits, toying with your nipples like an errant reel. Not content with just tormenting you on two fronts, his thick muscled tail curls up and [if anallevel is 3]swirls around your taut asshole, dimpling the ring before penetrating shallowly[else]swats across your ass in time with his thrusts[end if], driving you to impale yourself all the more enthusiastically. If you weren't properly tied and pinned firmly, you would be flopping like a fish, much to your chagrin! He just has a way of taking control of your body with every thrust and slap of flesh on flesh, his jabbing cock forcing slutty moans and cries of pleasure from you until your throat grows hoarse.";
	LineBreak;
	say "The tenrec keeps his muzzle close to your ears, nibbling and slobbering on your neck as a dominant gesture. 'Yeah, you like that? Just another slut for me.' His hips rock and thrust, forcing your [breasts of player] tits to bounce in his hands, and juice from your cunt[sfn] to splatter across the ground and his crotch. Those juices are all over his cock, too, from the double orgasms he has already fucked into your body. Another one is approaching, seemingly in time with his own, if his panting and barking is an indicator. With a sudden forceful thrust, he sinks in as deeply as your cunt will allow before spraying a copious load of his cum into you. In response, you gush with a load of femjuices, flooding outward to splatter across the floor. With a low, satisfied groan, the tenrec lowers you to the ground and settles you right in the puddle of your combined juices. 'Ah, much better.' With a low hiss, he draws out from your cunt and gives the knots around your wrists a tug. Freed of the rope and from his amazing cock, you are left to recover in the mess you've both made. 'Consider that just a taste of the sign-on bonus you'll receive when you come on board.' He smirks, picking up his jacket and walking off.[fimpregchance]";

To say Tenrec MaleVic:
	say "The otter-shrew snorts though his small nose, whiskers flicking from side to side as you slump over in defeat. 'Why didn't you just give up? That was barely a fight - but you seem like barely a male so I suppose that is fair.' He drops his coat to the ground, claws clicking as he strolls over. 'Up you go, and over...' He is surprisingly strong, dragging your [bodydesc of player] body up and onto a convenient pile of folded up nets and sails. Folded over it, you are at his mercy, the tenrec's clever paws lifting your tail and spreading the asscheeks beneath. 'Look at that...' he churrs, appreciatively, [if anallevel is 3]his breath hot across your rosebud. With a deep rumble he swipes his tongue out, gently rimming your manhole[else]stroking his fingers across your rosebud with a skillful teasing to stoke your flames of arousal[end if]. You have to wonder why you bothered fighting, when the male's teasing already has you so horny, your [cock size desc of player] [cock of player] prick dribbling a steady stream onto the sailcloth.";
	LineBreak;
	say "Those surprisingly strong paws trace their way up your asscheeks as the tenrec stops priming your pump, having put you in the proper mindset. Brain swirling with a submissive need to be penetrated, to get your asshole filled to the brim, you let out quiet begging moans. 'I know, your ass is hungry. You gotta get bred.' Already dizzy, the world begins to spin when you shake your head enthusiastically. Teasingly, the ottershrew hotdogs his fat prick between your asscheeks, rocking his hips back and forth. His hefty ballsack softly collides with your [ball size], and with that touch this encounter becomes decidedly gay. You are well past that fear though, the haze of your lust and need overwhelming all your other concerns! You pant, you moan, you beg in half-whispers as the tapered head of his cock teases on your well-primed asshole.";
	LineBreak;
	say "He sinks into you with a slow, measured motion that is almost as torturous as the teasing. You need his full length inside of you, and you need it now! If only you had the strength to take it, but you have already proved that you are weak in comparison to him. He is deserving of the control that you should have given him, control over your sweet ass wrapped around his fat prick, control over your dripping cock, your desires, even your will. A thought bubbles to the surface, the same way his overflowing precum leaks from your anal ring. The nanites are already working on you, altering the way you think and act. Already things are spiraling out of control, moans and barks coming out of your mouth unbidden when the tenrec starts to jackhammer, his burbling tip playing on your prostate like a joy buzzer. One of his paws drops down, reaching around your hip to give the rock hard [if cock length of player is 1]inch of meat[else][cock length of player] inches[end if] you're sporting a friendly reach around. 'You could get this every day, if you come join the crew.'[mimpregchance]";
	LineBreak;
	say "Would it be so bad to just give in and go with this male? He has beaten you, reduced you to a quivering cockslut begging for his cum, and still he has the courtesy of giving your otherwise worthless cock a friendly tugging. With every thrust the idea becomes more seductive, the rough feeling of his oily fur on your back more comforting. You could lose yourself in the feeling of being well-fucked, the slow build to your orgasm the furthest thing from your mind. You scarcely even notice when your [cum load size of player] load splatters onto the sails below you. You are too wrapped up in the feeling of that gorgeous prick sliding in and out, those hefty nuts slapping against your thighs. The real joy blossoms when he tenses up, his fat prick shuddering deep within your ass, spunking it thoroughly. A satisfied haze steals over you, a deep lethargy of submissive satisfaction as he draws out, wiping his shaft clean on your back. 'When you stop looking spunk drunk, seek me out. I have a position you can fill.' Laughing softly at his own joke, the ottershrew picks up his coat and walks off.";

To say Tenrec HermVic:
	say "The otter-shrew grooms himself briefly, paws combing through his facefur and whiskers. 'Well, I've got quite the catch here. You're like a little playground of fuck fun.' He drops his coat to the ground, tail undulating as he strolls over. 'Take a seat up here...' He is surprisingly strong, dragging your [bodydesc of player] body up and onto a convenient pile of folded up nets and sails. Planted on it, you are at his mercy, the tenrec's clever paws spreading your thighs to reveal your dripping cunt[sfn] and cock[smn]. He does it without asking, just taking complete control - and you love it. Your [breast size desc of player] tits jiggle as the fisherman reclines you backwards, lining his cock up with your [cunt size desc of player] snatch. 'Let's see, should I plunge right in here?' He smirks, one paw gripping your dripping [cock size desc of player] shaft.";
	LineBreak;
	say "He teases you for a moment, dragging his cock from your puckered asshole up to the base of your prick. He grinds the leaking tip along your cuntlips, one paw roaming up to grasp and toy with your [breast size desc of player] tits, toying with your nipple like an errant reel. 'Where to go...' [if a random chance of 1 in 5 succeeds and anallevel > 1]With a wicked grin, the tenrec sinks into your asshole, letting your needy cunt[sfn] drip and drizzle without his fat shaft to plug them up. You will have to suffer having a cock so close, but not within[else]The masterful ottershrew goes the traditional route, sinking into your smouldering cunt[end if]! It is such a relief to be finally penetrated, those paws on your cock and tits just making you so fucking horny!";
	LineBreak;
	say "You can't focus at all, just when you manage to get in a rhythm with his cock sawing in and out, his paw will work your cock just so. Or suddenly a claw pricks a nipple, throwing you completely off balance again! It's like trying to ride out a storm or choppy seas, continual chop sending your brain reeling with a primal, needy lust. Juices flow easily from your tits, cock[smn], and cunt[sfn] as he turns you into a toy for his amusement. Skillfully, he makes the two of you orgasm in tandem, his paw aiming your [cock size desc of player] cock so that your [cum load size of player] load splatters across your [breast size desc of player] jugs and face! 'Oh, that was a good ride! I'll have to do it again.' With a wink and a whistle the fisherman withdraws, strolling away with a spring in his step.";


To say Tenrec loses:
	if inasituation is false:
		if libido of player < 30 or (player is herm):
			say "'Well, you can just throw me right over the side,' the ottershrew gasps, cradling his bruised and battered body. 'You might think you are a tough guy, but you got lucky this time.' His narrow chest heaves as he struggles to catch a breath, long thick tail flopping against the ground. 'Still, you did screw up in one place.' He grins, weakly, as his tail tenses. 'You should have put a net over me.' With a bark and a sudden muscular push of his tail, the tenrec flips right over the side of the wharf, diving into the water. You'll have to catch him next time!";
		else:
			say "Left dazed and staggering after your last blow, the tenrec is left open for you to finish him off. Would you like to knock him down and [link]ride him (1)[as]1[end link], [link]use his muzzle (2)[as]2[end link] or [link]throw him back? (3)[as]3[end link]?";
			now calcnumber is 0;
			while calcnumber < 1 or calcnumber > 3:
				say "Choice? (1-3)>[run paragraph on]";
				get a number;
				if calcnumber < 1 or calcnumber > 3:
					say "Invalid choice. Pick from 1 to 3.";
			if calcnumber is 1:
				say "[Tenrec LossRide]";
			else if calcnumber is 2:
				say "[Tenrec LossOral]";
			else:
				say "Deciding you would rather not deal with this lanky fisherman, you send him tumbling into the water with a well-placed kick.";
	else:
		say "";


To say Tenrec LossRide:
	say "The otter-shrew shrugs himself out of his coat, not rising from the ground. 'I suppose you want to have your way with me? I'll try not to complain overmuch.' He even manages a weak smile as you strip off your gear, exposing you[if player is male]r cock[smn] already hard and dripping with excitement[end if]. [if player is female]Your eager cunt[sfn] drizzle[sfv] juice on the boards, wetly splattering to the tempo of your heart. [end if]The poor tenrec is awe-struck, eyes trailing down your face[if player is female], briefly pausing at your heaving [breast size desc of player] tits[end if], eventually sinking your crotch. His red-hued cock is fully hard, just shy of a foot in length and nicely shaped, sure to please. With a grin you swagger over to the prone fisherman, feet on either side of his hips.";
	LineBreak;
	say "His breath catches as you lower yourself, going slow to tease him as much as you are able to resist your own lustful urges. You do want that cock inside, but it will be on your terms, not his! When you reach down and grasp his length, the prone stud moans low. You mirror the sound as the [if player is female and a random chance of 3 in 5 succeeds]tip of his dribbling cock kisses against your [cunt size desc of player] twat, sliding in with the help of gravity and your guiding hand! [else]tapered head atop eleven inches of fat tenrec cock dimples your asshole, then opens the gateway into your male passage. [end if]The ecstasy of your penetration is shared well, those clever paws of his moving to grip your calves, then thighs, urging you to sink down onto him. You resist, if for no other reason to maintain control, but it feels so damn good! You swat away his paws, and hold just the tip inside until your thighs tingle with fatigue.";
	LineBreak;
	say "Giving in to your urges, and the pull of gravity, you sink inch by inch onto the ottershrew's fat fuckstick, letting it fill you up. When at last your hips meet his you cannot help but feel like a cat with cream, mind swirling with the warm content feeling of being well filled. 'Hot damn!' mutters the fisherman, deft paws roaming up to play with your body[if player is male]. He grips your now quite messy [cock size desc of player] prick, letting your precum run through his fingers[end if][if player is female]. Chuckling at all the juices you produce, he toys with your soft nipples, enhancing the experience[end if]. The wet sound of his cock squelching into you fills the air as you lean forward and begin to ride him like a rough sea. Feeling strength from your victory, you have all the power you need to punish that gloriously fat cock and milk your own pleasure from it! By the time you blow your load, the tenrec is bruised and nearly unconscious. Chuckling to yourself, you lift up off him, leaving the hapless ottershrew to doze it off in a puddle of your mixed juices.";


To say Tenrec LossOral:
	say "The otter-shrew drops to his knees, blitzed by your overpowering victory. Without a word you just take him by his torpedo-like head and yank him toward your crotch. There is no need for words, your [if player is male] cock[smn] already hard and ready for him to service it with[else]dripping puss[yfn] hot and aching in need to be soothed by[end if] his clever tongue. He doesn't complain, he knows better than to tussle with the true victor, but just opens his maw and gets to work. He keeps his teeth to himself, using only the soft parts of his curling oral digit to stroke and caress every contour of your junk. In the tidal wave of his rising enthusiasm, your personal sense of self restraint can only hold you for so long. With a heaving sigh you unroll into your orgasm, tension melting as your [if player is male]cock[smn] pulses, splattering your [cum load size of player] wad of cum all over his muzzle! [else]puss[yfn] clench up and then gush a torrent of female juices. [end if]Wanting to see, you shove him away, sending the tenrec tumbling onto his back. The sight of your fuck fluids dripping down his muzzle and neck adds a fun cap to your fun. With a snigger at his sticky face, you slip back into the crowds.";
	say "The otter-shrew grooms himself briefly, paws combing through his facefur and whiskers. 'Well, I've got quite the catch here. You're like a little playground of fuck fun.' He drops his coat to the ground, tail undulating as he strolls over. 'Take a seat up here...' He is surprisingly strong, dragging your [bodydesc of player] body up and onto a convenient pile of folded up nets and sails. Planted on it, you are at his mercy, the tenrec's clever paws spreading your thighs to reveal your dripping cunt[sfn] and cock[smn]. He does it without asking, just taking complete control - and you love it. Your [breast size desc of player] tits jiggle as the fisherman reclines you backwards, lining his cock up with your [cunt size desc of player] snatch. 'Let's see, should I plunge right in here?' He smirks, one paw gripping your dripping [cock size desc of player] shaft.";
	LineBreak;
	say "He teases you for a moment, dragging his cock from your puckered asshole up to the base of your prick. He grinds the leaking tip along your cuntlips, one paw roaming up to grasp and toy with your [breast size desc of player] tits, toying with your nipple like an errant reel. 'Where to go...' [if a random chance of 1 in 5 succeeds]With a wicked grin, the tenrec sinks into your asshole, letting your needy cunt[sfn] drip and drizzle without his fat shaft to plug them up. They will have to suffer having a cock so close, but not within[else]The masterful ottershrew goes the traditional route, sinking into your smouldering cunt[end if]! It is such a relief to be finally penetrated, those paws on your cock and tits just making you so fucking horny!";
	LineBreak;
	say "You can't focus at all, just when you manage to get in a rhythm with his cock sawing in and out, his paw will work your cock just so. Or suddenly a claw pricks a nipple, throwing you completely off balance again! It's like trying to ride out a storm or choppy seas, continual chop sending your brain reeling with a primal, needy lust. Juices flow easily from your tits, cock[smn], and cunt[sfn] as he turns you into a toy for his amusement. Skillfully, he makes the two of you orgasm in tandem, his paw aiming your [cock size desc of player] cock so that your [cum load size of player] load splatters across your [breast size desc of player] jugs and face! 'Oh, that was a good ride! I'll have to do it again.' With a wink and a whistle the fisherman withdraws, strolling away with a spring in his step.";

[
To say Tenrec loses:
	if libido of player < 30:
		say "'Well, you can just throw me right over the side,' the ottershrew gasps, cradling his bruised and battered body. 'You might think you are a tough guy, but you got lucky this time.' His narrow chest heaves as he struggles to catch a breath, long thick tail flopping against the ground. 'Still, you did screw up in one place.' He grins, weakly, as his tail tenses. 'You should have put a net over me.' With a bark and a sudden muscular push of his tail, the tenrec flips right over the side of the wharf, diving into the water. You'll have to catch him next time!";
	else:
		say "Would you like to[link]ride him (1)[as]1[end link], [link]use his muzzle (2)[as]2[end link] or [link]throw him back? (3)[as]3[end link]?";
		now calcnumber is 0;
]



To say Tenrec LossOral:
	say "The otter-shrew drops to his knees, blitzed by your overpowering victory. Without a word you just take him by his torpedo-like head and yank him toward your crotch. There is no need for words, your [if player is male]cock[smn] already hard and ready for him to service it with[else]dripping puss[yfn] hot and aching in need to be soothed by[end if] his clever tongue. He doesn't complain, he knows better than to tussle with the true victor, but just opens his maw and gets to work. He keeps his teeth to himself, using only the soft parts of his curling oral digit to stroke and caress every contour of your junk. In the tidal wave of his rising enthusiasm, your personal sense of self restraint can only hold you for so long. With a heaving sigh you unroll into your orgasm, tension melting as your [if player is male]cock[smn] pulses, splattering your [cum load size of player] wad of cum all over his muzzle! [else]puss[yfn] clench up and then gush a torrent of female juices. [end if]Wanting to see, you shove him away, sending the tenrec tumbling onto his back. The sight of your fuck fluids dripping down his muzzle and neck adds a fun cap to your fun. With a snigger at his sticky face, you slip back into the crowds.";

to say TenrecDesc:
	setmongender 3;
	if inasituation is false: [regular scene]
		say "     A common sight around the warehouses and docks is the otter-shrew, a common member of the tenrec family. So named for their appearance of a stretched out otter crossed somewhere with a shrew, they distinguish themselves with a long vertically flattened tail they use to swim like an alligator. Between their love of the water and ability to fish, it is no surprise that crews of them operate night and day to harvest fish from the coastal waters. This one isn't working, though, and from his unbuttoned yellow coat and leaking cock, you've an idea for what he's out to catch. '[one of]Ah. My first catch of the day.[or]You don't want to writhe on a hook, hrm? I've got something better for you.[or]There can be some good trade for a bit of fish, if you like.[or]Whore ho! It's nautical humor. No?[or]Fancy that, looks like I don't need a net to catch you.[or]Not to imply I'm out to press gang, but we could use some more crewmates. Join us.[or]No use trying to run, darlin[']. You're on my line.[at random]' he chuffs quietly, opening his coat fully and taking off his hat before moving in to attack!";
	else:
		say ""; [delt with in special event]

Section 2 - Monster Insertion

Table of random critters (continued)
name	attack	defeated	victory	desc	face	body	skin	tail	cock	face change	body change	skin change	ass change	cock change	str	dex	sta	per	int	cha	sex	HP	lev	wdam	area	cocks	cock length	cock width	breasts	breast size	male breast size	cunts	cunt length	cunt width	libido	loot	lootchance	scale (number)	body descriptor (text)	type (text)	magic (truth state)	resbypass (truth state)	non-infectious (truth state)	nocturnal (truth state)	altcombat (text)
--	--	--	--	--	--	--	--	--	--	--	--	--	--	--	--	--	--	--	--	--	--	--	--	--	--	--	--	--	-- 	--	--	--	--	--	--	--	--	--	--	--	--	--	--	--	--;

When Play begins:
	Choose a blank row from Table of random critters;
	now name entry is "Tenrec";
	now attack entry is "[one of]The tenrec lunges for you with both paws slashing![or]The sleek fisherstud darts left, then right, and traps you in a tight hug with his large tail, grinding his cock up against you![or]The limber otter-shrew feints left and strikes with his large tail![or]The fisherman reaches into his loose coat and pulls out a large fish. Which is then chucked at your head![or]The no-nonsense tenrec just punches you upside your head like an errant cub.[or]With a snarl, the tenrec uses his sharp teeth to bite you![or]The horny male grabs hold of a passing net, swinging above you. He uses his height to splatter precum all over you![at random]";
	now defeated entry is "[Tenrec loses]";
	now victory entry is "[Tenrec Victory]";
	now desc entry is "[TenrecDesc]";
	now face entry is "a quite narrow, hydrodynamic face replete with whiskers and complemented by tiny ears. You look a bit like an otter that went through a taffy machine";
	now body entry is "limber and lithe, you are stretched out and sleek. Obviously made for working your way through the water, if the webbed digits are any indication";
	now skin entry is "[one of]chestnut brown[or]water resistant[or]slightly oily[or]musky Tenrec fur[at random]";
	now tail entry is "You have a very long tail, strangely ridged along the top and hairless. It is like a vertical wall of muscle, moving from side to side as if to help you swim through the air as you walk.";[ Tail description, write a whole Sentence or leave blank. ]
	now cock entry is "[one of]otter-shrew[or]pinkish tenrec[or]slightly tapered[at random]";
	now face change entry is "your skull suddenly thinks it is part torpedo, pushing forward and slimming down considerably. Your ears shrink and shift, moving upwards where they will cause the least turbulence. Pain flare around your eyes as new nictating membranes form, sliding over your eyes as a second set of lids. Further forward, your mouth takes on the shape of a dagger, or needle-nose pliers, a narrow toothy muzzle perfect for clamping on fish and digging them out of mud. From either side, a vast array of vibrissae spout from nose to cheekbones, forming a massive facial tactile array"; [ face change text. format as "Your face feels funny as (your text)" ]
	now body change entry is "everything begins to ache, then thob, from inside out as your bones reshape. Some lengthen, others shorten, and the sensation of your spine sprouting almost puts you on the ground. Your shoulders draw inward, body narrowing and becoming streamlined. Your arm tremble, fingers growing fine and slender, tipped with sharp little claws perfect for gripping prey. It is almost enough to distract you from the sticky feeling of webbing forming between your digits, confirming what your torpedo-shaped body is made for"; [ body change text. format as "Your body feels funny as (your text)" ]
	now skin change entry is "rich chestnut colored fur erupts from your skin, sensation traveling in waves as layers of waterproof fur emerge";
	now ass change entry is "muscle is packed on, pelvis creaking as your hips widen to make more room for your muscular tailbase. Your spine seems to shift upwards, if that were possible, allowing your rudder-like tail to unfurl above your newly empowered rump";
	now cock change entry is "it flushes a bright pink before settling to a rich muted red, taking on a slightly tapered profile. Ridges and veins briefly surge from the surface before the shaft retracts into a well-shielded tenrec sheath"; [ cock change text. format as "Your cock feels funny as (your text)" ]
	now str entry is 14;
	now dex entry is 14;
	now sta entry is 18;
	now per entry is 16;
	now int entry is 14;
	now cha entry is 14;
	now sex entry is "Male"; 			[ Defines which sex the infection will try and make you. current options are 'Male' 'Female' 'Both']
	now HP entry is 65;
	now lev entry is 7; [ Level of the Monster, you get this much HP if you win, or this much HP halved if you loose ]
	now wdam entry is 7; [Amount of Damage monster Does when attacking.]
	now area entry is "Warehouse"; [ Current options are 'Outside' and 'Mall'. Case sensitive]
	now cocks entry is 1; [ How many cocks will the infection try and cause if sex is 'Male' or 'Both']
	now cock length entry is 12; [ Length infection will make cock grow to if cocks]
	now cock width entry is 8; [ Size of balls apparently ;) sneaky Nuku]
	now breasts entry is 2; [ Number of Breasts infection will give you. ]
	now breast size entry is 0; [Size of breasts infection will try to attain ]
	now male breast size entry is 0; [ Breast size for if Sex="Male", usually zero. ]
	now cunts entry is 0; [ if sex = "Female or both", indicates the number of female sexes infection will grant you.]
	now cunt length entry is 0; [ Length of female sex infection will attempt to give you. ]
	now cunt width entry is 0; [ Width of female sex infection will try and give you ]
	now libido entry is 40; [ Amount player Libido will go up if defeated ]
	now loot entry is ""; [ Loot monster drops, ]
	now lootchance entry is 0; [ Chance of loot dropping 0-100 ]
	now scale entry is 3; [ Number 1-5, approx size/height of infected PC body: 1=tiny, 3=avg, 5=huge ]
	now body descriptor entry is "[one of]whippy[or]limber[or]lithe[or]slender[at random]";
	now type entry is "[one of]musteline[or]tenrec[at random]";
	now magic entry is false;
	now resbypass entry is false;
	now non-infectious entry is false;
	blank out the nocturnal entry; [ True=Nocturnal (night encounters only), False=Diurnal (day encounters only), blank for both. ]
	now altcombat entry is "default"; [ Row used to designate any special combat features, "default" for standard combat. ]

when play ends:
	if bodyname of player is "Tenrec":
		if humanity of player < 10:
			if cunts of player > 0:
				say "You surrender yourself to the animal instincts that rule your mind at last. Your cunt is on fire with the memory of a scent, of salt and fish and the magnificent male that granted you so dear an infection. The aquatic stud that lives by the bounty of the sea calls to you like a siren would. Unable to resist it, you make your way to the coast, nose searching for the right ship. Pussy glowing like a lighthouse, you shimmy yourself on board and throw yourself into the nets of his lust. Pawed over by the crew of the slime-slick fishing vessel, you are eventually taken down into the hold. For the hardworking crew of a fishing vessel, your dripping cunt is a welcome respite from the cold wet of the ocean!";
			if cocks of player > 0:
				say "The powerful animal urges the tenrec stud planted deep rise like a tidal wave to sweep away the last vestiges of your humanity. Concepts of things like your individuality and sense of free will are dissolved in the sheer animal power of are simply shoved aside to make room for new drives and urges, manifested with a certain feral intensity. You hunger for sex and fish and water, and most importantly the companionship of your fellow tenrecs. You head for the docks, seeking out the ship on which you know you belong, finding it with your nose and feeling it for sure in the throbbing hardness of your cock. The male that broke you down so completely and remade you in his image welcomes you back into his arms, and onto his prick. After a fun orgy where the rest of the crew take turns in your various holes, you are formally inducted into their brotherhood. Your days blur in sex and fish, sex and fish, until the day you die.";
		else:
			say "Rescued finally by the military, you manage somehow to endure all the mistaken doctors and professionals that think you are an actual otter. The experience hardens you to the ocean and the sea otters that live there, so after your release you head inland. An oar over your shoulder, as tradition, until someone asks what it is you bear. There, far from the sea, you settle besides a lake that welcomes you with a calmness that soothes your internal turmoil. It isn't long before you become intimately familiar with the lake and its tributary streams. It seems only natural that you fall into the position of guide, taking tourist fisherman among the gentle white waters and placid coves of the waterways you love.";

Tenrec ends here.
