Foul Scuttler by Xenophiliac begins here.

"Adds a Foul Scuttler to Flexible Survival's Sealed table"

Section 1 - Monster Responses

when play begins:
	add { "Foul Scuttler" } to infections of guy;

FirstDescOuter is a number that varies. [Don't know if monsters have something I can assign variables to]

to say FoulS_Desc:
	setmongender 3; [creature is male]
	choose row monster from Table of Random Critters;
	if "Male Preferred" is listed in feats of player:
		now sex entry is "Male";
	else if "Herm Preferred" is listed in feats of player:
		now sex entry is "Both";
	else:
		now sex entry is "Female";
	if FirstDescOuter is 0:
		say "     Walking through the desolate corridors that make up the basement of Trevor Labs, you can't help but feel as though the walls of the world are closing in on you, the empty rooms and silent halls overwhelming your thoughts. The claustrophobia you find yourself experiencing soon gets the better of you, and you find yourself lost in the maze of the lab complex, trying to quickly find your way out. Echoing through the halls, a low growl emanates behind you, sending shivers up your spine. Turning yourself around to face whatever is behind you, you come face to face with something you couldn't have dreamt up in your nightmares.";
		now FirstDescOuter is 1;
	else:
		say "     A familiar growl echoes throughout the halls of the Trevor Lab Complex, sounding throughout the empty halls and rooms. Preparing yourself to face your attacker, you turn to face the Foul Scuttler that stalks you.";
	LineBreak;
	say "     You're not entirely sure what this creature is. Tall enough to reach your chest, this beast is a mass of spines with a maw of razor-sharp teeth. The creature's body is supported by six legs, using them to scuttle forward in quick jaunts. The legs supporting it are similar to triple-jointed insect legs, and end in serrated claws, perfect for cutting and rending. The skin of this being is covered in plated carapace, with ridges of thick spines protruding from the creatures back, giving it a horrific look. The head of the creature is even more disturbing. Solid [one of]black[or]yellow[or]red[or]gray[or]purple[at random] eyes stare at you, a cunning intelligence glimmering within them. The maw of the creature is gigantic, with the sides of its mouth extending to the sides of its face, ending just below the holes that serve as its ears. Thick saliva drips from its open mouth, leaking between the rows of sharp incisors that function as its teeth, while foot-length spikes grow from its lower jaw; getting anywhere near this creature's head is a bad idea. Dropping your gaze lower, you can tell that this creature is definitely male, a dripping, wriggling, fifteen-inch dick hanging beneath its mass. The head of the beast's cock seems to be made up of five separate tentacles, reminding you of a splayed-out starfish attached to the creature's shaft. Screaming at you and charging, the beast engages you, horrid intent in its emotionless eyes.";

to say FoulS_PlayerVictory:
	say "     Landing a heavy hit straight to the creature's head, pushing it back and slamming it into the ground. Letting out a mournful scream as he falls to the ground, the Foul Scuttler slams to the ground, hurt and exhausted from the long fight you both just engaged in.";
	say "     Feeling a familiar lustful sensation flowing through your veins, you consider having some fun with the mutated beast. Do you?";
	if player consents:
		if player is herm:
			say "     Walking up to the exhausted Scuttler, you stop for a moment and think to yourself whether or not indulging yourself with this beast is truly a good idea. Your concerns are quickly thrown to the wayside by your rising lust, your cock[smn] rapidly hardening at the thought of taking this creature's massive shaft. Rapidly removing your clothes, you throw them to the side as you push the creature onto his back. Growling angrily, the beast flails uselessly as it tries to right itself, but this is soon stopped when you grab the creature's drooping cock. The growl turns into a yelp of pleasure, the cock in your hand quickly hardening as you slowly rub your hand over the quivering shaft. Looking at the panting beast below you and the freakish cock currently in your hand, you figure that having this rod in your cunt would be an amazing experience, or you could take a straight injection of beast-seed down your throat, taking a snack for the road. (Y for cunt, N for mouth)";
			LineBreak;
			if player consents:
				LineBreak;
				say "[HermOuterWin]";
			else:
				LineBreak;
				say "[OuterSuck]";
		else if player is female:
			say "     Walking up to the defeated creature, you take a moment to run your eyes over its unnerving form. You consider for a moment if you really want to indulge yourself with this creature's fifteen-inch cock, but as lust continues to build throughout you, you quickly disregard those thoughts and remove your clothes, setting them aside. The creature watches you intently, its wriggling cock beginning to protrude from beneath its large mass; both of you know what's coming next. Rolling the creature onto its rough, ridged back, it begins to pant heavily as you decide what to do with it. Grasping the Foul Scuttler's twitching, tentacled cock, you take a moment to run your hand along its shaft, feeling the quivering nubs massage your hand as the tentacled head wiggles wildly. You consider how pleasurable it would be to have this monstrous shaft in your cunt, or you could suck the creature off, taking its load straight into your stomach. (Y for cunt, N for mouth)";
			LineBreak;
			if player consents:
				LineBreak;
				say "[FemaleOuterWin]";
			else:
				LineBreak;
				say "[OuterSuck]";
		else if player is male:
			say "     Approaching the defeated Scuttler cautiously, you wonder if fucking this beast is really a smart idea. You consider stopping for a few moments, but your hardening [if cocks of player is 1]cock[else]cocks[end if] get the best of you, and you quickly strip down, setting your clothes aside. Walking up to the beast, you use all your strength to roll the beast onto its back, and taking a look at what it's packing. The Foul Scuttler growls angrily at your rough treatment, but does not attempt to resist, curious at what you're doing with it. Hoisting yourself onto the creature's chest, you grab its mutant cock and begin rapidly stroking the beast to hardness, eliciting happy yelps from the mutant beast below you. Seeing as though the beast does not have any openings you could use, you figure that taking his beastly cock in your ass would be your best bet at getting off. Alternatively, you could go down on the beast, sucking him off and taking his load for yourself. (Y for ass, N for mouth)";
			LineBreak;
			if player consents:
				LineBreak;
				say "[MaleOuterWin]";
			else:
				LineBreak;
				say "[OuterSuck]";
		else:
			say "     Cautiously approaching the exhausted beast, you consider that fucking this strange creature may not be the best of ideas. The feeling of arousal building in your [bodytype of player] figure rapidly removes those concerns, your clothes swiftly removed and thrown to the side. You quickly push the fallen beast onto its back, the Scuttler yelping weakly and flailing about uselessly. Grabbing the beast's forearm-length shaft gently, you quickly reduce the angered beast to pleasured grunts and yelps as you languidly stroke the beast to full arousal; soon enough, the beast's thick cock is standing rigid in the damp air of the underground tunnels. Taking a look at the beast, you eventually come up with two options; you could ride this creature's monstrous shaft with your rear, or you could go down on the panting beast. (Y for ass, N for mouth)";
			LineBreak;
			if player consents:
				LineBreak;
				say "[NeutOuterWin]";
			else:
				LineBreak;
				say "[OuterSuck]";
	else:
		say "     Deciding that sex with this beast might not be worth the risk, you swiftly gather your things and leave the creature behind, hoping to not have to face one of those beasts anytime soon.";

to say FoulS_PlayerDefeat:
	if HP of player > 0:
		say "     Lowering yourself to the ground as non-threateningly as you can, you place your fate in the hands of the creature. Approaching you cautiously, the Foul Scuttler ambles to you, preparing for any sudden movements. Bowling you over onto your back, the beast repositions itself above you, placing its face inches from yours. Wafting its warm breath over your face, you are overwhelmed with the smell of meat, while a subtle musk begins to set your senses aflame. Inhaling your scent with deep, drawn-out sniffs, the creature seems to be trying to figure out what to do with you.";
	else:
		say "     While you put up your best effort, the Foul Scuttler proves to be too much for you, and you find yourself panting on the ground, exhausted and bleeding. Thundering up to you, each step he makes sending vibrations throughout the floor, the Scuttler ambles up to you, assured of its victory. Easily rolling you over onto your back, the beast positions itself over you, its muzzle of imposing teeth hovering inches from your face. You've no idea what the beast has in store for you, but you know that it's probably not going to be good.";
	WaitLineBreak;
	if player is female and cocks of player >= 0:
		if player is submissive and cocks of player is 0:
			say "     The Foul Scuttler lets out a low, rumbling growl, one that sounds more like a purr rather than an angered growl. Bringing its muzzle to your face, it begins to nuzzle your head lovingly, constantly letting out a rumbling, quiet purr. You can't help but feel safe and comfortable under the big beast, and you begin to run a hand through the beast's coarse head spines, rubbing and scratching its head. Its deep purring grows even louder at your caressing, closing its eyes and licking your face with its coarse, rough tongue. Doing your best to return his affection, you close your eyes and link your tongue with his, caressing his long tongue with yours. Feeling a wriggling touch at your thighs, you sense that the beast is just as aroused as you, knowing that his wriggling cock is doing its best to find your (now dripping) cunt[sfn]. Breaking the kiss and panting heavily, you both look down together as you worm your hand towards your pants. You can't go fast enough as you lower your pants and undergarments, leaving them at your knees as you wrap your arms around the crook of his neck. Wiggling your body around, you line up [if cunts of player > 1]one of your [cunt size desc of player] cunts[else]your [cunt size desc of player] cunt[end if] with the beasts wiggling cock, the twitching mini-tentacles sending jolts of pleasure through your body. Biting your lip and looking down, you wait with bated breath for the beast to impale you with his wonderful cock.";
			say "     The Beast wastes no time, and thrusts fully into your waiting cunt, filling you with his cock and claiming you as his. [if cunt length of player < 15]Your eyes go wide and you clench up as he buries his large length in your cunt, spearing it open in one fell swoop. Pain and pleasure overwhelm you as his cock forcefully widens your womanhood, feeling every inch of his squirming dick with your clenching cunt. You scream out in pain and pleasure as this happens, and the Foul Scuttler above you adds his own yell to yours. Gasping for breath as your speared cunt seizes involuntarily around his magnificent cock, the beast above you allows you time to adjust to his intrusion[else]He bottoms out within you, his cock engulfed by your [cunt size desc of player] cunt, becoming fully enveloped within your womanhood, which is currently gripping and massaging the cock buried in it[end if]. After a few moments, the Beast slowly withdraws from you, the nubs on his mutated cock rubbing pleasurably along the walls of your dick-filled pussy, the wiggling tentacles that make up his head caressing every inch of it. He almost pulls out of you, leaving only his tentacled head inside your quivering cunt, having them caress and stimulate every inch of your pussy that they can find. He quickly buries his mutated cock back into your inviting slit, causing your eyes to roll into your head as pleasure washes over your body, emanating from your stuffed pussy. The Scuttler begins thrusting rhythmically into your pussy, stimulating you in ways you've never thought possible, the creature's wondrous dick finding every crevice of your [cunt size desc of player] slit. The nubs along his shaft quiver as his tentacled head caresses your walls, and his thrusting quickly brings you to a mind-altering orgasm, [if cunts of player is 1] cumming hard along his thick shaft while screaming loudly[else]your impaled cunt spasming wildly around his shaft[end if].";
			WaitLineBreak;
			say "     Your new lover, however, is not done. Continuing his rhythmic thrusting, you can barely hold on as you forget everything but the magical shaft pumping in and out of you. Nestling your head under his chin, you surrender yourself to your mate, loving the feeling of his otherworldly shaft stimulating every inch of your womanhood. You're soon brought to another orgasm, hugging the beast tightly as you drench his manhood in your juices, clenching your teeth hard as pleasure wracks your body. You lose track of how long you're under him, willingly losing your mind to the stimulation of the beast above you. His thrusts soon become more wild while his panting becomes faster, and your eyes go wide as, in one quick thrust, he spears open your womb.";
			say "     You both release a high-pitched scream, your feminine yell melding with his animalistic screech as you both cum simultaneously. The miniature tentacles grip the insides of your womb as his full, syrupy load is deposited directly into it, burst after burst of cum blasting into your deepest recesses. He continues fills you with his virile seed, your belly expanding from the copious amount of seed. The flow eventually stops, with your belly swelling to look like you're already months pregnant. The Beast sags down, panting, as he recovers from filling you with life. You finally let go of his neck, sagging onto the cold metal floor, his cock still buried in you. He purrs happily, licking your face with his wet tongue as you caress the side of his head, scratching and rubbing him lovingly. After a few minutes, he slowly withdraws from you, each inch of withdraw eliciting pleasured moans from you. As he finally pulls out, a trickle of his seed drips from your clenching womanhood, dropping onto the floor below. Rubbing up against you, the Foul Scuttler gives you one last lick before bounding off into the darkness, returning from wherever he came from. You eventually recover from your exhaustion, pulling your undergarments back up and gathering your things. As you find your way back out into the daylight, you do your best to keep any of his heavenly seed from leaking out of you, hoping that your belly will be bulging with his unborn children.[impregchance][impregchance]";
			now libido of player is 0;
		else if player is not male:
			say "     The Foul Scuttler lets out a low, rumbling growl, subconsciously ordering you to submit. You do your best to not look threatening, the beast staring intently at you, his cunning intelligence shining through. With a sudden push, the beast flips you onto your front, eliciting a surprised yelp from you. Using two of his legs to hold your chest up, you find your head below his, while his other legs hold you in place. Looking back, you know what this beast has in store for you, as his wriggling beastly cock continue to grow, finally poking at your clothed ass. Growling angrily at his inability to penetrate you, he brings one of his hind legs off of you, doing his best to rip your clothes off. Not wanting to irreparably damage your clothes, you wiggle one of your hands back, and quickly remove your undergarments, giving the Scuttler full access to your cunt. Thrusting forward wildly, the beast does his best to spear [if cunts of player > 1]one of your [cunt size desc of player] cunts[else]your [cunt size desc of player] cunt[end if] with his impressive manhood, and finally, after a few missed thrusts, he spears open your [cunt size desc of player], glistening womanhood.";
			say "     [if cunt length of player < 15]You groan loudly in pain as your cunt is forced to accept his length, your walls forcibly pushed aside as he pushes himself into you, widening painfully to accept his massive length[else]Miraculously, you're able to take his entire length without too much issue, the sudden intrusion drawing pleasured gasps from you[end if]. After a few moments, the Beast slowly withdraws from you, the nubs on his supernatural cock quivering pleasurably along the walls of your cunt while the wiggling tentacles that make up his head feel their way around your cunt. He pulls out most of the way, only leaving his wriggling tentacle head in your cunt, eliciting pleasured gasps and moans from you. Burying his full length into your seizing cunt, [if cunt length of player < 15]he elicits another pained gasp from you, but pleasure soon replaces the feeling of pain[else]causing you to moan happily as you're once again filled with his squirming cock[end if]. The nubs along his shaft quiver faster as his tentacled head caresses your walls, and his thrusting quickly brings you to a mind-numbing orgasm, and [if cunts of player is 1]you cum hard along his thick shaft, gripping it as tightly as you can[else]your impaled cunt caresses his length, doing all it can to grip the invading member[end if].";
			WaitLineBreak;
			say "     Your new mate, however, is not done with you. Continuing his wild thrusting throughout your entire orgasm, you barely regain your senses, the feelings of pleasure emanating from your cock-stuffed cunt almost too much for you to handle. Moving one of your hands to your [breast size of player] breast, you begin to grope and tease at your own breast, enhancing the feelings of pleasure overwhelming your head. You're soon brought to another orgasm, putting both of your hands on the floor to avoid hitting your head as you ride out your second orgasm. You lose track of how long you're under the beast, being taken like a complete animal. His thrusts soon become short and quick while his panting becomes faster, and you clench your eyes and teeth as, in one quick thrust, he buries his wriggling cock into your womb.";
			say "     You both release a high-pitched scream, your feminine yell melding with his animalistic screech as you both cum simultaneously. The miniature tentacles grip the insides of your womb as his hefty load is blasted directly into it, each blast visibly distorting his quivering cock. He continuously fills you with his virile seed, your belly bulging out from the sheer size of his load. The flow eventually stops, with your belly filling to look months pregnant. The Beast sags down, panting, as you let yourself sag down, lying your head on the cold metal floor. After a few minutes of recovery, he slowly withdraws from you, each inch of withdraw eliciting pleasured moans. As he finally pulls out, you both let out a groan, and you come to rest on the floor, savoring the coolness of the metal below you. The Foul Scuttler sniffs the air, and lopes off into the darkness, going after whatever it is he smelled. You eventually recover from your exhaustion, pulling your undergarments back up and gathering your things. As you find your way back out into the daylight, you hope that you won't have to face one of them again soon, the beast having given you quite a thrashing. Feeling something in your stomach wriggle, you put a hand to your bulging belly and also hope that there won't be any... permanent consequences to your recent loss.[impregchance][impregchance]";
			now libido of player is 0;
		else if player is male:
			say "     Growling menacingly, the beast above you locks you in place with his legs, preventing you from moving or resisting. Looking at you, cunning intelligence gleaming in his eyes, the Foul Scuttler then shifts his gaze to your pants, his intent clear. Not wanting to fight against the massive beast, you move one of your hands to your pants, slowly unhinging and lowering your pants. Looking down at your [if cocks of player is 1]cock[else]cocks[end if] and glistening [if cunts of player is 1]cunt[else]cunts[end if], the beast growls in uncertainty at your dual genders. The Foul Scuttler still repositions itself above you, its rapidly-hardening manhood prodding at the entrance to [if cunts of player is 1]your cunt[else]one of your cunts[end if]. Thrusting forward wildly, the beast does his best to spear [if cunts of player > 1]his chosen entrance[else]your [cunt size desc of player] cunt[end if] with his impressive manhood, and finally, after a few missed thrusts, he impales [if cunts of player is 1]your [cunt size desc of player], glistening womanhood[else] one of your cunts, spearing you on his thick shaft[end if].";
			say "     [if cunt length of player < 15]You groan loudly in pain as your cunt is split along his massive cock length, the walls of your pussy forced wide from his forceful intrusion[else]You're able to somehow fit his entire length into your cunt, the sudden intrusion causing you to scream in pleasure[end if]. After a few moments, the Scuttler begins to slowly thrust into you, each one causing you more and more pleasure as your [if cocks of player is 1]cock[else]cocks[end if] quickly harden, leaking precum onto the ground. Reaching a hand down to [if cocks of player is 1]your cock[else]one of your cocks[end if], you start to quickly jerk yourself off, feelings of pleasure emanating from both of your sexes. The nubs along his shaft quiver faster as his tentacled head caresses your walls, and his thrusting quickly brings you to a not entirely unwanted orgasm, and you cum hard, your spasming cunt gripping his shaft tightly as you shoot your load onto yourself, covering your [breast size desc of player] breasts in your own cum.";
			WaitLineBreak;
			say "     Your new mate, however, is not done with you. Continuing his wild thrusting throughout your entire orgasm, you barely regain your senses, the feelings of pleasure emanating from your cock-stuffed cunt almost too much for you to handle. Moving one of your hands to your [breast size of player] breast, you begin to grope and tease at your own breast, enhancing the feelings of pleasure overwhelming your head. Your other hand is still occupied with your cock, continuing to jerk yourself off as your pussy is speared on this beast. You're soon brought to another orgasm, letting out a low moan as your balls clench, blasting more of your seed across your chest and body, covering yourself in your own fluids. You lose track of how long you're under the beast, his cock continuously thrusting into your slit as [if cocks of player is 1]your cock[else]your cocks[end if] continue to drip cum. His thrusts soon become short and quick while his panting becomes faster, and you scream out in wordless pleasure as, in one quick thrust, he pushes his thrashing cock into your waiting womb.";
			say "     Your scream soon releases sound, your scream echoing throughout the corridors. The Foul Scuttler's scream follows yours, his deep yell vibrating the metal walls of the labs. The miniature tentacles grip the insides of your womb as his thick viscous, heavy load is pushed straight into your womb, each blast eliciting pleasured moans as you feel it move down his shaft. He continues to fill your womb with his seed, each blast pushing out your stomach even more. He finally finishes, with your stomach looking like you're six months pregnant. The Beast sags down, panting, as you slacken all of your muscles, laying in a pool of your own cum and sweat. After a few minutes of recovery, he slowly withdraws from you, each inch of withdraw eliciting pleasured moans. As he pulls out completely, a veritable flood of seed leaking from your abused lips. The Foul Scuttler stands still a moment, waving slightly side to side, before ambling off into the darkness. You eventually recover from your exhaustion, pulling your undergarments back up and gathering your things. As you find your way back out into the daylight, you wonder just how many of those beasts exist down there, silently hoping that there aren't too many. Feeling something in your stomach move around, you put a hand to your bulging belly and hope that you won't have any new additions to your family anytime soon.[impregchance][impregchance]";
			now libido of player is 0;
	else:
		if player is puremale:
			say "     Looking at you, the Foul Scuttler growls disapprovingly, seemingly displeased by something you can't figure out. Using its six muscular legs to hold you still, a deep, rumbling sound begins originating in its throat, getting louder as the seconds pass. Closing its toothed jaw, the beast looks down before extruding a massive gout of mucus and spit directly onto your head and into your mouth. Coughing and sputtering at the sudden flood of fluids, you do your best not to choke on the thick mix of liquids. Holding you there for a few moments, the beast looks down at you, unblinking as you try not to suffocate. Seemingly satisfied, the Beast lets you loose and wanders back into the maze of hallways, looking for another victim. After wiping yourself off and gathering your things, you still cannot get the bitter taste of Scuttler spit off your tongue, and you begin to feel nauseous. Hopefully there isn't some illness the beast gave you.";
		else:
			say "     Growling at you menacingly, making sure to show its maw of teeth, the Foul Scuttler seems incredibly displeased with you; you're not sure why. Using its six muscular legs to hold you still, a deep, rumbling sound begins originating in its throat, getting louder as the seconds pass. Closing its toothed jaw, the beast looks down before extruding a massive gout of mucus and spit directly onto your head and into your mouth. Coughing and sputtering at the sudden flood of fluids, you do your best not to choke on the thick mix of liquids. Holding you there for a few moments, the beast looks down at you, unblinking as you try not to suffocate. Seemingly satisfied, the Beast lets you loose and wanders back into the maze of hallways, looking for another victim. After wiping yourself off and gathering your things, you still cannot get the bitter taste of Scuttler spit off your tongue, and you begin to feel nauseous. Hopefully there isn't some illness the beast gave you.";

to say FemaleOuterWin:
	say "     Deciding to take that wondrous-looking shaft in your clenching womanhood, you climb on top of the creature, keeping your hand slowly running along its ever-hardening shaft. The creature begins to thrust forward, his cock thrusting between your hands wildly as the tentacled heads flail around. Quickly repositioning yourself above the creature, you line [if cunts of player is 1]your cunt[else]one of your cunts[end if] up with the creature's lengthy shaft, hovering inches above his throbbing cock. Lowering yourself down slowly, your feminine lips come into contact with the head-tentacles of the creature's freakish manhood, which quickly begin to caress the entrance to your [cunt size desc of player] pussy, sending jolts of pleasure throughout your body. Pleasure coursing to your head, you slam yourself down as far as you can, screaming in pleasure as you take his shaft, preparing to give him the ride of his life.";
	WaitLineBreak;
	say "     Hilting yourself as far as you can, you barely stop yourself from cumming on the spot, the amount of pleasure you're feeling sure to burn out a few nerve endings. The creature below you yelps happily from your sudden intrusion, doing its best to thrust forward savagely. Laying on the ground, however, is doing it no favors, and it only succeeds in bouncing you a few inches up its cock every thrust. Its bouncing, however, causes you to groan in pleasure as you bounce on his impressive manhood, the vibrating nubs on the creature's shaft massaging your inner passage while the tentacled head of the creature does its best to reach your deepest recesses, caressing every inch of your cunt. Losing yourself in the creature's frantic thrusting, you begin to meet his thrusts, continuously impaling yourself on the beast's mutant dick. Speeding up your thrusting, you feel that your orgasm is not far off. Hilting yourself as far as you can, you gyrate your hips, causing the squirming dick buried in your pussy to reach every crevice of your womb.";
	say "     This act sets off both of you, your eyes rolling into your head as the creature lets out an ear-splitting screech, echoing throughout the corridors. You can feel each throb of the beast's cock as he blasts his vast load straight into your quivering tunnel. Drenching the Foul Scuttler's body in your fluids, it's all you can do to remain conscious as the beast continues to pump his seed into your stomach. Sagging forward and panting heavily, you can feel your stomach begin to expand with every shot of cum the beast shoots into you. Resting on the Scuttler, you take a few minutes to recover, the beast's squirming cock still firmly buried in your pleasure-laden cunt. Finally getting the energy to get up, you slowly remove the beast's dick from your soaked cunt, each inch sending small jolts of pleasure through you. After the head of his cock passes your lips, a small river of seed runs out, drenching the beast in his own cum. Dismounting from the large creature, you amble over to your equipment and slowly get dressed, savoring the feeling of immense fullness the creature has given you. Taking one last look at the sex-drenched creature and rubbing your cum-stuffed belly lovingly, you figure that it might not be a bad idea to come down here occasionally.[impregchance][impregchance]";
	now libido of player is 0;

to say MaleOuterWin:
	say "     Deciding to take that wondrous-looking shaft in your backside, you climb on top of the creature, keeping your hand roughly masturbating the creature, listening to its heavy panting. The creature begins to thrust forward, his cock thrusting between your hands wildly as the tentacled heads flail around. Quickly repositioning yourself above the creature, you line up your rear with the creature's lengthy shaft, hovering inches above his throbbing cock. Lowering yourself down slowly, your rear entrance comes into contact with the head-tentacles of the creature's freakish manhood, which quickly begin to caress the entrance to your ass, sending jolts of pleasure throughout your body, emanating from your soon-to-be filled rear. Pleasure coursing to your head, you slam yourself down as far as you can, screaming in pleasure as you fit the entirety of the Foul Scuttler's thick cock up your rear.";
	WaitLineBreak;
	say "     Hilting yourself as far as you can, you barely stop yourself from cumming on the spot, the shaft buried in your rear sending thunderous bolts of pleasure throughout your body. The creature below you yelps happily from your sudden intrusion, doing its best to thrust forward savagely. Laying on the ground, however, is doing it no favors, and it only succeeds in bouncing you a few inches up its cock every thrust. That only helps to enhance the feeling of getting well-fucked; the creature's wanton thrusting sending bolts of pleasure throughout your body, your [if cocks of player is 1]cock[else]cocks[end if] jumping every time your re-hilted. The vibrating nubs on the creature's shaft massage your inner walls, while the tentacled head of the creature does its best to reach your deepest recesses, exploring all they can of your impaled ass. Swiftly bringing a hand to your rock-hard [if cocks of player is 1]cock[else]cocks[end if], you rapidly start masturbating, timing your jerking with the beast's wild thrusting. Speeding up your bouncing, you do your best to clench down on the member in your rear, feeling every inch of his wriggling dick caress your bowels. Clenching and grinding as hard as you can, you try your hardest to wring out the creature's load straight into your ass.";
	say "     These acts set off both of you, your eyes rolling into your head as the creature lets out an ear-splitting screech, echoing throughout the corridors. You can feel each throb of the beast's cock as he blasts his vast load straight into your clenching ass, while your [short ball size] balls tighten as you cum hard, shooting your [cum load size of player] load across the creature's stomach. Having blown your load across the creature's chest, it's all you can do to remain conscious as the beast continues to pump his seed into your stomach. Sagging forward and panting heavily, you can feel your bowels begin to expand with every shot of cum the beast shoots into you. Resting on the Foul Scuttler, you take a few minutes to recover, the beast's squirming cock still firmly buried in your sore, expanded ass. Finally recovering the energy needed to get up, you slowly remove the beast's dick from your still-spasming rear, each inch sending small jolts of pleasure through you. After the head of his cock is removed from your rear, a small river of seed runs out, drenching the beast in his own cum and mixing with yours. Dismounting from the large creature, you amble over to your equipment and slowly get dressed, savoring the feeling of immense fullness the creature has given you. Taking one last look at the sex-drenched creature, you figure that it might not be a bad idea to come down here again.";
	now libido of player is 0;

to say HermOuterWin:
	say "     Deciding to take that wondrous-looking shaft in your backside, you climb on top of the creature, keeping your hand roughly masturbating the creature, listening to its heavy panting. The creature begins to thrust forward, his cock thrusting between your hands wildly as the tentacled heads flail around. Quickly repositioning yourself above the creature, you line up your dripping cunt with the creature's lengthy shaft, hovering inches above his throbbing cock. Lowering yourself down slowly, your pussy comes into contact with the head-tentacles of the creature's freakish manhood, which quickly begin to caress the entrance to your cunt, sending jolts of pleasure throughout your body and causing your [if cocks of player is 1]cock[else]cocks[end if] to jump in pleasure. Excitement coursing through your body, you slam yourself down as far as you can, screaming in pleasure as you fit the entirety of the Foul Scuttler's thick cock into your slit.";
	WaitLineBreak;
	say "     Hilting yourself as far as you can, you barely stop yourself from cumming on the spot, the shaft buried in your cunt sending strings of pleasure shooting through your veins. The creature below you yelps happily from your sudden intrusion, doing its best to thrust forward savagely. Laying on the ground, however, is doing it no favors, and it only succeeds in bouncing you a few inches up its cock every thrust. The only thing that the creature's wanton thrusting does is cause you to moan in pleasure; its thrusts sending bolts of pleasure throughout your body, your [if cocks of player is 1]cock[else]cocks[end if] jumping every time the Scuttler bottoms out. The vibrating nubs on the creature's shaft massage your inner walls, while the tentacled head of the creature does its best to reach your deepest recesses, exploring all they can of your dripping cunt. Swiftly bringing a hand to your rock-hard [if cocks of player is 1]cock[else]cocks[end if], you rapidly start masturbating, timing your jerking with the beast's wild thrusting. Speeding up your bouncing, you do your best to clench down on the member stuffing your pussy, feeling every inch of his wriggling dick caress your womb. Clenching and grinding as hard as you can, you try your hardest to wring out the creature's load straight into your waiting cunt.";
	say "     These acts set off both of you, your eyes rolling into your head as the creature lets out an ear-splitting screech, echoing throughout the corridors. You can feel each throb of the beast's cock as he blasts his vast load straight into your spasming cunt, while your [short ball size] balls tighten as you cum hard, shooting your [cum load size of player] [if cocks of player is 1]load[else]loads[end if] across the creature's stomach. Having blown your [if cocks of player is 1]load[else]loads[end if] across the creature's chest, it's all you can do to remain conscious as the beast continues to pump his seed into your hungry cunt. Sagging forward and panting heavily, you can feel your slit begin to expand with every shot of seed the beast shoots into you. Resting on the Foul Scuttler, you take a few minutes to recover, the beast's squirming cock still firmly buried in your throbbing, clenching cunt. Finally recovering the energy needed to get up, you slowly remove the beast's dick from your still-cumhungry cunt, each inch sending small jolts of pleasure through you. After the head of his cock passes your feminine lips, a small river of seed runs out, drenching the beast in his own cum and mixing with yours. Dismounting from the large creature, you amble over to your equipment and slowly get dressed, savoring the feeling of immense fullness the creature has given you. Taking one last look at the sex-drenched creature, you figure that it might not be a bad idea to find one of these beasts again.";
	now libido of player is 0;

to say NeutOuterWin:
	say "     Deciding to take that wondrous-looking shaft in your backside, you climb on top of the creature, keeping your hand roughly masturbating the creature, listening to its heavy panting. The creature begins to thrust forward, his cock thrusting between your hands wildly as the tentacled heads flail around. Quickly repositioning yourself above the creature, you line up your rear with the creature's lengthy shaft, hovering inches above his throbbing cock. Lowering yourself down slowly, your rear entrance comes into contact with the head-tentacles of the creature's freakish manhood, which quickly begin to caress the entrance to your ass, sending jolts of pleasure throughout your body, emanating from your soon-to-be filled rear. Pleasure coursing to your head, you slam yourself down as far as you can, screaming in pleasure as you fit the entirety of the Scuttler's lengthy cock up your rear.";
	WaitLineBreak;
	say "     Hilting yourself as far as you can, you barely stop yourself from cumming on the spot, the shaft buried in your rear sending thunderous bolts of pleasure throughout your body. The creature below you yelps happily from your sudden intrusion, doing its best to thrust forward savagely. Laying on the ground, however, is doing it no favors, and it only succeeds in bouncing you a few inches up its cock every thrust. That only causes you to groan in pleasure; the creature's thrusting sending bolts of pleasure throughout your body, your anal walls convulsing with every thrust. The vibrating nubs on the creature's shaft massage your walls, while the tentacled head of the creature does its best to reach your deepest recesses, exploring all they can of your widened ass. Bringing your hands to your [breast size of player] breasts, you begin to massage and pull on your nipples, groaning in pleasure as you do so. Speeding up your bouncing, you do your best to clench down on the member spearing your rear, being able to feel every inch of his wriggling dick caress your bowels. Clenching and grinding as hard as you can, you try your hardest to wring out the creature's load straight into your ass.";
	say "     These acts set off both of you, your eyes rolling into your head as the creature lets out an ear-splitting screech, echoing throughout the corridors. You can feel each throb of the beast's cock as he blasts his vast load straight into your clenching ass, while your [short ball size] balls tighten as you cum hard, shooting your [cum load size of player] load across the creature's stomach. Having blown your load across the creature's chest, it's all you can do to remain conscious as the beast continues to pump his seed into your stomach. Sagging forward and panting heavily, you can feel your bowels begin to expand with every shot of cum the beast shoots into you. Resting on the Foul Scuttler, you take a few minutes to recover, the beast's squirming cock still firmly buried in your sore, expanded ass. Finally recovering the energy needed to get up, you slowly remove the beast's dick from your still-spasming rear, each inch sending small jolts of pleasure through you. After the head of his cock is removed from your rear, a small river of seed runs out, drenching the beast in his own cum and mixing with yours. Dismounting from the large creature, you amble over to your equipment and slowly get dressed, savoring the feeling of immense fullness the creature has given you. Taking one last look at the sex-drenched creature, you figure that it might not be a bad idea to explore here again.";
	now libido of player is 0;

to say OuterSuck:
	say "     Finding that you want a taste of the beast's seed, you find yourself face to face with the squirming mutant cock this beast sports. Running your hand over the beast's length, you can feel every vein throb and pulse with the creature's heartbeat, the quiet panting of this strange beast growing louder as you continue to lavish attention on his squirming dick. Slowly speeding up your rubbing, the beast's cock soon grows to its full 15-inch length, squirming intently, doing its best to pleasure and massage whatever imaginary cunt its buried in. The Foul Scuttler begins to thrust forward, lost in the bestial lust your hand has awoken. Deciding that the beast below you has had enough foreplay, you swiftly engulf the Scuttler's cock head, taking the wriggling tentacles into your maw.";
	say "     A pleased screech and faster thrusting are your rewards for sucking on the beast's head, his panting becoming faster and faster as his arousal peaks. The tentacled head you're currently sucking on explores every inch of your mouth, running along the insides in an effort to arouse you further. Your arousal builds as you bob up and down on the creature's shaft, taking more and more of his length down your throat each bob. Your hand rubs and caresses whatever length you aren't able to get into your mouth, working overtime to have the Foul Scuttler shoot his load into your gullet. Sucking greedily on the good-tasting cock thrusting down your throat, you speed up your bobbing, wanting nothing more than to have this creature's virile load sitting in your stomach.";
	say "     Your efforts prove to not be in vain, as soon enough, your plaything emits a high-pitched screech, and a massive blast of cum plasters your mouth white, more not far behind. Hungrily swallowing as much of his sweet-tasting load as you can, the flow proves to be too much for you to keep up with, and some of it begins spilling out of your mouth and flowing down your chin onto the creature's stomach. The Foul Scuttler continues to blast his load down your throat, your stomach growling in protest from the sheer amount of seed you're swallowing. You pull off of the throbbing beast-cock, waves of cum flowing out of your mouth as the Foul Scuttler coats your face and chest with his gargantuan load. Eventually, the Scuttler stops, but not before your stomach is full to bursting and your face and chest are painted white. Taking a few harsh breaths, you dismount the freakish beast, leaving it there to recover. Gathering your things, you do your best to clean yourself off, wiping as much of the musky load from your face and chest as you can. Taking one last handful of the Foul Scuttler's cum and swallowing it down, you feel re-energized, walking happily out of the labs.";
	increase libido of player by 25;


Section 2 - Monster Insertion

Table of Random Critters (continued)
name	enemy title	enemy name	enemy type	attack	defeated	victory	desc	face	body	skin	tail	cock	face change	body change	skin change	ass change	cock change	str	dex	sta	per	int	cha	sex	HP	lev	wdam	area	cocks	cock length	cock width	breasts	breast size	male breast size	cunts	cunt length	cunt width	libido	loot	lootchance	scale (number)	body descriptor (text)	type (text)	magic (truth state)	resbypass (truth state)	non-infectious (truth state)	DayCycle	altcombat (text)	BannedStatus (truth state)
--	--	--	--	--	--	--	--	--	--	--	--	--	--	--	--	--	--	--	--	--	--	--	--	--	--	--	--	--	--	--	--	--	--	--	--	--	--	--	--	--	--	--	--	--	--	--	--	--	--;

When Play begins:
	Choose a blank row from Table of Random Critters;
	now name entry is "Foul Scuttler";
	now enemy title entry is "";
	now enemy name entry is "";
	now enemy type entry is 0; [non-unique enemy]
	now attack entry is "[one of]Leaping back, the Foul Scuttler releases an ear-splitting screech, the corridors of the labs funneling the entirety of the sonic wave towards you. You throw your hands to your ears, doing your best to block out the sound. You eventually recover, but not without a pounding head[or]Flinging the entirety of its muscled mass at you, the Foul Scuttler bowls you over, rending massive gashes across your chest as it drags its claws across your body[or]Sliding past your defenses, the Foul Scuttler bites down on your leg, ripping large chunks of flesh off of your leg as it withdraws[or]Lowering its head and bounding forward, the beasts slams its head into your chest, knocking the wind out of you and throwing you back a few feet[at random].";
	now defeated entry is "[FoulS_PlayerVictory]";
	now victory entry is "[FoulS_PlayerDefeat]";
	now desc entry is "[FoulS_Desc]";
	now face entry is "a visage formed from the dark depths of space itself. Solid [one of]yellow[or]black[or]purple[or]red[or]gray[sticky random] eyes sit in sockets too large for humans, while your nostrils are just two small holes below your eyes, with no protruding structure. The same is true of your ears, with two holes acting as your ears. The maw currently occupying your lower jaw is horrifying and otherworldly; the sides of your mouth extend almost to your ears, impossibly wide for anything natural. Within your large gaping maw lie rows of razor-sharp teeth, while your tongue extends out a few feet. The stiff points on your head can barely be considered hair, more of sharp, malleable spikes growing out of your skull";
	now body entry is "an imposing mutant beast. Your original two arms are thick and long, with your fingers each becoming serrated claws, meant for walking or rending flesh. Below these original two arms lie a smaller set of arms with sharper, more agile finger-claws, meant only for rending and tearing. Your legs are triply-jointed, similar to the legs of a preying mantis or another insect. These slim legs end in claws, making your legs just as dangerous as your arms, should you choose to use them. Ridges of thick, sharp spines grow out of your back, running in five separate rows down your back, enhancing your fiendish look even more";
	now skin entry is "thick, plated carapace-like";
	now tail entry is "Your tail isn't actually much of a tail. Protruding from your rear is more of a large nub, a wide base that rises up to a point, pointing out about six inches long.";
	now cock entry is "otherworldly";
	now face change entry is "you feel your face reshaping itself. You feel your nose recede into your face, with two small holes being the only remnant of your original nose. Melting down into your head, your ears follow the same path as your nose, leaving only small holes as evidence of your auditory senses. Your mouth elongates, with the corners of your mouth now reaching close to your ears, while your teeth reshape and grow, filling your mouth with sharp incisors. Bony protrusions begin to form on the underside of your skull, and soon form into bony spikes, curving outwards and giving you an imposing, beastly visage. The hair on your head recedes and fuses together, forming sharp, bone-like spines. Feeling the changes cease, you find a broken mirror nearby, you take a look at yourself. Resembling a monster out of a Sci-Fi monster movie, you can't help but grin at your new inhuman visage";
	now body change entry is "changes begin to wrack your body simultaneously. Your arms thicken and elongate slightly, while your hands reshape into claws. Pain pierces your elbows as bone protrusions thrust out of them, curving out and back, the ends almost touching your shoulders. You hear your bones snapping and breaking in your legs, as your legs reshape to resemble the hind legs of a dog, but much more otherworldly. Your feet quickly follow the same path as your hands, reshaping into deadly claws, while ridges of thick spines erupt from your back forming symmetrical lines down it. Below your arms, fleshy masses begin to form, quickly gaining mass, and forming into vaguely recognizable shapes. They eventually take form and solidify, and you find yourself with another pair of hands. You quickly look over yourself to make sure these are the last of the changes, but they look to have stopped. You move around a bit and test out your new body, figuring out all of the intricacies of your new body";
	now skin change entry is "it turns a brownish color, resembling dark sand. Touching your skin, you yelp in surprise as you feel your skin harden, thickening into a dark carapace. Parts of your new carapace shift around each other, and soon enough, your skin looks like plated leather, thick, protective, and imposing";
	now ass change entry is "the skin of your ass bulges outward slightly, mass rearranging itself as the nanite infection shifts your body. The changes on your rear do not last long, and finding a mirror, you see that you now have a half-foot pointed tail, resembling a miniature mountain protruding from your backside";
	now cock change entry is "it changes to a dark-gray color, while rows of symmetrical, fleshy nubs begin to grow along the shaft of your cock. You're overcome by pain as you observe these changes, and looking down when you're able to, you're surprised at the changes taking place. The head of your cock has extended itself, and instead of tapering off to a normal cock end, has instead peeled apart into five separate appendages. After recovering from the pangs of pain, you experiment with your new wiggling cock, and you find that you can control each of these cock-tacles. You find that if you want to, you can settle all of them down, and they sit together resembling a normal cock, the only noticeable difference being that the skin of your cock head looks cut in places. You're also able to separate them apart, having your cock resemble a starfish, appendages splayed out in a traditional star shape";
	now str entry is 18;
	now dex entry is 14;
	now sta entry is 11;
	now per entry is 16;
	now int entry is 10;
	now cha entry is 7;
	now sex entry is "Female";
	now HP entry is 38;
	now lev entry is 6;
	now wdam entry is 10;
	now area entry is "Sealed";
	now cocks entry is 1;
	now cock length entry is 15;
	now cock width entry is 4;
	now breasts entry is 2;
	now breast size entry is 1;
	now male breast size entry is 0;
	now cunts entry is 1;
	now cunt length entry is 15;
	now cunt width entry is 5;
	now libido entry is 60;
	now loot entry is "foul scuttler spit";
	now lootchance entry is 35;
	now scale entry is 3;
	now body descriptor entry is "[one of]beastly[or]strange[or]frightening[or]mutated[at random]";
	now type entry is "mutant";
	now magic entry is false;
	now resbypass entry is false;
	now non-infectious entry is false;
	now DayCycle entry is 0;
	now altcombat entry is "default";
	now BannedStatus entry is false;

Section 3 - Endings

when play ends:
	if bodyname of player is "Foul Scuttler":
		if humanity of player < 10:
			if player is herm:
				if "Sterile" is not listed in feats of player:
					say "     The resounding call within your head proves to be too much for you to resist, and you soon find yourself below, in the catacombs that once was the underground labs. Finding your way throughout the halls, you hunt down the others of your species, finding nests scattered throughout the halls. Fighting for a dominant position within the pack hierarchy, you become a leader among the pack, unknowingly leading them to greatness. Subconsciously knowing that you must breed and pass along your genes, fertile females are brought to you and impregnated by your virile seed. You do your best to also seek out a male mate worthy of bearing children with you, and after many fights for the honor of fathering your children, your womb soon swells with your chosen mates seed. Many months later, your womb is swollen with children, the father of your children always present, keeping you for himself. You continue this existence, constantly pregnant and impregnating, until your nest grows large with your children. Looking throughout the labs, you order your children to hunt and mate, continuing the survival of your species, an ever-growing threat to the outside world.";
				else:
					say "     Finding yourself drawn to the dilapidated labs, you soon find yourself amongst your own species, living deep below the surface in the ruins of human construction. You're found to be an oddity amongst your species, being both male and female and unable to bear children. Living here is good, despite your odd nature. You're always fed and considered another equal member of the packs, with only the strongest dominant members of your species above you in stature. You come to find yourself a valued member of your species, as only the strongest of your species are allowed to breed, unless a unique situation arises. Because of this, many members of your species are never allowed to mate, lust and arousal building within them with no outlet. However, as you are unable to bear children, any member of your species may breed with you and not arouse the ire of the more dominant members. You soon find yourself being fucked often, many of the males above you unable to breed normally. You have no problem with this, as evident by your constant pleasured screams. You become almost as valued as a fertile female, being able to fuck constantly with most members of your species. You live out your life as luxuriously as you can, being well-taken care of by your many mates, and constantly watching the survival and evolution of your species.";
			else if player is male:
				if "Sterile" is not listed in feats of player:
					say "     Finding your way to the labs beneath the ground, you explore the endless corridors of these labs, looking for your brethren. Finally finding a nest deep in the labs, you're quickly accepted into the pack. You hunt the desolate halls for food and mates, taking survivors and explorers back to your ever-growing nest. Swelling the wombs of fertile survivors with your virile seed, their bellies bulge with your children, and they soon birth a new generation of ever-evolving magic beasts. Your children grow quickly as you teach them to live and hunt, with you always at the head of the pack, your screams echoing throughout the corridors of your home. The military tries again and again to remove you and your children, but they are never able to, every man and woman sent down into the labs disappearing forever. Your children soon seed a new generation of smarter, stronger Foul Scuttlers, but again and again, you prove to be the best among them, leading them forward without any conscious knowledge of it. Your children soon swarm the underground labs, an unstoppable force of life and evolution. Looking into the light of the surface, you let out a yell, reverberating it throughout the lab complex. The time has come, and soon, you and your children will swarm the outside world, taking it for yourself.";
				else:
					say "     Your new body soon overwhelms you, and bounding through the metal corridors and broken containment labs, you meet with your brethren and join with them. Unable to sire children, you find yourself unable to hold a truly dominant position, but your existence here is not horrible. You always lead the hunting packs, looking for food for the ever-growing nest, or fertile females for the stronger amongst you to seed. A strange honor is subconsciously awarded to you, as the best hunter of a species is a valuable beast. Losing you could easily spell death for your nest, but you have no intention of letting that happen. You're soon ordered to hunt the surface, to see what lies above. Bounding forward, you and your hunting pack quickly overwhelm the military blockade at the entrance to the labs, making sure to spare the females. You order your pack to take them down to the nest, while you and a few chosen hunters explore the outside world, looking to guarantee your species['] survival.";
			else if player is female:
				if "Sterile" is not listed in feats of player:
					say "     Finally accepting your true purpose, you seek out one of the beings that showed you the wondrousness of your new form. Finding one of the Foul Scuttlers, you quickly submit yourself to him, offering your body for his use. He quickly mounts you, and soon after, you're filled with his seed, cumming hard as he breeds you. He leads you to a nest of these beautiful beasts, your cunt still full with his offering, you know you've found your new home. You adjust to living with the beasts, hunting and learning with them. Having become one of the Scuttlers, you find yourself a prized commodity, as being one of the fertile females that is actually a true Foul Scuttler is a rare occurrence. You rapidly find yourself at the top of the nest, the matron of the Scuttlers. Finding the most powerful male of your kind, your union produces new life, your womb swelling rapidly with your children. Giving birth to a new, stronger generation of Foul Scuttlers, your children grow swiftly and learn swiftly. Soon, your children swarm the labs that you call home, driving out all competitions and threats, securing a place in the world for your species.";
				else:
					say "     Unable to cope with the outside world any longer, you descend into the winding depths of the Trevor Lab Complex, intent on finding your brethren. Following the thickening scent of your species, you soon find one of the many nests lying in the depths of the labs. You're quickly found to be unable to bear children, and while unable to be a leading member of your species, you're still treated quite well. Finding yourself to be quickly learning the ways of the Foul Scuttlers, you show an unusual intelligence amongst the Scuttlers, able to think and understand in ways most of them cannot. Organizing most of the hunts against the outside world, and quickly grasping human tactics and thought, you're able to overwhelm the humans defenses time and time again. Deciding that the labs are lost, the military seals the lab entrances, preventing any escape in a hope to starve you out. You, however, are too smart for that. Scouring the labs for certain volatile chemicals, you quickly gather them at the entrances that were sealed. Preparing your species for an invasion of the outside world, you trigger the bombs, blowing open the entrances and flooding out in a wave of otherworldly beasts. Overwhelming the small military detachments quickly, you start to plan for your continued takeover, intending to take the world by storm.";
			else:
				say "     Drawn to the broken labs where you first became a Scuttler, you do not have the will to resist the silent call that hounds you. Descending into the dark halls, you leave your previous life behind, embracing the inhuman nature seeking to overwhelm your mind. Hunting through the dark halls of Trevor Labs, you make your way to a nest of your new brethren. Falling in amongst the rest of your species, you live amongst your new brethren, hunting the desolate labs. You suddenly found yourself thrust into the position of caretaker when a military team killed a large hunting party, leaving many of the smaller young without parents. You take the orphans in, and teach them how to hunt and live as part of the Scuttlers. The young that you raise grow, and due to your caring guidance, become strong and intelligent Scuttlers, guaranteed to play a part in your species['] survival. You become revered among your nesting partners, subconsciously known as a teacher amongst your species. You continue to teach younglings how to be Scuttlers, with your students expertly hunting through the labs, their screams echoing through the corridors and sending shivers down the spines of those smart enough to know what they mean.";
		else:
			say "     After what feels like eons, the military finally rolls through, doing their best to contain the nanite infection and rescue those people that are still sane. Your unusual form was first met with fear and threats, but you're able to prove your sanity, with the military taking you to quarantine. You spend an extended amount of time in quarantine, the scientists present wanting to study your magic-warped form. Figuring that your freedom depends on your cooperation, you allow the scientists to study your form, on the promise that you'll be allowed to leave. Many weeks later, the researchers monitoring you have learned all they can from you, and you're released into the civilized world. Finding work wherever you can, you change jobs often, your coworkers unnerved by your strange appearance. Always catching odd stares or hushed whispers as people spot you, you eventually come to realize that city life may not be for you. Taking the money you had saved from the odd jobs you've had over the last few years, you search around for a home away from most civilizations, looking to live a peaceful life. Finally finding yourself a place away from people, you quickly move, and you're able to find a job doing online work, able to live peacefully.";
			if player is female or cocks of player is 0:
				say "     You're not able to fully escape civilization, however. You still have a few neighbors, and while most of them keep to themselves, you become friends with some of them, with them being able to look past your appearance. One of them, [one of]a lithe Husky-morph[or]a tough dragon-morph[or]a small rat-morph[or]a tall hawk-morph[or]a pleasant young man[at random], quickly becomes your best friend out here. Becoming closer and closer as you continue to learn more about each other, you soon find yourselves bedding each other, your screams of pleasure echoing loudly through acres of forest and farmland. Having fallen in love, you both begin living together, etching out a living in the desolate countryside. Thinking back to your adventures, you count yourself blessed that you've been able to find a good live and a wonderful lover after the things you'd witnessed during your time in the nanite-stricken city. Being called inside for dinner, you chuckle to yourself, and try to forget about all the things you'd seen. You choose to instead focus on the life ahead of you, and what that may bring.";
			else:
				say "     You're not able to fully escape civilization, however. Your new home is not entirely secret, and you soon find yourself friends with a few of your nearby neighbors. One of them, [one of]a short catgirl[or]a muscled centaur girl[or]a scarred wolf-woman[or]a skinny lizard woman[or]a lovely young woman[at random], quickly catches your heart. You soon catch hers, and you both end up in each other's beds, your screams of pleasure telling the world just how much you've fallen for each other. You both take your things and save up enough money to jointly purchase a house, moving in with each other, etching out a life for yourselves. Thinking back to your time among the infested citizens in the nanite-stricken town, you find yourself smiling at just how far you've come. Being called in for dinner, you bury your past, looking instead towards the future.";

Section 4 - Item

Table of Game Objects (continued)
name	desc	weight	object
"foul scuttler spit"	"A jar of viscous spit you gathered from a Foul Scuttler. Why you did, no one knows."	1	foul scuttler spit

foul scuttler spit is a grab object.
It is temporary.
it is part of the player.
the usedesc of foul scuttler spit is "[FoulScuttlerUse]".

to say FoulScuttlerUse:
	say "     You look disgustingly at the goopy liquid in the jar, wondering if you're insane for doing this. Steeling yourself, you bring the jar to your lips, quickly drinking the Foul Scuttler saliva. Contrary to your belief, the fluid does not taste horrendous, but it's not exactly tasty, either. Soon enough, you've drained the jar, putting it back into your pack for later use.";
	setmonster "Foul Scuttler";
	choose row monster from the Table of Random Critters;
	if "Male Preferred" is listed in feats of player:
		now sex entry is "Male";
	else if "Herm Preferred" is listed in feats of player:
		now sex entry is "Both";
	else:
		now sex entry is "Female";
	infect;

the scent of foul scuttler spit is "Unscrewing the jar and taking a whiff of the fluid inside, your nose wrinkles in disgust as the smell of rotten meat and acidic digestive juices assaults your nostrils. Screwing the cap back on, you find something to smell that'll get the scent of the saliva out of your head.".

Foul Scuttler ends here.
