Version 1 of Basic Clothing Items by Core Mechanics begins here.
[ Written by Wahn ]
[ Version 1 - New File ]

"Adds new equipment for the player."

[ Section 1 - Waist Items ]

When Play begins:
	[testing drop of all items in the library]
	[
	add { "ripped jeans", "black jeans", "sturdy jeans", "skinny jeans", "hot pants", "grey pants", "camo pants", "jogging pants", "bermuda shorts", "black miniskirt", "pencil skirt", "floral skirt" } to invent of Grey Abbey Library;
	add { "centaur cum", "centaur cum", "centaur cum", "centaur cum", "centaur cum", "behemoth horn", "behemoth horn", "behemoth horn", "behemoth horn", "behemoth horn" } to invent of Grey Abbey Library;
	]
	[not sure why setting the plural boolean does not work for the pants, but this should (for now) fix that after the fact, at the same start]
	now plural of ripped jeans is true;
	now plural of black jeans is true;
	now plural of sturdy jeans is true;
	now plural of skinny jeans is true;
	now plural of hot pants is true;
	now plural of grey pants is true;
	now plural of camo pants is true;
	now plural of jogging pants is true;
	now plural of bermuda shorts is true;

Table of Game Objects(continued)
name	desc	weight	object
"ripped jeans"	"A pair of jeans with some rips and slashes in them. Before all of this started, their look might have been a fashion statement, but these days one usually ends up with ripped clothing after a fight."	1	ripped jeans
"black jeans"	"A pair of solid black jeans. They're well-worn and a little washed out in places, but quite comfortable even in the most dire situations."	1	black jeans
"sturdy jeans"	"A pair of sturdy jeans in the typical blue color of that type of pants. They're well-worn and a little washed out in places, but quite comfortable even in the most dire situations."	1	sturdy jeans
"skinny jeans"	"A pair of jeans made from thin and fairly flexible material. They look like they'd be snug just about everywhere on any person that can wiggle their way into such a tight garment."	1	skinny jeans
"hot pants"	"A pair of red hot pants, barely long enough to cover someone's thighs even to about a third."	1	hot pants
"grey pants"	"A pair of grey cloth pants, most likely belonging to a business suit."	1	grey pants
"camo pants"	"A pair of camo pants in various shades of green. Clearly, these belong to the uniform of a soldier of the US army."	1	camo pants
"jogging pants"	"A pair of jogging pants made from fairly soft and stretchy fabric."	1	jogging pants
"bermuda shorts"	"A pair of wide shorts covered in patterns of leaves and bright flowers. They look fitting to be worn by a tourist or vacationer."	1	bermuda shorts
"black miniskirt"	"A simple black miniskirt, barely long enough to cover someone's thighs even halfway."	1	black miniskirt
"pencil skirt"	"A light blue pencil skirt, long enough to cover an average person's whole thighs, down to the knees."	1	pencil skirt
"floral skirt"	"A full length skirt, covered with a floral print that depicts cherry blossoms."	1	floral skirt

ripped jeans is a grab object.
ripped jeans is equipment.
It is not temporary.
The plural of ripped jeans is true.
The taur-compatible of ripped jeans is false.
The size of black jeans is 3.
The AC of ripped jeans is 0.
The effectiveness of ripped jeans is 0.
The placement of ripped jeans is "waist".
The descmod of ripped jeans is "A pair of ripped and torn jeans cover your hips and legs. Even though they have holes, wearing them gives you a somewhat protected feeling.".
The slot of ripped jeans is "waist".
the scent of ripped jeans is "The jeans have the typical faintly musky scent of pants that have been worn a few days. But surelythey're clean enough to wear another week or two at least...".

black jeans is a grab object.
black jeans is equipment.
It is not temporary.
The plural of black jeans is true.
The taur-compatible of black jeans is false.
The size of black jeans is 3.
The AC of black jeans is 0.
The effectiveness of black jeans is 0.
The placement of black jeans is "waist".
The descmod of black jeans is "A pair of solid black jeans cover your hips and legs. The sturdy fabric gives you a well-protected feeling.".
The slot of black jeans is "waist".
the scent of black jeans is "The jeans have the typical faintly musky scent of pants that have been worn a few days. But surelythey're clean enough to wear another week or two at least...".

sturdy jeans is a grab object.
sturdy jeans is equipment.
It is not temporary.
The plural of sturdy jeans is true.
The taur-compatible of sturdy jeans is false.
The size of sturdy jeans is 3.
The AC of sturdy jeans is 0.
The effectiveness of sturdy jeans is 0.
The placement of sturdy jeans is "waist".
The descmod of sturdy jeans is "A pair of dark blue jeans cover your hips and legs. The sturdy fabric gives you a well-protected feeling.".
The slot of sturdy jeans is "waist".
the scent of sturdy jeans is "The jeans have the typical faintly musky scent of pants that have been worn a few days. But surelythey're clean enough to wear another week or two at least...".

skinny jeans is a grab object.
skinny jeans is equipment.
It is not temporary.
The plural of skinny jeans is true.
The taur-compatible of skinny jeans is false.
The size of skinny jeans is 3.
The AC of skinny jeans is 0.
The effectiveness of skinny jeans is 0.
The placement of skinny jeans is "waist".
The descmod of skinny jeans is "A pair of dark blue jeans cover your hips and legs. They look almost painted onto you, with stretchy fabric that follows every last curve of your legs and hips.".
The slot of skinny jeans is "waist".
the scent of skinny jeans is "The jeans have the typical faintly musky scent of pants that have been worn a few days. But surelythey're clean enough to wear another week or two at least...".

hot pants is a grab object.
hot pants is equipment.
It is not temporary.
The plural of hot pants is true.
The taur-compatible of hot pants is false.
The size of hot pants is 3.
The AC of hot pants is 0.
The effectiveness of hot pants is 0.
The placement of hot pants is "waist".
The descmod of hot pants is "A pair of red hot pants cover your hips and legs. They are really skimpy, barely covering a third of your thighs. If they were any tighter, you could call them underwear.".
The slot of hot pants is "waist".
the scent of hot pants is "The pants have the typical faintly musky scent of clothing that has been worn a few days. But surelythey're clean enough to wear another week or two at least...".

grey pants is a grab object.
grey pants is equipment.
It is not temporary.
The plural of grey pants is true.
The taur-compatible of grey pants is false.
The size of grey pants is 3.
The AC of grey pants is 0.
The effectiveness of grey pants is 0.
The placement of grey pants is "waist".
The descmod of grey pants is "A pair of grey pants cover your hips and legs. They are fairly light and soft, but you worry how long they'll last given the regular fights you can get into.".
The slot of grey pants is "waist".
the scent of grey pants is "The pants have the typical faintly musky scent of clothing that has been worn a few days. But surelythey're clean enough to wear another week or two at least...".

camo pants is a grab object.
camo pants is equipment.
It is not temporary.
The plural of camo pants is true.
The taur-compatible of camo pants is false.
The size of camo pants is 3.
The AC of camo pants is 0.
The effectiveness of camo pants is 0.
The placement of camo pants is "waist".
The descmod of camo pants is "A pair of camo pants covers your hips and legs. The sturdy fabric gives you a well-protected feeling.".
The slot of camo pants is "waist".
the scent of camo pants is "The pants have the typical faintly musky scent of clothing that has been worn a few days. But surelythey're clean enough to wear another week or two at least...".

jogging pants is a grab object.
jogging pants is equipment.
It is not temporary.
The plural of jogging pants is true.
The taur-compatible of jogging pants is false.
The size of jogging pants is 3.
The AC of jogging pants is 0.
The effectiveness of jogging pants is 0.
The placement of jogging pants is "waist".
The descmod of jogging pants is "A pair of jogging pants cover your hips and legs.  They are fairly light and soft, but you worry how long they'll last given the regular fights you can get into.".
The slot of jogging pants is "waist".
the scent of jogging pants is "The pants have the typical faintly musky scent of clothing that has been worn a few days. But surelythey're clean enough to wear another week or two at least...".

bermuda shorts is a grab object.
bermuda shorts is equipment.
It is not temporary.
The plural of bermuda shorts is true.
The taur-compatible of bermuda shorts is false.
The size of bermuda shorts is 3.
The AC of bermuda shorts is 0.
The effectiveness of bermuda shorts is 0.
The placement of bermuda shorts is "waist".
The descmod of bermuda shorts is "A pair of colorful bermuda shorts cover your hips and legs. With their bright and colorful patterns, they'll surely draw attention to you.".
The slot of bermuda shorts is "waist".
the scent of bermuda shorts is "The shorts have the typical faintly musky scent of clothing that has been worn a few days. But surelythey're clean enough to wear another week or two at least...".

black miniskirt is a grab object.
black miniskirt is equipment.
It is not temporary.
The plural of black miniskirt is false.
The taur-compatible of black miniskirt is false.
The size of black miniskirt is 3.
The AC of black miniskirt is 0.
The effectiveness of black miniskirt is 0.
The placement of black miniskirt is "waist".
The descmod of black miniskirt is "A simple black miniskirt covers your hips and legs. It is really quite easy to accidentally (or on purpose) expose yourself while wearing it.".
The slot of black miniskirt is "waist".
the scent of black miniskirt is "The skirt has the typical faintly musky scent of clothing that has been worn a few days. But surelyit is clean enough to wear another week or two at least...".

pencil skirt is a grab object.
pencil skirt is equipment.
It is not temporary.
The plural of pencil skirt is false.
The taur-compatible of pencil skirt is false.
The size of pencil skirt is 3.
The AC of pencil skirt is 0.
The effectiveness of pencil skirt is 0.
The placement of pencil skirt is "waist".
The descmod of pencil skirt is "A dark blue pencil skirt covers your hips and legs. It is long and narrow, giving you a slim look.".
The slot of pencil skirt is "waist".
the scent of pencil skirt is "The skirt has the typical faintly musky scent of clothing that has been worn a few days. But surely it is clean enough to wear another week or two at least...".

floral skirt is a grab object.
floral skirt is equipment.
It is not temporary.
The plural of floral skirt is false.
The taur-compatible of floral skirt is false.
The size of floral skirt is 3.
The AC of floral skirt is 0.
The effectiveness of floral skirt is 0.
The placement of floral skirt is "waist".
The descmod of floral skirt is "A floor length skirt covers your hips and legs. It is covered in a floral pattern that depics cherry blossoms.".
The slot of floral skirt is "waist".
the scent of floral skirt is "The skirt has the typical faintly musky scent of clothing that has been worn a few days. But surely it is clean enough to wear another week or two at least...".


[ Section 2 - Chest Items ]

[
When Play begins:
	add { "black t-shirt", "white t-shirt", "maroon pullover", "zephyr shirt", "camo shirt", "sleeveless shirt", "mesh shirt" } to invent of Grey Abbey Library;
]

Table of Game Objects(continued)
name	desc	weight	object
"black t-shirt"	"A simple black t-shirt, without any pattern or frills to it."	1	black t-shirt
"white t-shirt"	"A simple white t-shirt, without any pattern or frills to it"	1	white t-shirt
"maroon pullover"	"A fairly large maroon pullover. It is perfect to keep its wearer warm."	1	maroon pullover
"zephyr shirt"	"A simple dark grey t-shirt, with a light blue stylized Z covering the middle of its chest. Depending on whom you ask, it either makes the wearer look like a superhero, or a corporate drone of Zephyr."	1	zephyr shirt
"camo shirt"	"A t-shirt with camo patterns in various shades of green. Clearly, it belongs to the uniform of a soldier of the US army."	1	camo shirt
"sleeveless shirt"	"A white sleeveless shirt, made from and stretchy fabric. It looks suitable to be working out in it."	1	sleeveless shirt
"mesh shirt"	"A tight shirt made of some kind of black, sheer mesh. You can literally see right through it."	1	mesh shirt

black t-shirt is a grab object.
black t-shirt is equipment.
It is not temporary.
The plural of black t-shirt is false.
The taur-compatible of black t-shirt is true.
The size of black t-shirt is 3.
The AC of black t-shirt is 0.
The effectiveness of black t-shirt is 0.
The placement of black t-shirt is "chest".
The descmod of black t-shirt is "Your upper body is covered by a black t-shirt.".
The slot of black t-shirt is "chest".
the scent of black t-shirt is "The fabric has the typical faintly musky scent clothing that has been worn a few days. Still, it's good enough for a few more, at least. During the nanite apocalypse, one can give some leeway in terms of body hygiene - survival comes first...".

white t-shirt is a grab object.
white t-shirt is equipment.
It is not temporary.
The plural of white t-shirt is false.
The taur-compatible of white t-shirt is true.
The size of white t-shirt is 3.
The AC of white t-shirt is 0.
The effectiveness of white t-shirt is 0.
The placement of white t-shirt is "chest".
The descmod of white t-shirt is "Your upper body is covered by a white t-shirt.".
The slot of white t-shirt is "chest".
the scent of white t-shirt is "The fabric has the typical faintly musky scent clothing that has been worn a few days. Still, it's good enough for a few more, at least. During the nanite apocalypse, one can give some leeway in terms of body hygiene - survival comes first...".

maroon pullover is a grab object.
maroon pullover is equipment.
It is not temporary.
The plural of maroon pullover is false.
The taur-compatible of maroon pullover is true.
The size of maroon pullover is 3.
The AC of maroon pullover is 0.
The effectiveness of maroon pullover is 0.
The placement of maroon pullover is "chest".
The descmod of maroon pullover is "Your upper body is covered by a maroon pullover.".
The slot of maroon pullover is "chest".
the scent of maroon pullover is "The fabric has the typical faintly musky scent clothing that has been worn a few days. Still, it's good enough for a few more, at least. During the nanite apocalypse, one can give some leeway in terms of body hygiene - survival comes first...".

zephyr shirt is a grab object.
zephyr shirt is equipment.
It is not temporary.
The plural of zephyr shirt is false.
The taur-compatible of zephyr shirt is true.
The size of zephyr shirt is 3.
The AC of zephyr shirt is 0.
The effectiveness of zephyr shirt is 0.
The placement of zephyr shirt is "chest".
The descmod of zephyr shirt is "Your upper body is covered by a dark grey t-shirt with the Zephyr logo.".
The slot of zephyr shirt is "chest".
the scent of zephyr shirt is "The fabric has the typical faintly musky scent clothing that has been worn a few days. Still, it's good enough for a few more, at least. During the nanite apocalypse, one can give some leeway in terms of body hygiene - survival comes first...".

camo shirt is a grab object.
camo shirt is equipment.
It is not temporary.
The plural of camo shirt is false.
The taur-compatible of camo shirt is true.
The size of camo shirt is 3.
The AC of camo shirt is 0.
The effectiveness of camo shirt is 0.
The placement of camo shirt is "chest".
The descmod of camo shirt is "Your upper body is covered by a camo pattern t-shirt in shades of green.".
The slot of camo shirt is "chest".
the scent of camo shirt is "The fabric has the typical faintly musky scent clothing that has been worn a few days. Still, it's good enough for a few more, at least. During the nanite apocalypse, one can give some leeway in terms of body hygiene - survival comes first...".

sleeveless shirt is a grab object.
sleeveless shirt is equipment.
It is not temporary.
The plural of sleeveless shirt is false.
The taur-compatible of sleeveless shirt is true.
The size of sleeveless shirt is 3.
The AC of sleeveless shirt is 0.
The effectiveness of sleeveless shirt is 0.
The placement of sleeveless shirt is "chest".
The descmod of sleeveless shirt is "Your upper body is covered by a white sleeveless shirt.".
The slot of sleeveless shirt is "chest".
the scent of sleeveless shirt is "The fabric has the typical faintly musky scent clothing that has been worn a few days. Still, it's good enough for a few more, at least. During the nanite apocalypse, one can give some leeway in terms of body hygiene - survival comes first...".

mesh shirt is a grab object.
mesh shirt is equipment.
It is not temporary.
The plural of mesh shirt is false.
The taur-compatible of mesh shirt is true.
The size of mesh shirt is 3.
The AC of mesh shirt is 0.
The effectiveness of mesh shirt is 0.
The placement of mesh shirt is "chest".
The descmod of mesh shirt is "Your upper body is covered by a black mesh shirt. With its sheer fabric, you can literally see right through it.".
The slot of mesh shirt is "chest".
the scent of mesh shirt is "The fabric has the typical faintly musky scent clothing that has been worn a few days. Still, it's good enough for a few more, at least. During the nanite apocalypse, one can give some leeway in terms of body hygiene - survival comes first...".

[ Section 3 - Shoes ]

When Play begins:
	[
	add { "combat boots", "brown loafers", "leather sandals", "high heels", "stiletto heels", "jogging shoes", "cowboy boots" } to invent of Grey Abbey Library;
	]
	now plural of combat boots is true;
	now plural of brown loafers is true;
	now plural of leather sandals is true;
	now plural of high heels is true;
	now plural of stiletto heels is true;
	now plural of jogging shoes is true;
	now plural of cowboy boots is true;
	
Table of Game Objects(continued)
name	desc	weight	object
"combat boots"	"A pair of black combat boots. They are quite sturdy and fairly heavy because of the steel caps in them."	3	combat boots
"brown loafers"	"A pair of brown loafers. They look comfortable and one can just slide right in without having to worry about tying them."	1	brown loafers
"leather sandals"	"A pair of leather sandals. They have a number of straps that can be used to fasten them to your foot."	1	leather sandals
"high heels"	"A pair of bright red woman's shoes, with moderately high heels. Not exactly the best thing to run around with at speed."	1	high heels
"stiletto heels"	"A pair of black woman's shoes, with very high heels. Not exactly the best thing to run around with at speed."	1	stiletto heels
"jogging shoes"	"A pair of athlete's jogging shoes. They look new and are still bright and shiny."	1	jogging shoes
"cowboy boots"	"A pair of cowboy boots made from dark brown leather, complete with high heels and a relatively narrow toe. They are sure to make using stirrups easier, and can protect against rattlesnake bites."	1	cowboy boots

combat boots is a grab object.
combat boots is equipment.
It is not temporary.
The plural of combat boots is true.
The taur-compatible of combat boots is false.
The size of combat boots is 3.
The AC of combat boots is 0.
The effectiveness of combat boots is 0.
The placement of combat boots is "feet".
The descmod of combat boots is "You are wearing sturdy black combat boots. They even have steel caps that protect your toes.".
The slot of combat boots is "feet".
the scent of combat boots is "The boots smell like leather and rubber.".

brown loafers is a grab object.
brown loafers is equipment.
It is not temporary.
The plural of brown loafers is true.
The taur-compatible of brown loafers is false.
The size of brown loafers is 3.
The AC of brown loafers is 0.
The effectiveness of brown loafers is 0.
The placement of brown loafers is "feet".
The descmod of brown loafers is "You are wearing comfortable brown loafers.".
The slot of brown loafers is "feet".
the scent of brown loafers is "The loafers smell like leather.".

leather sandals is a grab object.
leather sandals is equipment.
It is not temporary.
The plural of leather sandals is true.
The taur-compatible of leather sandals is false.
The size of leather sandals is 3.
The AC of leather sandals is 0.
The effectiveness of leather sandals is 0.
The placement of leather sandals is "feet".
The descmod of leather sandals is "Two leather sandals are strapped to your feet.".
The slot of leather sandals is "feet".
the scent of leather sandals is "The sandals smell like leather.".

high heels is a grab object.
high heels is equipment.
It is not temporary.
The plural of high heels is true.
The taur-compatible of high heels is false.
The size of high heels is 3.
The AC of high heels is 0.
The effectiveness of high heels is 0.
The placement of high heels is "feet".
The descmod of high heels is "You are wearing two red high heels. It won't be easy to run in these, but you sure look fabulous like this.".
The slot of high heels is "feet".
the scent of high heels is "The shoes smell a bit of laquer and plastic.".

stiletto heels is a grab object.
stiletto heels is equipment.
It is not temporary.
The plural of stiletto heels is true.
The taur-compatible of stiletto heels is false.
The size of stiletto heels is 3.
The AC of stiletto heels is 0.
The effectiveness of stiletto heels is 0.
The placement of stiletto heels is "feet".
The descmod of stiletto heels is "You are wearing two black stiletto heels. They're quite extraordinary high and have very narrow heels.".
The slot of stiletto heels is "feet".
the scent of stiletto heels is "The shoes smell a bit of laquer and plastic.".

jogging shoes is a grab object.
jogging shoes is equipment.
It is not temporary.
The plural of jogging shoes is true.
The taur-compatible of jogging shoes is false.
The size of jogging shoes is 3.
The AC of jogging shoes is 0.
The effectiveness of jogging shoes is 0.
The placement of jogging shoes is "feet".
The descmod of jogging shoes is "You are wearing fairly new jogging shoes. Just perfect to run with.".
The slot of jogging shoes is "feet".
the scent of jogging shoes is "The shoes smell like plastic and not much else. Good thing these are new.".

cowboy boots is a grab object.
cowboy boots is equipment.
It is not temporary.
The plural of cowboy boots is true.
The taur-compatible of cowboy boots is false.
The size of cowboy boots is 3.
The AC of cowboy boots is 0.
The effectiveness of cowboy boots is 0.
The placement of cowboy boots is "feet".
The descmod of cowboy boots is "You are wearing a pair of dark brown cowboy boots. You won't have to fear brambles and rattlesnakes with these on, that's for sure.".
The slot of cowboy boots is "feet".
the scent of cowboy boots is "The boots smell like leather.".


[ Section 4 - Underwear ]

When Play begins:
	[
	add { "ragged loincloth", "simple loincloth", "boxer briefs", "white briefs", "orange jockstrap", "mesh undies", "pink panties" } to invent of Grey Abbey Library;
	]
	now plural of boxer briefs is true;
	now plural of white briefs is true;
	now plural of mesh undies is true;
	now plural of pink panties is true;
	
Table of Game Objects(continued)
name	desc	weight	object
"ragged loincloth"	"A ragged piece of brown fabric that one can tie around their hips to cover the bare essentials."	0	ragged loincloth
"simple loincloth"	"A simple white cotton loincloth. One can tie it around their hips to cover the bare essentials."	0	simple loincloth
"boxer briefs"	"A pair of black boxer briefs with a grey band of elastic at the top. Simple, yet functional."	0	boxer briefs
"white briefs"	"A pair of tight white briefs. Simple, yet functional."	0	white briefs
"orange jockstrap"	"A jockstrap in bright orange, clearly made for people who do not mind showing off quite a bit."	0	orange jockstrap
"mesh undies"	"Underwear made of sheer black mesh. You can literally see right through it."	0	mesh undies
"pink panties"	"A pair of pink panties with frilly edges."	0	pink panties

ragged loincloth is a grab object.
ragged loincloth is equipment.
It is not temporary.
The plural of ragged loincloth is false.
The taur-compatible of ragged loincloth is false.
The size of ragged loincloth is 3.
The AC of ragged loincloth is 0.
The effectiveness of ragged loincloth is 0.
The placement of ragged loincloth is "crotch".
The descmod of ragged loincloth is "A ragged loincloth barely covers your crotch. It is fairly easy to expose yourself with the wrong (or right?) move.".
The slot of ragged loincloth is "crotch".
the scent of ragged loincloth is "Smells a little bit musky. Apparently the loincloth has been worn before, but is fairly clean.".

simple loincloth is a grab object.
simple loincloth is equipment.
It is not temporary.
The plural of simple loincloth is false.
The taur-compatible of simple loincloth is false.
The size of simple loincloth is 3.
The AC of simple loincloth is 0.
The effectiveness of simple loincloth is 0.
The placement of simple loincloth is "crotch".
The descmod of simple loincloth is "A simple white loincloth is tied around your crotch.".
The slot of simple loincloth is "crotch".
the scent of simple loincloth is "Smells a little bit musky. Apparently the loincloth has been worn before, but is fairly clean.".

boxer briefs is a grab object.
boxer briefs is equipment.
It is not temporary.
The plural of boxer briefs is true.
The taur-compatible of boxer briefs is false.
The size of boxer briefs is 3.
The AC of boxer briefs is 0.
The effectiveness of boxer briefs is 0.
The placement of boxer briefs is "crotch".
The descmod of boxer briefs is "A pair of black boxer briefs cover your crotch.".
The slot of boxer briefs is "crotch".
the scent of boxer briefs is "Smells a little bit musky. Apparently the underwear has been worn before, but is fairly clean.".

white briefs is a grab object.
white briefs is equipment.
It is not temporary.
The plural of white briefs is true.
The taur-compatible of white briefs is false.
The size of white briefs is 3.
The AC of white briefs is 0.
The effectiveness of white briefs is 0.
The placement of white briefs is "crotch".
The descmod of white briefs is "A pair of tight white briefs cover your crotch.".
The slot of white briefs is "crotch".
the scent of white briefs is "Smells a little bit musky. Apparently the underwear has been worn before, but is fairly clean.".

orange jockstrap is a grab object.
orange jockstrap is equipment.
It is not temporary.
The plural of orange jockstrap is false.
The taur-compatible of orange jockstrap is false.
The size of orange jockstrap is 3.
The AC of orange jockstrap is 0.
The effectiveness of orange jockstrap is 0.
The placement of orange jockstrap is "crotch".
The descmod of orange jockstrap is "An orange jockstrap covers your crotch while leaving your ass and back door bare. This makes you feel somewhat exposed, yet at the same time you can't help but want to show off.".
The slot of orange jockstrap is "crotch".
the scent of orange jockstrap is "Smells a little bit musky. Apparently the underwear has been worn before, but is fairly clean.".

mesh undies is a grab object.
mesh undies is equipment.
It is not temporary.
The plural of mesh undies is true.
The taur-compatible of mesh undies is false.
The size of mesh undies is 3.
The AC of mesh undies is 0.
The effectiveness of mesh undies is 0.
The placement of mesh undies is "crotch".
The descmod of mesh undies is "A pair of mesh undies around your hips expose more than they conceal.".
The slot of mesh undies is "crotch".
the scent of mesh undies is "Smells a little bit musky. Apparently the underwear has been worn before, but is fairly clean.".

pink panties is a grab object.
pink panties is equipment.
It is not temporary.
The plural of pink panties is true.
The taur-compatible of pink panties is false.
The size of pink panties is 3.
The AC of pink panties is 0.
The effectiveness of pink panties is 0.
The placement of pink panties is "crotch".
The descmod of pink panties is "A skimpy and frilly pair of pink panties cover your crotch.".
The slot of pink panties is "crotch".
the scent of pink panties is "Smells a little bit musky. Apparently the underwear has been worn before, but is fairly clean.".

[ Section 5 - Glasses ]

When Play begins:
	[
	add { "" } to invent of Grey Abbey Library;
	]
	now plural of stylish sunglasses is true;
	now plural of basic sunglasses is true;
	now plural of horn-rimmed glasses is true;
	now plural of aviator goggles is true;
	now plural of lab goggles is true;
	now plural of prop glasses is true;
	now plural of rose-tinted glasses is true;
	
Table of Game Objects(continued)
name	desc	weight	object
"stylish sunglasses"	"A set of Lu-Beam sunglasses with a very stylish shape. Those are sure to make anyone look like a star."	0	stylish sunglasses
"basic sunglasses"	"A set of fairly basic sunglasses with a black plastic frame. Nothing special, but they'll protect your eyes."	0	basic sunglasses
"horn-rimmed glasses"	"A pair of dignified horn-rimmed glasses with slightly curved lenses."	0	horn-rimmed glasses
"aviator goggles"	"A set of aviator goggles with a strap to keep them tightly pressed to someone's face. Perfect for situations like being in strong winds, or being in danger of getting cum-facials by lots of horny monster."	0	aviator goggles
"lab goggles"	"A pair of clear plastic goggles that closely fit to someone's face. They're perfect to keep harmful chemicals (and spurting cum) out of your eyes."	0	lab goggles
"prop glasses"	"A pair of stylish glasses with clear glass lenses in their frames. These are what you'd see on stage or in a movie, creating the right appearance without giving people headaches from wearing glasses even if they are not needed."	0	prop glasses
"rose-tinted glasses"	"A pair of rose-tinted glasses with frilly edges. There even are some glass gemstones with reflective backing glued to them."	0	rose-tinted glasses

stylish sunglasses is a grab object.
stylish sunglasses is equipment.
It is not temporary.
The plural of stylish sunglasses is true.
The taur-compatible of stylish sunglasses is true.
The size of stylish sunglasses is 0.
The AC of stylish sunglasses is 0.
The effectiveness of stylish sunglasses is 0.
The placement of stylish sunglasses is "eyes".
The descmod of stylish sunglasses is "An expensive set of sunglasses sits on your nose, giving you a stylish look and protecting your eyes.".
The slot of stylish sunglasses is "eyes".
the scent of stylish sunglasses is "The glasses don't smell like anything really.".

basic sunglasses is a grab object.
basic sunglasses is equipment.
It is not temporary.
The plural of basic sunglasses is true.
The taur-compatible of basic sunglasses is true.
The size of basic sunglasses is 0.
The AC of basic sunglasses is 0.
The effectiveness of basic sunglasses is 0.
The placement of basic sunglasses is "eyes".
The descmod of basic sunglasses is "An cheap set of sunglasses sits on your nose, protecting your eyes from bright light.".
The slot of basic sunglasses is "eyes".
the scent of basic sunglasses is "The glasses don't smell like anything really.".

horn-rimmed glasses is a grab object.
horn-rimmed glasses is equipment.
It is not temporary.
The plural of horn-rimmed glasses is true.
The taur-compatible of horn-rimmed glasses is true.
The size of horn-rimmed glasses is 0.
The AC of horn-rimmed glasses is 0.
The effectiveness of horn-rimmed glasses is 0.
The placement of horn-rimmed glasses is "eyes".
The descmod of horn-rimmed glasses is "A pair of horn-rimmed glasses on your nose give you a dignified look.".
The slot of horn-rimmed glasses is "eyes".
the scent of horn-rimmed glasses is "The glasses don't smell like anything really.".

aviator goggles is a grab object.
aviator goggles is equipment.
It is not temporary.
The plural of aviator goggles is true.
The taur-compatible of aviator goggles is true.
The size of aviator goggles is 0.
The AC of aviator goggles is 0.
The effectiveness of aviator goggles is 0.
The placement of aviator goggles is "eyes".
The descmod of aviator goggles is "A pair of aviator goggles cover your eyes, protecting them from danger - like spurts of cum, for example.".
The slot of aviator goggles is "eyes".
the scent of aviator goggles is "The goggles don't smell like anything really.".

lab goggles is a grab object.
lab goggles is equipment.
It is not temporary.
The plural of lab goggles is true.
The taur-compatible of lab goggles is true.
The size of lab goggles is 0.
The AC of lab goggles is 0.
The effectiveness of lab goggles is 0.
The placement of lab goggles is "eyes".
The descmod of lab goggles is "A pair of lab goggles cover your eyes, protecting them from danger - like spurts of cum, for example.".
The slot of lab goggles is "eyes".
the scent of lab goggles is "The goggles don't smell like anything really.".

prop glasses is a grab object.
prop glasses is equipment.
It is not temporary.
The plural of prop glasses is true.
The taur-compatible of prop glasses is true.
The size of prop glasses is 0.
The AC of prop glasses is 0.
The effectiveness of prop glasses is 0.
The placement of prop glasses is "eyes".
The descmod of prop glasses is "A pair of prop glasses on your nose gives you an intelligent air.".
The slot of prop glasses is "eyes".
the scent of prop glasses is "The glasses don't smell like anything really.".

rose-tinted glasses is a grab object.
rose-tinted glasses is equipment.
It is not temporary.
The plural of rose-tinted glasses is true.
The taur-compatible of rose-tinted glasses is true.
The size of rose-tinted glasses is 0.
The AC of rose-tinted glasses is 0.
The effectiveness of rose-tinted glasses is 0.
The placement of rose-tinted glasses is "eyes".
The descmod of rose-tinted glasses is "A pair of somewhat kitschy glasses on your nose gives you a rose-tinted outlook of the world.".
The slot of rose-tinted glasses is "eyes".
the scent of rose-tinted glasses is "The glasses don't smell like anything really.".

[ Section 6 - Helmets ]

[
When Play begins:

	add { "" } to invent of Grey Abbey Library;
]
	
Table of Game Objects(continued)
name	desc	weight	object
"motorcycle helmet"	"A black motorcycle helmet with a clear visor. Heavy, but protective."	3	motorcycle helmet
"bike helmet"	"A plastic foam bicycle helmet, complete with a white shell and reflective stripes, as well as a strap to fasten it to the wearer's head."	1	bike helmet
"protective helmet"	"A white protection helmet as might be worn by industrial workers. That should certainly ward off some bumps to the wearer's head."	2	protective helmet
"tin-foil hat"	"A bunch of tin foil, bent into shape to cover a human's head. It might protect its wearer from alien mind control rays, or could possibly ensure that the head is still juicy and not burned on the outside when baked..."	0	tin-foil hat
"grey fedora"	"A grey fedora hat with soft brim and indented crown. Wearing it might make you look like a private detective, or a hipster."	0	grey fedora
"baseball cap"	"A blue baseball cap with the logo of the Tenvale Gorillas on its front."	0	baseball cap
"knitted skullcap"	"A woolen cap, made to rightly stretch over someone's skull."	0	knitted skullcap
"football helmet"	"A white football helmet with the logo of the Tenvale Gorillas on both sides. Heavy, but protective."	3	football helmet

motorcycle helmet is a grab object.
motorcycle helmet is equipment.
It is not temporary.
The plural of motorcycle helmet is false.
The taur-compatible of motorcycle helmet is true.
The size of motorcycle helmet is 3.
The AC of motorcycle helmet is 60.
The effectiveness of motorcycle helmet is 80.
The placement of motorcycle helmet is "head".
The descmod of motorcycle helmet is "Your head is encased in the thick shell of a motorcycle helmet.".
The slot of motorcycle helmet is "head".
the scent of motorcycle helmet is "The helmet smells of plastic and fabric.".

bike helmet is a grab object.
bike helmet is equipment.
It is not temporary.
The plural of bike helmet is false.
The taur-compatible of bike helmet is true.
The size of bike helmet is 3.
The AC of bike helmet is 20.
The effectiveness of bike helmet is 40.
The placement of bike helmet is "head".
The descmod of bike helmet is "A plastic bike helmet encases the upper half of your head.".
The slot of bike helmet is "head".
the scent of bike helmet is "The helmet smells like plastic.".

protective helmet is a grab object.
protective helmet is equipment.
It is not temporary.
The plural of protective helmet is false.
The taur-compatible of protective helmet is true.
The size of protective helmet is 3.
The AC of protective helmet is 30.
The effectiveness of protective helmet is 60.
The placement of protective helmet is "head".
The descmod of protective helmet is "A white protective helmet sits on your head, providing some protection.".
The slot of protective helmet is "head".
the scent of protective helmet is "The helmet smells like plastic.".

tin-foil hat is a grab object.
tin-foil hat is equipment.
It is not temporary.
The plural of tin-foil hat is false.
The taur-compatible of tin-foil hat is true.
The size of tin-foil hat is 3.
The AC of tin-foil hat is 0.
The effectiveness of tin-foil hat is 0.
The placement of tin-foil hat is "head".
The descmod of tin-foil hat is "A tin-foil hat covers your head, providing a dubious level of protection against... something.".
The slot of tin-foil hat is "head".
the scent of tin-foil hat is "The hat smells a bit like metal".

grey fedora is a grab object.
grey fedora is equipment.
It is not temporary.
The plural of grey fedora is false.
The taur-compatible of grey fedora is true.
The size of grey fedora is 3.
The AC of grey fedora is 0.
The effectiveness of grey fedora is 0.
The placement of grey fedora is "head".
The descmod of grey fedora is "A grey fedora covers your head, making you look like a private detective from the prohibition days.".
The slot of grey fedora is "head".
the scent of grey fedora is "The hat smells like wool.".

baseball cap is a grab object.
baseball cap is equipment.
It is not temporary.
The plural of baseball cap is false.
The taur-compatible of baseball cap is true.
The size of baseball cap is 3.
The AC of baseball cap is 0.
The effectiveness of baseball cap is 0.
The placement of baseball cap is "head".
The descmod of baseball cap is "A blue baseball cap covers your head, providing some protection from the sun with its visor.".
The slot of baseball cap is "head".
the scent of baseball cap is "The cap smells like fabric and plastic".

knitted skullcap is a grab object.
knitted skullcap is equipment.
It is not temporary.
The plural of knitted skullcap is false.
The taur-compatible of knitted skullcap is true.
The size of knitted skullcap is 3.
The AC of knitted skullcap is 0.
The effectiveness of knitted skullcap is 0.
The placement of knitted skullcap is "head".
The descmod of knitted skullcap is "A knitted skullcap covers the top of your head.".
The slot of knitted skullcap is "head".
the scent of knitted skullcap is "The cap smells like wool.".

football helmet is a grab object.
football helmet is equipment.
It is not temporary.
The plural of football helmet is false.
The taur-compatible of football helmet is true.
The size of football helmet is 3.
The AC of football helmet is 40.
The effectiveness of football helmet is 80.
The placement of football helmet is "head".
The descmod of football helmet is "Your head is encased in the thick shell of a football helmet.".
The slot of football helmet is "head".
the scent of football helmet is "The helmet smells of plastic and fabric.".

[ Section 6 - Helmets ]

When Play begins:
	[
	add { "" } to invent of Grey Abbey Library;
	]
	now plural of football pads is true;
	
Table of Game Objects(continued)
name	desc	weight	object
"leather jacket"	"A black leather jacket some shiny silver buttons and zippers. Stylish and protective."	4	leather jacket
"sturdy greatcoat"	"A full-body coat made from thick wool. It will certainly protect you from bad weather, but the sturdy material should also be some help in a close-combat fight."	5	sturdy greatcoat
"bulletproof vest"	"A heavy-duty bulletproof vest, complete with metal plates for extra protection."	14	bulletproof vest
"medieval breastplate"	"A shiny medieval breastplate. It is either a historical artifact or a quite good reproduction - either way, this should allow for some serious protection for someone who wants to survive the nanite apocalypse."	20	medieval breastplate
"roadsign breastplate"	"A breastplate that someone fairly large seems to have crafted from things that were available - namely roadsigns. The front is formed by a STOP sign that has been hammered into a slight curve, with further signs bolted to its edges to curve around the sides of the body. Heavy leather straps for over the shoulders hold another stop sign forming the back plate."	30	roadsign breastplate
"football pads"	"Tough polymer football pads, sized to cover the shoulders and upper chest of a human player. There even is an extra plate attached to the front in order to cover the abdominal area of the wearer. You can see the logo of the Tenvale Gorillas emblazoned on the left pec."	9	football pads
"life jacket"	"A bright orange life jacket. It'll help normal humans stay afloat and comes with an attached whistle and light."	2	life jacket
"shoulder pad"	"An oversized, padded shoulderpad that juts out to the side too much. It won't cover much, but it might help."	1	shoulder pad

leather jacket is a grab object.
leather jacket is equipment.
It is not temporary.
The plural of leather jacket is false.
The taur-compatible of leather jacket is true.
The size of leather jacket is 3.
The AC of leather jacket is 30.
The effectiveness of leather jacket is 70.
The placement of leather jacket is "body".
The descmod of leather jacket is "A black leather jacket covers your upper body.".
The slot of leather jacket is "body".
the scent of leather jacket is "The jacket smells like leather.".

sturdy greatcoat is a grab object.
sturdy greatcoat is equipment.
It is not temporary.
The plural of sturdy greatcoat is false.
The taur-compatible of sturdy greatcoat is true.
The size of sturdy greatcoat is 3.
The AC of sturdy greatcoat is 15.
The effectiveness of sturdy greatcoat is 80.
The placement of sturdy greatcoat is "body".
The descmod of sturdy greatcoat is "A full length woolen greatcoat covers your body.".
The slot of sturdy greatcoat is "body".
the scent of sturdy greatcoat is "The coat smells like whool.".

bulletproof vest is a grab object.
bulletproof vest is equipment.
It is not temporary.
The plural of bulletproof vest is false.
The taur-compatible of bulletproof vest is true.
The size of bulletproof vest is 3.
The AC of bulletproof vest is 70.
The effectiveness of bulletproof vest is 60.
The placement of bulletproof vest is "body".
The descmod of bulletproof vest is "A reinforced bulletproof vest covers your upper body.".
The slot of bulletproof vest is "body".
the scent of bulletproof vest is "The vest smells slightly of sweat, which isn't too woundrous as these things usually are put on in times of great stress.".

medieval breastplate is a grab object.
medieval breastplate is equipment.
It is not temporary.
The plural of medieval breastplate is false.
The taur-compatible of medieval breastplate is true.
The size of medieval breastplate is 3.
The AC of medieval breastplate is 65.
The effectiveness of medieval breastplate is 60.
The placement of medieval breastplate is "body".
The descmod of medieval breastplate is "A medieval breastplate covers your chest and back with shiny metal.".
The slot of medieval breastplate is "body".
the scent of medieval breastplate is "The breastplate smells like metal".

roadsign breastplate is a grab object.
roadsign breastplate is equipment.
It is not temporary.
The plural of roadsign breastplate is false.
The taur-compatible of roadsign breastplate is true.
The size of roadsign breastplate is 4.
The AC of roadsign breastplate is 60.
The effectiveness of roadsign breastplate is 50.
The placement of roadsign breastplate is "body".
The descmod of roadsign breastplate is "A roadsign breastplate covers your chest and back in an improvised patchwork of metal.".
The slot of roadsign breastplate is "body".
the scent of roadsign breastplate is "The breastplate smells like metal".

football pads is a grab object.
football pads is equipment.
It is not temporary.
The plural of football pads is true.
The taur-compatible of football pads is true.
The size of football pads is 3.
The AC of football pads is 30.
The effectiveness of football pads is 50.
The placement of football pads is "body".
The descmod of football pads is "Blue football pads cover chest, abs and shoulders providing protective padding.".
The slot of football pads is "body".
the scent of football pads is "The pads smell of plastic, fabric and sweat.".

life jacket is a grab object.
life jacket is equipment.
It is not temporary.
The plural of life jacket is false.
The taur-compatible of life jacket is true.
The size of life jacket is 3.
The AC of life jacket is 20.
The effectiveness of life jacket is 40.
The placement of life jacket is "body".
The descmod of life jacket is "A bright orange life jacket covers your upper body.".
The slot of life jacket is "body".
the scent of life jacket is "The life jacket smells of synthetic fabrics.".

shoulder pad is a grab object.
shoulder pad is equipment.
It is not temporary.
The plural of shoulder pad is false.
The taur-compatible of shoulder pad is true.
The size of shoulder pad is 3.
The AC of shoulder pad is 13.
The effectiveness of shoulder pad is 13.
The placement of shoulder pad is "body".
The descmod of shoulder pad is "A single, armoured pad is strapped to your shoulder.".
The slot of shoulder pad is "body".
the scent of shoulder pad is "The shoulder pad stinks of the [']90s.".


Basic Clothing Items ends here.