Version 1 of Equipment by Core Mechanics begins here.
[ Written by Wahn ]
[ Version 1 - New File ]
[ Version 2 - Added a lot of new clothes and reorganized clothing lists. Added new stats to all clothing and gear (traits and gender appearance) by Luneth]
[ Version 2.1 - Added a few new TF equipment pieces by Luneth]
[ Version 2.2 - fixed "road sign breastplate" name]

"Adds new equipment for the player."

[                   Basic Slot Placements                                       ]
[Hat: Head Slot                                                                 ]
[Hair Accessory: Hair Slot                                                      ]
[Glasses: Eye Slot                                                              ]
[Mask: Face Slot                                                                ]
[Neckwear: Neck Slot                                                            ]
[Necklace: Neck Slot                                                            ]
[Jacket: Back Slot                                                              ]
[Shirt: Chest Slot                                                              ]
[Bra: Breast Slot                                                               ]
[Torso Trainers: Stomach Slot                                                   ]
[Wristbands: Arms Slot                                                          ]
[Gloves: Hands Slot                                                             ]
[Rings: Ring Slot                                                               ]
[Belt: Waist Slot                                                               ]
[Pants: Leg Slot                                                                ]
[Skirt: Leg Slot                                                                ]
[Underwear: Groin Slot                                                          ]
[Cock Accessory: Cock Slot                                                      ]
[Pussy Accessory: Cunt Slot                                                     ]
[Socks: Calf Slot                                                               ]
[Shoes: Feet Slot                                                               ]

[                   Expanded Slot Placements (not implemented yet)              ]
[Earring: Ear Slot                                                              ]
[Eyebrow Ring: Eyebrow Slot                                                     ]
[Nose Ring: Nose Slot                                                           ]
[Lip Ring: Lip Slot                                                             ]
[Tongue Ring: Tongue Slot                                                       ]
[Nipple Ring: Nipple Slot                                                       ]
[Bellybutton Ring: Bellybutton Slot                                             ]
[Cock Ring: Shaft Slot                                                          ]
[Clit Ring: Clit Slot                                                           ]

Book 1 - Gear & Equipment

Section 1 - Hats

Part 1 - Motorcycle Helmets

Table of Game Objects (continued)
name	desc	weight	object
"black motorcycle helmet"	"A black motorcycle helmet with a clear visor. Heavy, but protective. Judging by the helmet's appearance, it's [']unisex['] and pretty [']cool[']."	3	black motorcycle helmet
"flaming motorcycle helmet"	"A black motorcycle helmet with a clear visor and painted flames rising along the sides. Heavy, but protective. Judging by the helmet's appearance, it's [']unisex['] and pretty [']rebellious[']."	3	flaming motorcycle helmet
"succubus motorcycle helmet"	"A black motorcycle helmet with a clear visor and a picture of a sexy succubus with her legs spread over your face. Heavy, but protective. Judging by the helmet's appearance, it's [']feminine['] and pretty [']sexy[']."	3	succubus motorcycle helmet
"incubus motorcycle helmet"	"A black motorcycle helmet with a clear visor and a picture of a sexy incubus jerking off over your face. Heavy, but protective. Judging by the helmet's appearance, it's [']masculine['] and pretty [']sexy[']."	3	incubus motorcycle helmet

black motorcycle helmet is a grab object.
black motorcycle helmet is equipment.
It is not temporary.
Plural of black motorcycle helmet is false.
Taur-compatible of black motorcycle helmet is true.
Size of black motorcycle helmet is 3.
AC of black motorcycle helmet is 60.
Effectiveness of black motorcycle helmet is 80.
GA of black motorcycle helmet is 0.
Traits of black motorcycle helmet is {"cool"}.
Placement of black motorcycle helmet is "head".
Descmod of black motorcycle helmet is "Your head is encased in the thick shell of a black motorcycle helmet.".
Slot of black motorcycle helmet is "head".
Scent of black motorcycle helmet is "The helmet smells of plastic and fabric.".

flaming motorcycle helmet is a grab object.
flaming motorcycle helmet is equipment.
It is not temporary.
Plural of flaming motorcycle helmet is false.
Taur-compatible of flaming motorcycle helmet is true.
Size of flaming motorcycle helmet is 3.
AC of flaming motorcycle helmet is 60.
Effectiveness of flaming motorcycle helmet is 80.
GA of flaming motorcycle helmet is 0.
Traits of flaming motorcycle helmet is {"rebellious"}.
Placement of flaming motorcycle helmet is "head".
Descmod of flaming motorcycle helmet is "Your head is encased in the thick shell of a black motorcycle helmet covered in flames.".
Slot of flaming motorcycle helmet is "head".
Scent of flaming motorcycle helmet is "The helmet smells of plastic and fabric.".

succubus motorcycle helmet is a grab object.
succubus motorcycle helmet is equipment.
It is not temporary.
Plural of succubus motorcycle helmet is false.
Taur-compatible of succubus motorcycle helmet is true.
Size of succubus motorcycle helmet is 3.
AC of succubus motorcycle helmet is 60.
Effectiveness of succubus motorcycle helmet is 80.
GA of succubus motorcycle helmet is -1.
Traits of succubus motorcycle helmet is {"sexy"}.
Placement of succubus motorcycle helmet is "head".
Descmod of succubus motorcycle helmet is "Your head is encased in the thick shell of a black motorcycle helmet, complete with a sexy succubus riding your face.".
Slot of succubus motorcycle helmet is "head".
Scent of succubus motorcycle helmet is "The helmet smells of plastic and fabric.".

An everyturn rule:
	if succubus motorcycle helmet is equipped and a random chance of 1 in 2 succeeds:
		say "[bold type]Your scalp tingles a little where it touches the succubus motorcycle helmet.[roman type][line break]";
		infect "Succubus";

incubus motorcycle helmet is a grab object.
incubus motorcycle helmet is equipment.
It is not temporary.
Plural of incubus motorcycle helmet is false.
Taur-compatible of incubus motorcycle helmet is true.
Size of incubus motorcycle helmet is 3.
AC of incubus motorcycle helmet is 60.
Effectiveness of incubus motorcycle helmet is 80.
GA of incubus motorcycle helmet is 1.
Traits of incubus motorcycle helmet is {"sexy"}.
Placement of incubus motorcycle helmet is "head".
Descmod of incubus motorcycle helmet is "Your head is encased in the thick shell of a black motorcycle helmet, complete with a sexy incubus riding your face.".
Slot of incubus motorcycle helmet is "head".
Scent of incubus motorcycle helmet is "The helmet smells of plastic and fabric.".

An everyturn rule:
	if incubus motorcycle helmet is equipped and a random chance of 1 in 2 succeeds:
		say "[bold type]Your scalp tingles a little where it touches the incubus motorcycle helmet.[roman type][line break]";
		infect "Incubus";


Part 2 - Bike Helmets

Table of Game Objects (continued)
name	desc	weight	object
"simple bike helmet"	"A plastic foam bicycle helmet, complete with a white shell and reflective stripes, as well as a strap to fasten it to the wearer's head. Judging by the helmet's appearance, it's [']unisex['] and pretty [']basic[']."	1	bike helmet
"princess bike helmet"	"A plastic foam bicycle helmet, complete with a pink shell covered with rainbows and unicorns, as well as a strap to fasten it to the wearer's head. Judging by the helmet's appearance, it's [']feminine['] and pretty [']cute[']."	1	princess bike helmet
"dragon bike helmet"	"A plastic foam bicycle helmet, complete with a green shell covered with dragons spewing red flames, as well as a strap to fasten it to the wearer's head. Judging by the helmet's appearance, it's [']masculine['] and pretty [']cool[']."	1	dragon bike helmet

simple bike helmet is a grab object.
simple bike helmet is equipment.
It is not temporary.
Plural of simple bike helmet is false.
Taur-compatible of simple bike helmet is true.
Size of simple bike helmet is 3.
AC of simple bike helmet is 20.
Effectiveness of simple bike helmet is 40.
GA of simple bike helmet is 0.
Traits of simple bike helmet is {"basic"}.
Placement of simple bike helmet is "head".
Descmod of simple bike helmet is "A plastic simple bike helmet encases the upper half of your head.".
Slot of simple bike helmet is "head".
Scent of simple bike helmet is "The helmet smells like plastic.".

princess bike helmet is a grab object.
princess bike helmet is equipment.
It is not temporary.
Plural of princess bike helmet is false.
Taur-compatible of princess bike helmet is true.
Size of princess bike helmet is 3.
AC of princess bike helmet is 20.
Effectiveness of princess bike helmet is 40.
GA of princess bike helmet is -1.
Traits of princess bike helmet is {"cute"}.
Placement of princess bike helmet is "head".
Descmod of princess bike helmet is "A plastic princess bike helmet encases the upper half of your head, showcasing your love for everything cute.".
Slot of princess bike helmet is "head".
Scent of princess bike helmet is "The helmet smells like plastic.".

dragon bike helmet is a grab object.
dragon bike helmet is equipment.
It is not temporary.
Plural of dragon bike helmet is false.
Taur-compatible of dragon bike helmet is true.
Size of dragon bike helmet is 3.
AC of dragon bike helmet is 20.
Effectiveness of dragon bike helmet is 40.
GA of dragon bike helmet is 1.
Traits of dragon bike helmet is {"cool"}.
Placement of dragon bike helmet is "head".
Descmod of dragon bike helmet is "A plastic dragon bike helmet encases the upper half of your head, showcasing your love for fire-breathing dragons.".
Slot of dragon bike helmet is "head".
Scent of dragon bike helmet is "The helmet smells like plastic.".

Part 3 - Construction Helmets
[Intending for inclusion of protective helmet and the yellow helmet since both are described as pretty much the same object just different colors,]

Table of Game Objects (continued)
name	desc	weight	object
"white industrial helmet"	"A white protection helmet as might be worn by industrial workers. That should certainly ward off some bumps to the wearer's head. Judging by the appearance of the helmet, it's [']unisex['] and pretty [']basic['] looking."	1	white industrial helmet
"yellow construction helmet"	"A yellow helmet with the word 'Supervisor' printed on the front. It should provide some minor protection while worn. Judging by the appearance of the helmet, it's [']unisex['] and pretty [']authoritive['] looking."	1	yellow construction helmet

white industrial helmet is a grab object.
white industrial helmet is equipment.
It is not temporary.
Plural of white industrial helmet is false.
Taur-compatible of white industrial helmet is true.
Size of white industrial helmet is 3.
AC of white industrial helmet is 30.
Effectiveness of white industrial helmet is 60.
GA of white industrial helmet is 0.
Traits of white industrial helmet is {"basic"}.
Placement of white industrial helmet is "head".
Descmod of white industrial helmet is "A white industrial helmet sits on your head, providing some protection.".
Slot of white industrial helmet is "head".
Scent of white industrial helmet is "The helmet smells like plastic.".

yellow construction helmet is a grab object.
yellow construction helmet is equipment.
It is not temporary.
Plural of yellow construction helmet is false.
Taur-compatible of yellow construction helmet is true.
Size of yellow construction helmet is 3.
AC of yellow construction helmet is 30.
Effectiveness of yellow construction helmet is 60.
GA of yellow construction helmet is 0.
Traits of yellow construction helmet is {"authoritive"}.
Placement of yellow construction helmet is "head".
Descmod of yellow construction helmet is "A yellow construction helmet sits on your head, providing some protection.".
Slot of yellow construction helmet is "head".
Scent of yellow construction helmet is "The helmet smells like plastic.".

Part 4 - Football Helmets

Table of Game Objects (continued)
name	desc	weight	object
"tenvale silverbacks football helmet"	"A black football helmet with the logo of the Tenvale Silverbacks on both sides in silver. Heavy, but protective. Judging by the helmet's appearance, it's [']masculine['] and pretty [']sporty[']."	3	tenvale silverbacks football helmet
"Roman's gifted football helmet"	"Roman's black football helmet with the logo of the Tenvale Silverbacks on both sides in silver. Heavy, but protective. Judging by the helmet's appearance, it's [']masculine['] and pretty [']sporty[']. Holding this helmet brings back memories of helping Roman come to terms with his new gender and showing him that his team still supports him."	3	Roman's gifted football helmet
"Roman's stolen football helmet"	"Roman's black football helmet with the logo of the Tenvale Silverbacks on both sides in silver. Heavy, but protective. Judging by the helmet's appearance, it's [']masculine['] and pretty [']sporty[']. Holding this helmet brings back memories of betraying Roman's trust and then watching as he became a mindless cocksleeve for his former teammates."	3	Roman's stolen football helmet

tenvale silverbacks football helmet is a grab object.
tenvale silverbacks football helmet is equipment.
It is not temporary.
Plural of tenvale silverbacks football helmet is false.
Taur-compatible of tenvale silverbacks football helmet is true.
Size of tenvale silverbacks football helmet is 3.
AC of tenvale silverbacks football helmet is 40.
Effectiveness of tenvale silverbacks football helmet is 80.
GA of tenvale silverbacks football helmet is 1.
Traits of tenvale silverbacks football helmet is {"sporty"}.
Placement of tenvale silverbacks football helmet is "head".
Descmod of tenvale silverbacks football helmet is "Your head is encased in the thick shell of a black and silver Tenvale Silverbacks football helmet.".
Slot of tenvale silverbacks football helmet is "head".
Scent of tenvale silverbacks football helmet is "The helmet smells of plastic and fabric.".

Roman's gifted football helmet is a grab object.
Roman's gifted football helmet is equipment.
It is not temporary.
Plural of Roman's gifted football helmet is false.
Taur-compatible of Roman's gifted football helmet is true.
Size of Roman's gifted football helmet is 3.
AC of Roman's gifted football helmet is 40.
Effectiveness of Roman's gifted football helmet is 80.
GA of Roman's gifted football helmet is 1.
Traits of Roman's gifted football helmet is {"sporty"}.
Placement of Roman's gifted football helmet is "head".
Descmod of Roman's gifted football helmet is "Your head is encased in the thick shell of Roman's black and silver football helmet.".
Slot of Roman's gifted football helmet is "head".
Scent of Roman's gifted football helmet is "The helmet smells of plastic and fabric, however there is also a hint of something kinda feminine about its smell.".

An everyturn rule:
	if Roman's gifted football helmet is equipped and a random chance of 1 in 2 succeeds:
		say "[bold type]Your scalp tingles a little where it touches Roman's gifted football helmet.[roman type][line break]";
		infect "Football Gorilla Cuntboi";

Roman's stolen football helmet is a grab object.
Roman's stolen football helmet is equipment.
It is not temporary.
Plural of Roman's stolen football helmet is false.
Taur-compatible of Roman's stolen football helmet is true.
Size of Roman's stolen football helmet is 3.
AC of Roman's stolen football helmet is 40.
Effectiveness of Roman's stolen football helmet is 80.
GA of Roman's stolen football helmet is 1.
Traits of Roman's stolen football helmet is {"sporty"}.
Placement of Roman's stolen football helmet is "head".
Descmod of Roman's stolen football helmet is "Your head is encased in the thick shell of Roman's black and silver football helmet.".
Slot of Roman's stolen football helmet is "head".
Scent of Roman's stolen football helmet is "The helmet smells of plastic and fabric, however there is also a hint of something that kinda reminds you of a lockeroom and sex.".

An everyturn rule:
	if Roman's stolen football helmet is equipped and a random chance of 1 in 2 succeeds:
		say "[bold type]Your scalp tingles a little where it touches Roman's stolen football helmet.[roman type][line break]";
		infect "Football Gorilla Male";

Part 5 - Urban Explorer Helmets

Table of Game Objects (continued)
name	desc	weight	object
"crimson urban explorer helmet"	"A protective helmet with a flashy crimson-red finish. It should certainly ward off some bumps to someone's head. A compact camera is attached to the front, to capture everything the wearer sees, but sadly its batteries seem to be empty and it doesn't turn on. Judging by the helmet's appearance, it's [']unisex['] and pretty [']cool[']."	2	crimson urban explorer helmet
"cobalt urban explorer helmet"	"A protective helmet with subdued cobalt-blue finish. It should certainly ward off some bumps to someone's head. A compact camera is attached to the front, to capture everything the wearer sees, but sadly its batteries seem to be empty and it doesn't turn on. Judging by the helmet's appearance, it's [']unisex['] and pretty [']cool[']."	2	cobalt urban explorer helmet

crimson urban explorer helmet is a grab object.
crimson urban explorer helmet is equipment.
It is not temporary.
Plural of crimson urban explorer helmet is false.
Taur-compatible of crimson urban explorer helmet is true.
Size of crimson urban explorer helmet is 3.
AC of crimson urban explorer helmet is 30.
Effectiveness of crimson urban explorer helmet is 80.
GA of crimson urban explorer helmet is 0.
Traits of crimson urban explorer helmet is {"cool"}.
Placement of crimson urban explorer helmet is "head".
Descmod of crimson urban explorer helmet is "Your head is encased in a protective helmet with a crimson-red finish and camera attached to the front.".
Slot of crimson urban explorer helmet is "head".
Scent of crimson urban explorer helmet is "The helmet smells of plastic and fabric.".

cobalt urban explorer helmet is a grab object.
cobalt urban explorer helmet is equipment.
It is not temporary.
Plural of cobalt urban explorer helmet is false.
Taur-compatible of cobalt urban explorer helmet is true.
Size of cobalt urban explorer helmet is 3.
AC of cobalt urban explorer helmet is 30.
Effectiveness of cobalt urban explorer helmet is 80.
GA of cobalt urban explorer helmet is 0.
Traits of cobalt urban explorer helmet is {"cool"}.
Placement of cobalt urban explorer helmet is "head".
Descmod of cobalt urban explorer helmet is "Your head is encased in a protective helmet with a cobalt-blue finish and camera attached to the front.".
Slot of cobalt urban explorer helmet is "head".
Scent of cobalt urban explorer helmet is "The helmet smells of plastic and fabric.".

Part 6 - Riot Helmets

Table of Game Objects (continued)
name	desc	weight	object
"zephyr riot helmet"	"A helmet that Zephyr has its security team use when dealing with emergencies. Judging by the appearance of the helmet, it's [']unisex['] and pretty [']authoritive['] looking."	3	zephyr riot helmet

zephyr riot helmet is a grab object.
zephyr riot helmet is equipment.
It is not temporary.
Plural of zephyr riot helmet is false.
Taur-compatible of zephyr riot helmet is true.
Size of zephyr riot helmet is 3.
AC of zephyr riot helmet is 30.
Effectiveness of zephyr riot helmet is 60.
GA of zephyr riot helmet is 0.
Traits of zephyr riot helmet is {"authoritive"}.
Placement of zephyr riot helmet is "head".
Descmod of zephyr riot helmet is "A jet black helmet with the Zephyr logo on it rests atop your head.".
Slot of zephyr riot helmet is "head".
Scent of zephyr riot helmet is "The riot gear smells of metal and plastic.".

Part 7 - Cowboy Hats

Table of Game Objects (continued)
name	desc	weight	object
"cow-print cowboy hat"	"A cowboy hat that is covered in cow hide, the top has two small bull horns sticking out of the side. They are sure to make you look like a real fancy cowpoke. Judging by the appearance of the hat, it's [']masculine['] and pretty [']sporty['] yet [']cool['] looking."	1	cow-print cowboy hat

cow-print cowboy hat is a grab object.
cow-print cowboy hat is equipment.
It is not temporary.
Plural of cow-print cowboy hat is false.
Taur-compatible of cow-print cowboy hat is true.
Size of cow-print cowboy hat is 3.
AC of cow-print cowboy hat is 5.
Effectiveness of cow-print cowboy hat is 10.
GA of cow-print cowboy hat is 0.
Traits of cow-print cowboy hat is {"sporty", "cool"}.
Placement of cow-print cowboy hat is "head".
Descmod of cow-print cowboy hat is "You are wearing a cow-print cowboy hat. The two small protruding horns on the side making you feel like a true stud bull.".
Slot of cow-print cowboy hat is "head".
Scent of cow-print cowboy hat is "The cowboy hat smell like leather and felt.".

An everyturn rule:
	if cow-print cowboy hat is equipped and a random chance of 1 in 2 succeeds:
		say "[bold type]Your scalp tingles a little bit where it touches the cowboy hat.[roman type][line break]";
		infect "Cow-boi Male";

Section 2 - Hair Accessories

Section 3 - Glasses

Part 1 - Goggles

Table of Game Objects (continued)
name	desc	weight	object
"aviator goggles"	"A set of aviator goggles with a strap to keep them tightly pressed to someone's face. Perfect for situations like being in strong winds, or being in danger of getting cum-facials by lots of horny monsters. Judging by the goggles['] appearance, it's [']unisex['] and pretty [']cool['] looking."	0	aviator goggles
"lab goggles"	"A pair of clear plastic goggles that closely fit to someone's face. They're perfect to keep harmful chemicals (and spurting cum) out of your eyes. Judging by the goggles['] appearance, it's [']unisex['] and pretty [']smart['] looking."	0	lab goggles

aviator goggles is a grab object.
aviator goggles is equipment.
It is not temporary.
Plural of aviator goggles is true.
Taur-compatible of aviator goggles is true.
Size of aviator goggles is 0.
AC of aviator goggles is 3.
Effectiveness of aviator goggles is 5.
GA of aviator goggles is 0.
Traits of aviator goggles is {"cool"}.
Placement of aviator goggles is "head".
Descmod of aviator goggles is "A pair of aviator goggles cover your eyes, protecting them from danger - like spurts of cum, for example.".
Slot of aviator goggles is "eyes".
Scent of aviator goggles is "The goggles don't smell like anything really.".

lab goggles is a grab object.
lab goggles is equipment.
It is not temporary.
Plural of lab goggles is true.
Taur-compatible of lab goggles is true.
Size of lab goggles is 0.
AC of lab goggles is 3.
Effectiveness of lab goggles is 5.
GA of lab goggles is 0.
Traits of lab goggles is {"smart"}.
Placement of lab goggles is "head".
Descmod of lab goggles is "A pair of lab goggles cover your eyes, protecting them from danger - like spurts of cum, for example.".
Slot of lab goggles is "eyes".
Scent of lab goggles is "The goggles don't smell like anything really.".

Section 4 - Masks

Table of Game Objects (continued)
name	desc	weight	object
"face mask"	"A basic filtered face mask. Maybe it will help? Probably not[first time]. You doubt it was designed with this madness in mind[only]."	2	face mask

face mask is a grab object.
face mask is equipment.
It is not temporary.
Plural of face mask is false.
Taur-compatible of face mask is true.
Size of face mask is 0.
AC of face mask is 3.
Effectiveness of face mask is 5.
GA of face mask is 0.
Traits of face mask is {"smart"}.
Placement of face mask is "head".
Descmod of face mask is "A filtered mask covers nose and mouth in a vain attempt to help.".
Slot of face mask is "face".
Scent of face mask is "The face mask doesn't smell like anything really.".

Section 5 - Neckwear

Section 6 - Necklaces

Table of Game Objects (continued)
name	desc	weight	object
"police badge necklace"	"A police badge on a chain, perfect to be worn around the neck. Looks pretty neat, with its black leather ground and a golden shield."	0	police badge necklace

police badge necklace is a grab object.
police badge necklace is equipment.
It is not temporary.
Plural of police badge necklace is false.
Taur-compatible of police badge necklace is true.
Size of police badge necklace is 0.
AC of police badge necklace is 0.
Effectiveness of police badge necklace is 0.
GA of police badge necklace is 0.
Traits of police badge necklace is {"authorative"}.
Placement of police badge necklace is "neck".
Descmod of police badge necklace is "A shining police badge dangles from a chain laid around your neck.".
Slot of police badge necklace is "neck".
Scent of police badge necklace is "The police badge smells like metal, and cum - as some seems to have seeped into the leather forming the back of the badge. It reminds you where you got the badge, and what the most likely fate of the policeman was who originally owned it.".

Table of Game Objects (continued)
name	desc	weight	object
"tooth necklace"	"A leather band, with several large teeth and fangs from some kind of beast strung up on it. Looks pretty neat and is a nice trophy of martial prowess. You took it from an orc."	0	tooth necklace

tooth necklace is a grab object.
tooth necklace is equipment.
It is not temporary.
Plural of tooth necklace is false.
Taur-compatible of tooth necklace is true.
Size of tooth necklace is 0.
AC of tooth necklace is 0.
Effectiveness of tooth necklace is 0.
GA of tooth necklace is 0.
Traits of tooth necklace is {"rebellious"}.
Placement of tooth necklace is "neck".
Descmod of tooth necklace is "A necklace with a number of large teeth - or rather fangs - is laid around your neck.".
Slot of tooth necklace is "neck".
Scent of tooth necklace is "Smells like leather, and a hint of blood too.".

Table of Game Objects (continued)
name	desc	weight	object
"handcuff necklace"	"A single police handcuff on a chain, perfect to be worn around the neck. The metal ring that held the links to its counterpart once has been snapped, apparently by brute force instead of a tool or anything."	0	handcuff necklace

handcuff necklace is a grab object.
handcuff necklace is equipment.
It is not temporary.
Plural of handcuff necklace is false.
Taur-compatible of handcuff necklace is true.
Size of handcuff necklace is 0.
AC of handcuff necklace is 0.
Effectiveness of handcuff necklace is 0.
GA of handcuff necklace is 0.
Traits of handcuff necklace is {"rebellious"}.
Placement of handcuff necklace is "neck".
Descmod of handcuff necklace is "A single police handcuff dangles from a chain laid around your neck.".
Slot of handcuff necklace is "neck".
Scent of handcuff necklace is "Smells like metal.".

Table of Game Objects (continued)
name	desc	weight	object
"mithril necklace"	"A fairly delicate chain made out of silvery metal. Despite its thin appearance, it seems very strong."	0	mithril necklace

mithril necklace is a grab object.
mithril necklace is equipment.
It is not temporary.
Plural of mithril necklace is false.
Taur-compatible of mithril necklace is true.
Size of mithril necklace is 0.
AC of mithril necklace is 0.
Effectiveness of mithril necklace is 0.
GA of mithril necklace is 0.
Traits of mithril necklace is {"rebellious"}.
Placement of mithril necklace is "neck".
Descmod of mithril necklace is "A delicate silver chain is laid around your neck.".
Slot of mithril necklace is "neck".
Scent of mithril necklace is "Smells like metal.".

Table of Game Objects (continued)
name	desc	weight	object
"arrowhead pendant"	"An obsidian arrowhead attached to a fairly delicate but nevertheless strong chain of silvery metal. The outside edges have been covered in golden paint, which creates a quite striking 'V' shape of black glass and gold, as well as blunting it just enough so that the wearer won't cut themselves on it."	0	arrowhead pendant

arrowhead pendant is a grab object.
arrowhead pendant is equipment.
It is not temporary.
Plural of arrowhead pendant is false.
Taur-compatible of arrowhead pendant is true.
Size of arrowhead pendant is 0.
AC of arrowhead pendant is 0.
Effectiveness of arrowhead pendant is 0.
GA of arrowhead pendant is 0.
Traits of arrowhead pendant is {"adventurous"}.
Placement of arrowhead pendant is "neck".
Descmod of arrowhead pendant is "An obsidian arrowhead with golden edges dangles from a chain laid around your neck.".
Slot of arrowhead pendant is "neck".
Scent of arrowhead pendant is "Smells like metal.".

Section 7 - Jackets

Part 1 - Leather Jackets

Table of Game Objects (continued)
name	desc	weight	object
"black leather jacket"	"A black leather jacket with some shiny silver buttons and zippers. It offers both looks and protection. Judging by the jacket's appearance, it's [']unisex['] and pretty [']stylish[']."	4	black leather jacket
"brown leather jacket"	"A brown leather jacket with some shiny silver buttons and zippers. It offers both looks and protection. Judging by the jacket's appearance, it's [']unisex['] and pretty [']stylish[']."	4	brown leather jacket
"leather biker jacket"	"A beat-up black leather jacket with a large pissed off wolf on the back, the words above the canine simply say [']The Wolf Pack[']. It brings with it both protection and an almost instinctive need to tell the world to kiss your ass. Judging by the jacket's appearance, it's [']masculine['] and pretty [']rebellious[']."	4	leather biker jacket

black leather jacket is a grab object.
black leather jacket is equipment.
It is not temporary.
Plural of black leather jacket is false.
Taur-compatible of black leather jacket is true.
Size of black leather jacket is 3.
AC of black leather jacket is 30.
Effectiveness of black leather jacket is 70.
GA of black leather jacket is 0.
Traits of black leather jacket is {"stylish"}.
Placement of black leather jacket is "body".
Descmod of black leather jacket is "A stylish black leather jacket covers your upper body.".
Slot of black leather jacket is "back".
Scent of black leather jacket is "The jacket smells like leather.".

brown leather jacket is a grab object.
brown leather jacket is equipment.
It is not temporary.
Plural of brown leather jacket is false.
Taur-compatible of brown leather jacket is true.
Size of brown leather jacket is 3.
AC of brown leather jacket is 30.
Effectiveness of brown leather jacket is 70.
GA of brown leather jacket is 0.
Traits of brown leather jacket is {"stylish"}.
Placement of brown leather jacket is "body".
Descmod of brown leather jacket is "A stylish brown leather jacket covers your upper body.".
Slot of brown leather jacket is "back".
Scent of brown leather jacket is "The jacket smells like leather.".

leather biker jacket is a grab object.
leather biker jacket is equipment.
It is not temporary.
Plural of leather biker jacket is false.
Taur-compatible of leather biker jacket is true.
Size of leather biker jacket is 3.
AC of leather biker jacket is 30.
Effectiveness of leather biker jacket is 80.
GA of leather biker jacket is 1.
Traits of leather biker jacket is {"rebellious"}.
Placement of leather biker jacket is "body".
Descmod of leather biker jacket is "A beat-up black leather jacket with a large pissed off wolf on the back, with the words [']The Wolf Pack['], covers your upper body.".
Slot of leather biker jacket is "back".
Scent of leather biker jacket is "The jacket smells like smoke and leather.".

Part 2 - Greatcoat

Table of Game Objects (continued)
name	desc	weight	object
"black greatcoat"	"A full-body black coat made from thick wool. It will certainly protect you from bad weather, but the sturdy material should also be some help in a close-combat fight. Judging by the coat's appearance, it's [']masculine['] and pretty [']smart['] looking."	4	black greatcoat
"gray greatcoat"	"A full-body gray coat made from thick wool. It will certainly protect you from bad weather, but the sturdy material should also be some help in a close-combat fight. Judging by the coat's appearance, it's [']masculine['] and pretty [']smart['] looking."	4	gray greatcoat

black greatcoat is a grab object.
black greatcoat is equipment.
It is not temporary.
Plural of black greatcoat is false.
Taur-compatible of black greatcoat is true.
Size of black greatcoat is 3.
AC of black greatcoat is 15.
Effectiveness of black greatcoat is 80.
GA of black greatcoat is 1.
Traits of black greatcoat is {"smart"}.
Placement of black greatcoat is "body".
Descmod of black greatcoat is "A full length black woolen greatcoat covers your body.".
Slot of black greatcoat is "back".
Scent of black greatcoat is "The coat smells like wool.".

gray greatcoat is a grab object.
gray greatcoat is equipment.
It is not temporary.
Plural of gray greatcoat is false.
Taur-compatible of gray greatcoat is true.
Size of gray greatcoat is 3.
AC of gray greatcoat is 15.
Effectiveness of gray greatcoat is 80.
GA of gray greatcoat is 1.
Traits of gray greatcoat is {"smart"}.
Placement of gray greatcoat is "body".
Descmod of gray greatcoat is "A full length gray woolen greatcoat covers your body.".
Slot of gray greatcoat is "back".
Scent of gray greatcoat is "The coat smells like wool.".

Part 3 - Breastplates

Table of Game Objects (continued)
name	desc	weight	object
"medieval breastplate"	"A shiny medieval breastplate. It is either a historical artifact or a quite good reproduction - either way, this should allow for some serious protection for someone who wants to survive the nanite apocalypse. Judging by the breastplate's appearance, it's [']masculine['] and pretty [']authorative['] looking."	20	medieval breastplate
"roadsign breastplate"	"A breastplate that someone fairly large seems to have crafted from things that were available - namely road signs. The front is formed by a STOP sign that has been hammered into a slight curve, with further signs bolted to its edges to curve around the sides of the body. Heavy leather straps for over the shoulders hold another stop sign forming the back plate. Judging by the breastplate's appearance, it's [']masculine['] and pretty [']violent['] looking."	30	roadsign breastplate

medieval breastplate is a grab object.
medieval breastplate is equipment.
It is not temporary.
Plural of medieval breastplate is false.
Taur-compatible of medieval breastplate is true.
Size of medieval breastplate is 3.
AC of medieval breastplate is 65.
Effectiveness of medieval breastplate is 60.
GA of medieval breastplate is 1.
Traits of medieval breastplate is {"authorative"}.
Placement of medieval breastplate is "body".
Descmod of medieval breastplate is "A medieval breastplate covers your chest and back with shiny metal.".
Slot of medieval breastplate is "back".
Scent of medieval breastplate is "The breastplate smells like metal".

roadsign breastplate is a grab object.
roadsign breastplate is equipment.
It is not temporary.
Plural of roadsign breastplate is false.
Taur-compatible of roadsign breastplate is true.
Size of roadsign breastplate is 4.
AC of roadsign breastplate is 60.
Effectiveness of roadsign breastplate is 50.
GA of roadsign breastplate is 1.
Traits of roadsign breastplate is {"violent"}.
Placement of roadsign breastplate is "body".
Descmod of roadsign breastplate is "A road sign breastplate covers your chest and back in an improvised patchwork of metal.".
Slot of roadsign breastplate is "back".
Scent of roadsign breastplate is "The breastplate smells like metal".

Part 4 - Pads

Table of Game Objects (continued)
name	desc	weight	object
"tenvale football pads"	"Tough polymer football pads, sized to cover the shoulders and upper chest of a human player. There even is an extra plate attached to the front in order to cover the abdominal area of the wearer. You can see the logo of the Tenvale Silverbacks emblazoned on the left pec. Judging by the pads['] appearance, it's [']masculine['] and pretty [']sporty['] looking."	9	tenvale football pads
"shoulder pad"	"An oversized, padded shoulder pad that juts out to the side too much. It won't cover much, but it might help. Judging by the pad's appearance, it's [']unisex['] and pretty [']basic['] looking."	1	shoulder pad

tenvale football pads is a grab object.
tenvale football pads is equipment.
It is not temporary.
Plural of tenvale football pads is true.
Taur-compatible of tenvale football pads is true.
Size of tenvale football pads is 3.
AC of tenvale football pads is 30.
Effectiveness of tenvale football pads is 50.
GA of tenvale football pads is 1.
Traits of tenvale football pads is {"sporty"}.
Placement of tenvale football pads is "body".
Descmod of tenvale football pads is "Black and silver football pads cover chest, abs and shoulders providing protective padding.".
Slot of tenvale football pads is "back".
Scent of tenvale football pads is "The pads smell of plastic, fabric and sweat.".

shoulder pad is a grab object.
shoulder pad is equipment.
It is not temporary.
Plural of shoulder pad is false.
Taur-compatible of shoulder pad is true.
Size of shoulder pad is 3.
AC of shoulder pad is 13.
Effectiveness of shoulder pad is 13.
GA of shoulder pad is 0.
Traits of shoulder pad is {"basic"}.
Placement of shoulder pad is "body".
Descmod of shoulder pad is "A single, armored pad is strapped to your shoulder.".
Slot of shoulder pad is "back".
Scent of shoulder pad is "The shoulder pad stinks of the [']90s.".

Part 5 - Special Jackets

Table of Game Objects (continued)
name	desc	weight	object
"life jacket"	"A bright orange life jacket. It'll help normal humans stay afloat and comes with an attached whistle and light. Judging by the jacket's appearance, it's [']unisex['] and pretty [']sporty[']."	2	life jacket
"zephyr riot chest piece"	"A chest piece that Zephyr has its security team use when dealing with emergencies. Judging by the chest piece's appearance, it's [']unisex['] and pretty [']authoritive[']."	6	zephyr riot chest piece
"zephyr armored lab coat"	"A lab coat specifically modified by Zephyr for their researchers out in the field. It has underpadding and a sheet of bendable plastic woven inside the fabric. Judging by the coat's appearance, it's [']unisex['] and looks pretty [']smart[']."	4	zephyr armored lab coat

life jacket is a grab object.
life jacket is equipment.
It is not temporary.
Plural of life jacket is false.
Taur-compatible of life jacket is true.
Size of life jacket is 3.
AC of life jacket is 20.
Effectiveness of life jacket is 40.
GA of life jacket is 0.
Traits of life jacket is {"sporty"}.
Placement of life jacket is "body".
Descmod of life jacket is "A bright orange life jacket covers your upper body.".
Slot of life jacket is "back".
Scent of life jacket is "The life jacket smells of synthetic fabrics.".

zephyr riot chest piece is a grab object.
zephyr riot chest piece is equipment.
It is not temporary.
Plural of zephyr riot chest piece is false.
Taur-compatible of zephyr riot chest piece is true.
Size of zephyr riot chest piece is 3.
AC of zephyr riot chest piece is 40.
Effectiveness of zephyr riot chest piece is 70.
GA of zephyr riot chest piece is 0.
Traits of zephyr riot chest piece is {"authoritive"}.
Placement of zephyr riot chest piece is "body".
Descmod of zephyr riot chest piece is "A jet black chest piece encases your torso with the Zephyr logo on it.".
Slot of zephyr riot chest piece is "back".
Scent of zephyr riot chest piece is "The riot gear smells of metal and plastic.".

zephyr armored lab coat is a grab object.
zephyr armored lab coat is equipment.
It is not temporary.
Plural of zephyr armored lab coat is false.
Taur-compatible of zephyr armored lab coat is true.
Size of zephyr armored lab coat is 3.
AC of zephyr armored lab coat is 50.
Effectiveness of zephyr armored lab coat is 35.
GA of zephyr armored lab coat is 0.
Traits of zephyr armored lab coat is {"smart"}.
Placement of zephyr armored lab coat is "body".
Descmod of zephyr armored lab coat is "A white and black lab coat rests upon your shoulders with the Zephyr logo embroidered over your shoulder blades.".
Slot of zephyr armored lab coat is "back".
Scent of zephyr armored lab coat is "The lab coat smells of chemicals and synthetic fibers.".

Section 8 - Shirts

Part 1 - Vests

Table of Game Objects (continued)
name	desc	weight	object
"bulletproof vest"	"A heavy-duty bulletproof vest, complete with metal plates for extra protection. Judging by the vest's appearance, it's [']unisex['] and pretty [']authorative[']."	10	bulletproof vest

bulletproof vest is a grab object.
bulletproof vest is equipment.
It is not temporary.
Plural of bulletproof vest is false.
Taur-compatible of bulletproof vest is true.
Size of bulletproof vest is 3.
AC of bulletproof vest is 70.
Effectiveness of bulletproof vest is 60.
GA of bulletproof vest is 0.
Traits of bulletproof vest is {"authorative"}.
Placement of bulletproof vest is "body".
Descmod of bulletproof vest is "A reinforced bulletproof vest covers your upper body.".
Slot of bulletproof vest is "back".
Scent of bulletproof vest is "The vest smells slightly of sweat, which isn't too wondrous as these things usually are put on in times of great stress.".

Section 9 - Bras

Section 10 - Stomach Trainers

Section 11 - Gloves

Part 1 - Arm Guards

Table of Game Objects (continued)
name	desc	weight	object
"zephyr riot arm guards"	"A set of arm guards that cover the back of your hands all the way up to your shoulders. Zephyr has its security team use these when dealing with emergencies. Judging by the arm guards['] appearance, it's [']unisex['] and pretty [']authorative[']."	3	zephyr riot arm guards

zephyr riot arm guards is a grab object.
zephyr riot arm guards is equipment.
It is not temporary.
Plural of zephyr riot arm guards is true.
Taur-compatible of zephyr riot arm guards is true.
Size of zephyr riot arm guards is 3.
AC of zephyr riot arm guards is 30.
Effectiveness of zephyr riot arm guards is 60.
GA of zephyr riot arm guards is 0.
Traits of zephyr riot arm guards is {"authorative"}.
Placement of zephyr riot arm guards is "body".
Descmod of zephyr riot arm guards is "A set of jet black arm guards that encase your arms with the Zephyr logo on it.".
Slot of zephyr riot arm guards is "arms".
Scent of zephyr riot arm guards is "The riot gear smell of metal and plastic.".

Table of Game Objects (continued)
name	desc	weight	object
"fur-lined armguards"	"A set of black leather arm guards that cover the forearms of the wearer. They're lined with white fur on the inside and around the ends, giving a soft, warm and protected feeling."	1	fur-lined armguards

fur-lined armguards is a grab object.
fur-lined armguards is equipment.
It is not temporary.
Plural of fur-lined armguards is true.
Taur-compatible of fur-lined armguards is true.
Size of fur-lined armguards is 3.
AC of fur-lined armguards is 20.
Effectiveness of fur-lined armguards is 60.
GA of fur-lined armguards is 0.
Traits of fur-lined armguards is {"adventurous"}.
Placement of fur-lined armguards is "body".
Descmod of fur-lined armguards is "A set of black leather arm guards protect your forearms.".
Slot of fur-lined armguards is "arms".
Scent of fur-lined armguards is "Smells like leather and fur.".


Part 2 - Lab Gloves

Table of Game Objects (continued)
name	desc	weight	object
"zephyr armored lab gloves"	"A set of lab gloves specifically modified by Zephyr for their researchers out in the field. It has a sheet of bendable plastic woven inside the rubber. Judging by the gloves['] appearance, it's [']unisex['] and looks pretty [']smart[']."	1	zephyr armored lab gloves

zephyr armored lab gloves is a grab object.
zephyr armored lab gloves is equipment.
It is not temporary.
Plural of zephyr armored lab gloves is true.
Taur-compatible of zephyr armored lab gloves is true.
Size of zephyr armored lab gloves is 3.
AC of zephyr armored lab gloves is 20.
Effectiveness of zephyr armored lab gloves is 15.
GA of zephyr armored lab gloves is 0.
Traits of zephyr armored lab gloves is {"smart"}.
Placement of zephyr armored lab gloves is "body".
Descmod of zephyr armored lab gloves is "A pair of white rubber lab gloves are fitted over your hands with the Zephyr logo patched over the back of your hand.".
Slot of zephyr armored lab gloves is "hands".
Scent of zephyr armored lab gloves is "The lab gloves smell of chemicals and rubber.".

Part 3 - Tactical Gloves

Table of Game Objects (continued)
name	desc	weight	object
"tactical gloves"	"A set of black fingerless gloves, with built-in knuckle guards. Looks to be police issue gear. Judging by the gloves['] appearance, it's [']unisex['] and looks pretty [']authoritative[']."	1	tactical gloves

tactical gloves is a grab object.
tactical gloves is equipment.
It is not temporary.
Plural of tactical gloves is true.
Taur-compatible of tactical gloves is true.
Size of tactical gloves is 3.
AC of tactical gloves is 20.
Effectiveness of tactical gloves is 15.
GA of tactical gloves is 0.
Traits of tactical gloves is {"authoritative "}.
Placement of tactical gloves is "body".
Descmod of tactical gloves is "A pair of fingerless black gloves are fitted over your hands.".
Slot of tactical gloves is "hands".
Scent of tactical gloves is "The tactical gloves smell of synthetic fabric and rubber.".

Section 12 - Rings

Section 13 - Belts

Section 14 - Pants

Section 15 - Skirts

Section 16 - Underwear

Section 17 - Cock Accessories

Section 18 - Cunt Accessories

Section 19 - Socks

Section 20 - Shoes

Part 1 - Cowboy Boots

Table of Game Objects (continued)
name	desc	weight	object
"dark-brown cowboy boots"	"A pair of cowboy boots made from dark-brown leather, complete with high heels and a relatively narrow toe. They are sure to make using stirrups easier, and can protect against rattlesnake bites. Judging by the appearance of the boots, it's [']unisex['] and pretty [']sporty['] looking."	1	dark-brown cowboy boots
"cow-print cowgirl boots"	"A pair of cowgirl boots that are covered in cow hide, the tops of each boot are covered in fringe and bedazzled in rhinestones. They are sure to make using stirrups easier, and can protect against rattlesnake bites. Judging by the appearance of the boots, it's [']feminine['] and pretty [']sporty['] yet [']sexy['] looking."	1	cow-print cowgirl boots

dark-brown cowboy boots is a grab object.
dark-brown cowboy boots is equipment.
It is not temporary.
Plural of dark-brown cowboy boots is true.
Taur-compatible of dark-brown cowboy boots is false.
Size of dark-brown cowboy boots is 3.
AC of dark-brown cowboy boots is 5.
Effectiveness of dark-brown cowboy boots is 10.
GA of dark-brown cowboy boots is 0.
Traits of dark-brown cowboy boots is {"sporty"}.
Placement of dark-brown cowboy boots is "body".
Descmod of dark-brown cowboy boots is "You are wearing a pair of dark-brown cowboy boots. You won't have to fear brambles and rattlesnakes with these on, that's for sure.".
Slot of dark-brown cowboy boots is "feet".
Scent of dark-brown cowboy boots is "The boots smell like leather.".

cow-print cowgirl boots is a grab object.
cow-print cowgirl boots is equipment.
It is not temporary.
Plural of cow-print cowgirl boots is true.
Taur-compatible of cow-print cowgirl boots is false.
Size of cow-print cowgirl boots is 3.
AC of cow-print cowgirl boots is 5.
Effectiveness of cow-print cowgirl boots is 10.
GA of cow-print cowgirl boots is 0.
Traits of cow-print cowgirl boots is {"sporty", "sexy"}.
Placement of cow-print cowgirl boots is "body".
Descmod of cow-print cowgirl boots is "You are wearing a pair of cow-print cowgirl boots. You won't have to fear brambles and rattlesnakes with these on, that's for sure.".
Slot of cow-print cowgirl boots is "feet".
Scent of cow-print cowgirl boots is "The boots smell like leather.".

An everyturn rule:
	if cow-print cowgirl boots is equipped and a random chance of 1 in 2 succeeds:
		say "     [bold type]Your skin tingles a little bit where it touches the cowgirl boots.[roman type][line break]";
		infect "Cow-babe Female";

Part 2 - Combat Boots

Table of Game Objects (continued)
name	desc	weight	object
"black combat boots"	"A pair of black combat boots. They are quite sturdy and fairly heavy because of the steel caps in them. Judging by the appearance of the boots, it's [']masculine['] and pretty [']rebellious['] looking."	2	black combat boots

black combat boots is a grab object.
black combat boots is equipment.
It is not temporary.
Plural of black combat boots is true.
Taur-compatible of black combat boots is false.
Size of black combat boots is 3.
AC of black combat boots is 5.
Effectiveness of black combat boots is 10.
GA of black combat boots is 1.
Traits of black combat boots is {"rebellious"}.
Placement of black combat boots is "body".
Descmod of black combat boots is "You are wearing sturdy black combat boots. They even have steel caps that protect your toes.".
Slot of black combat boots is "feet".
Scent of black combat boots is "The boots smell like leather and rubber.".

Part 3 - Shin Guards

Table of Game Objects (continued)
name	desc	weight	object
"zephyr riot shin guards"	"A set of shin guards that cover your legs from your feet up to your thighs. Zephyr has its security team use these when dealing with emergencies. Judging by the shin guards['] appearance, it's [']unisex['] and pretty [']authorative[']."	4	zephyr riot shin guards

zephyr riot shin guards is a grab object.
zephyr riot shin guards is equipment.
It is not temporary.
Plural of zephyr riot shin guards is true.
Taur-compatible of zephyr riot shin guards is false.
Size of zephyr riot shin guards is 3.
AC of zephyr riot shin guards is 30.
Effectiveness of zephyr riot shin guards is 60.
GA of zephyr riot shin guards is 0.
Traits of zephyr riot shin guards is {"authorative"}.
Placement of zephyr riot shin guards is "body".
Descmod of zephyr riot shin guards is "A set of jet black shin guards that encase your legs with the Zephyr logo on it.".
Slot of zephyr riot shin guards is "feet".
Scent of zephyr riot shin guards is "The riot gear smells of metal and plastic.".

Part 4 - Lab Boots

Table of Game Objects (continued)
name	desc	weight	object
"zephyr armored lab boots"	"A pair of lab boots specifically modified by Zephyr for their researchers out in the field. It has a sheet of bendable plastic woven inside the rubber. Judging by the boots['] appearance, it's [']unisex['] and looks pretty [']smart[']."	1	zephyr armored lab boots

zephyr armored lab boots is a grab object.
zephyr armored lab boots is equipment.
It is not temporary.
Plural of zephyr armored lab boots is true.
Taur-compatible of zephyr armored lab boots is false.
Size of zephyr armored lab boots is 3.
AC of zephyr armored lab boots is 20.
Effectiveness of zephyr armored lab boots is 15.
GA of zephyr armored lab boots is 0.
Traits of zephyr armored lab boots is {"smart"}.
Placement of zephyr armored lab boots is "body".
Descmod of zephyr armored lab boots is "A pair of black rubber lab boots are fitted over your feet with the Zephyr logo patched over the toes.".
Slot of zephyr armored lab boots is "feet".
Scent of zephyr armored lab boots is "The lab boots smells of chemicals and rubber.".

Book 2 - Clothing

Section 1 - Hats

Part 1 - Fedoras

Table of Game Objects (continued)
name	desc	weight	object
"white cashmere fedora"	"A white fedora hat with a soft brim and indented crown. Wearing it might make you look like a private detective, a hipster, or just someone with a fondness for the classy yesteryear. Judging by the hat's appearance, it's [']unisex['] and pretty [']stylish[']."	0	white cashmere fedora
"black wool fedora"	"A black fedora hat with soft brim and indented crown. Wearing it might make you look like a private detective, a hipster, or just someone with a fondness for the classy yesteryear. Judging by the hat's appearance, it's [']unisex['] and pretty [']stylish[']."	0	black wool fedora
"gray wool fedora"	"A gray fedora hat with soft brim and indented crown. Wearing it might make you look like a private detective, a hipster, or just someone with a fondness for the classy yesteryear. Judging by the hat's appearance, it's [']unisex['] and pretty [']stylish[']."	0	gray wool fedora

white cashmere fedora is a grab object.
white cashmere fedora is equipment.
It is not temporary.
Plural of white cashmere fedora is false.
Taur-compatible of white cashmere fedora is true.
Size of white cashmere fedora is 3.
AC of white cashmere fedora is 0.
Effectiveness of white cashmere fedora is 0.
GA of white cashmere fedora is 0.
Traits of white cashmere fedora is {"stylish"}.
Placement of white cashmere fedora is "head".
Descmod of white cashmere fedora is "A white cashmere fedora covers your head, making you look like a private detective from the prohibition days.".
Slot of white cashmere fedora is "head".
Scent of white cashmere fedora is "The hat smells like cashmere.".

black wool fedora is a grab object.
black wool fedora is equipment.
It is not temporary.
Plural of black wool fedora is false.
Taur-compatible of black wool fedora is true.
Size of black wool fedora is 3.
AC of black wool fedora is 0.
Effectiveness of black wool fedora is 0.
GA of black wool fedora is 0.
Traits of black wool fedora is {"stylish"}.
Placement of black wool fedora is "head".
Descmod of black wool fedora is "A black wool fedora covers your head, making you look like a private detective from the prohibition days.".
Slot of black wool fedora is "head".
Scent of black wool fedora is "The hat smells like wool.".

gray wool fedora is a grab object.
gray wool fedora is equipment.
It is not temporary.
Plural of gray wool fedora is false.
Taur-compatible of gray wool fedora is true.
Size of gray wool fedora is 3.
AC of gray wool fedora is 0.
Effectiveness of gray wool fedora is 0.
GA of gray wool fedora is 0.
Traits of gray wool fedora is {"stylish"}.
Placement of gray wool fedora is "head".
Descmod of gray wool fedora is "A gray wool fedora covers your head, making you look like a private detective from the prohibition days.".
Slot of gray wool fedora is "head".
Scent of gray wool fedora is "The hat smells like wool.".

Part 2 - Knitted Skullcaps

Table of Game Objects (continued)
name	desc	weight	object
"white knitted skullcap"	"A woolen cap, made to rightly stretch over someone's skull. Judging by the hat's appearance, it's [']unisex['] and pretty [']basic[']."	0	white knitted skullcap
"black knitted skullcap"	"A woolen cap, made to rightly stretch over someone's skull. Judging by the hat's appearance, it's [']unisex['] and pretty [']basic[']."	0	black knitted skullcap
"pink knitted skullcap"	"A woolen cap, made to rightly stretch over someone's skull. Judging by the hat's appearance, it's [']unisex['] and pretty [']basic[']."	0	pink knitted skullcap
"blue knitted skullcap"	"A woolen cap, made to rightly stretch over someone's skull. Judging by the hat's appearance, it's [']unisex['] and pretty [']basic[']."	0	blue knitted skullcap
"green knitted skullcap"	"A woolen cap, made to rightly stretch over someone's skull. Judging by the hat's appearance, it's [']unisex['] and pretty [']basic[']."	0	green knitted skullcap
"red knitted skullcap"	"A woolen cap, made to rightly stretch over someone's skull. Judging by the hat's appearance, it's [']unisex['] and pretty [']basic[']."	0	red knitted skullcap
"purple knitted skullcap"	"A woolen cap, made to rightly stretch over someone's skull. Judging by the hat's appearance, it's [']unisex['] and pretty [']basic[']."	0	purple knitted skullcap
"yellow knitted skullcap"	"A woolen cap, made to rightly stretch over someone's skull. Judging by the hat's appearance, it's [']unisex['] and pretty [']basic[']."	0	yellow knitted skullcap
"orange knitted skullcap"	"A woolen cap, made to rightly stretch over someone's skull. Judging by the hat's appearance, it's [']unisex['] and pretty [']basic[']."	0	orange knitted skullcap
"skull knitted skullcap"	"A woolen cap, made to rightly stretch over someone's skull. Judging by the hat's appearance, it's [']unisex['] and pretty [']rebellious[']."	0	skull knitted skullcap

white knitted skullcap is a grab object.
white knitted skullcap is equipment.
It is not temporary.
Plural of white knitted skullcap is false.
Taur-compatible of white knitted skullcap is true.
Size of white knitted skullcap is 3.
AC of white knitted skullcap is 0.
Effectiveness of white knitted skullcap is 0.
GA of white knitted skullcap is 0.
Traits of white knitted skullcap is {"basic"}.
Placement of white knitted skullcap is "head".
Descmod of white knitted skullcap is "A white knitted skullcap covers the top of your head.".
Slot of white knitted skullcap is "head".
Scent of white knitted skullcap is "The cap smells like wool.".

black knitted skullcap is a grab object.
black knitted skullcap is equipment.
It is not temporary.
Plural of black knitted skullcap is false.
Taur-compatible of black knitted skullcap is true.
Size of black knitted skullcap is 3.
AC of black knitted skullcap is 0.
Effectiveness of black knitted skullcap is 0.
GA of black knitted skullcap is 0.
Traits of black knitted skullcap is {"basic"}.
Placement of black knitted skullcap is "head".
Descmod of black knitted skullcap is "A black knitted skullcap covers the top of your head.".
Slot of black knitted skullcap is "head".
Scent of black knitted skullcap is "The cap smells like wool.".

pink knitted skullcap is a grab object.
pink knitted skullcap is equipment.
It is not temporary.
Plural of pink knitted skullcap is false.
Taur-compatible of pink knitted skullcap is true.
Size of pink knitted skullcap is 3.
AC of pink knitted skullcap is 0.
Effectiveness of pink knitted skullcap is 0.
GA of pink knitted skullcap is 0.
Traits of pink knitted skullcap is {"basic"}.
Placement of pink knitted skullcap is "head".
Descmod of pink knitted skullcap is "A pink knitted skullcap covers the top of your head.".
Slot of pink knitted skullcap is "head".
Scent of pink knitted skullcap is "The cap smells like wool.".

blue knitted skullcap is a grab object.
blue knitted skullcap is equipment.
It is not temporary.
Plural of blue knitted skullcap is false.
Taur-compatible of blue knitted skullcap is true.
Size of blue knitted skullcap is 3.
AC of blue knitted skullcap is 0.
Effectiveness of blue knitted skullcap is 0.
GA of blue knitted skullcap is 0.
Traits of blue knitted skullcap is {"basic"}.
Placement of blue knitted skullcap is "head".
Descmod of blue knitted skullcap is "A blue knitted skullcap covers the top of your head.".
Slot of blue knitted skullcap is "head".
Scent of blue knitted skullcap is "The cap smells like wool.".

green knitted skullcap is a grab object.
green knitted skullcap is equipment.
It is not temporary.
Plural of green knitted skullcap is false.
Taur-compatible of green knitted skullcap is true.
Size of green knitted skullcap is 3.
AC of green knitted skullcap is 0.
Effectiveness of green knitted skullcap is 0.
GA of green knitted skullcap is 0.
Traits of green knitted skullcap is {"basic"}.
Placement of green knitted skullcap is "head".
Descmod of green knitted skullcap is "A green knitted skullcap covers the top of your head.".
Slot of green knitted skullcap is "head".
Scent of green knitted skullcap is "The cap smells like wool.".

red knitted skullcap is a grab object.
red knitted skullcap is equipment.
It is not temporary.
Plural of red knitted skullcap is false.
Taur-compatible of red knitted skullcap is true.
Size of red knitted skullcap is 3.
AC of red knitted skullcap is 0.
Effectiveness of red knitted skullcap is 0.
GA of red knitted skullcap is 0.
Traits of red knitted skullcap is {"basic"}.
Placement of red knitted skullcap is "head".
Descmod of red knitted skullcap is "A red knitted skullcap covers the top of your head.".
Slot of red knitted skullcap is "head".
Scent of red knitted skullcap is "The cap smells like wool.".

purple knitted skullcap is a grab object.
purple knitted skullcap is equipment.
It is not temporary.
Plural of purple knitted skullcap is false.
Taur-compatible of purple knitted skullcap is true.
Size of purple knitted skullcap is 3.
AC of purple knitted skullcap is 0.
Effectiveness of purple knitted skullcap is 0.
GA of purple knitted skullcap is 0.
Traits of purple knitted skullcap is {"basic"}.
Placement of purple knitted skullcap is "head".
Descmod of purple knitted skullcap is "A purple knitted skullcap covers the top of your head.".
Slot of purple knitted skullcap is "head".
Scent of purple knitted skullcap is "The cap smells like wool.".

yellow knitted skullcap is a grab object.
yellow knitted skullcap is equipment.
It is not temporary.
Plural of yellow knitted skullcap is false.
Taur-compatible of yellow knitted skullcap is true.
Size of yellow knitted skullcap is 3.
AC of yellow knitted skullcap is 0.
Effectiveness of yellow knitted skullcap is 0.
GA of yellow knitted skullcap is 0.
Traits of yellow knitted skullcap is {"basic"}.
Placement of yellow knitted skullcap is "head".
Descmod of yellow knitted skullcap is "A yellow knitted skullcap covers the top of your head.".
Slot of yellow knitted skullcap is "head".
Scent of yellow knitted skullcap is "The cap smells like wool.".

orange knitted skullcap is a grab object.
orange knitted skullcap is equipment.
It is not temporary.
Plural of orange knitted skullcap is false.
Taur-compatible of orange knitted skullcap is true.
Size of orange knitted skullcap is 3.
AC of orange knitted skullcap is 0.
Effectiveness of orange knitted skullcap is 0.
GA of orange knitted skullcap is 0.
Traits of orange knitted skullcap is {"basic"}.
Placement of orange knitted skullcap is "head".
Descmod of orange knitted skullcap is "A orange knitted skullcap covers the top of your head.".
Slot of orange knitted skullcap is "head".
Scent of orange knitted skullcap is "The cap smells like wool.".

skull knitted skullcap is a grab object.
skull knitted skullcap is equipment.
It is not temporary.
Plural of skull knitted skullcap is false.
Taur-compatible of skull knitted skullcap is true.
Size of skull knitted skullcap is 3.
AC of skull knitted skullcap is 0.
Effectiveness of skull knitted skullcap is 0.
GA of skull knitted skullcap is 0.
Traits of skull knitted skullcap is {"rebellious"}.
Placement of skull knitted skullcap is "head".
Descmod of skull knitted skullcap is "A black knitted skullcap covers the top of your head, the white skull on the cover making you look like a rebel.".
Slot of skull knitted skullcap is "head".
Scent of skull knitted skullcap is "The cap smells like wool.".

Part 3 - Baseball Caps

Table of Game Objects (continued)
name	desc	weight	object
"tenvale vulpines baseball cap"	"A red and white baseball cap with the logo of the Tenvale Vulpines baseball team on its front. Judging by the cap's appearance, it's [']unisex['] and pretty [']sporty[']."	0	tenvale vulpines baseball cap
"tenvale silverbacks baseball cap"	"A black and silver baseball cap with the logo of the Tenvale Silverbacks football team on its front. Judging by the cap's appearance, it's [']unisex['] and pretty [']sporty[']."	0	tenvale silverbacks baseball cap

tenvale vulpines baseball cap is a grab object.
tenvale vulpines baseball cap is equipment.
It is not temporary.
Plural of tenvale vulpines baseball cap is false.
Taur-compatible of tenvale vulpines baseball cap is true.
Size of tenvale vulpines baseball cap is 3.
AC of tenvale vulpines baseball cap is 0.
Effectiveness of tenvale vulpines baseball cap is 0.
GA of tenvale vulpines baseball cap is 0.
Traits of tenvale vulpines baseball cap is {"sporty"}.
Placement of tenvale vulpines baseball cap is "head".
Descmod of tenvale vulpines baseball cap is "A red and white Tenvale Vulpines baseball cap covers your head, providing some protection from the sun with its visor.".
Slot of tenvale vulpines baseball cap is "head".
Scent of tenvale vulpines baseball cap is "The cap smells like fabric and plastic".

tenvale silverbacks baseball cap is a grab object.
tenvale silverbacks baseball cap is equipment.
It is not temporary.
Plural of tenvale silverbacks baseball cap is false.
Taur-compatible of tenvale silverbacks baseball cap is true.
Size of tenvale silverbacks baseball cap is 3.
AC of tenvale silverbacks baseball cap is 0.
Effectiveness of tenvale silverbacks baseball cap is 0.
GA of tenvale silverbacks baseball cap is 0.
Traits of tenvale silverbacks baseball cap is {"sporty"}.
Placement of tenvale silverbacks baseball cap is "head".
Descmod of tenvale silverbacks baseball cap is "A black and silver Tenvale Silverbacks baseball cap covers your head, providing some protection from the sun with its visor.".
Slot of tenvale silverbacks baseball cap is "head".
Scent of tenvale silverbacks baseball cap is "The cap smells like fabric and plastic".

Part 4 - Specialty Hats

Table of Game Objects (continued)
name	desc	weight	object
"tin-foil hat"	"A bunch of tin foil, bent into shape to cover a human's head. It might protect its wearer from alien mind control rays, or could possibly ensure that the head is still juicy and not burned on the outside when baked... Judging by the hat's appearance, it's [']unisex['] and pretty [']grungy[']."	0	tin-foil hat

tin-foil hat is a grab object.
tin-foil hat is equipment.
It is not temporary.
Plural of tin-foil hat is false.
Taur-compatible of tin-foil hat is true.
Size of tin-foil hat is 3.
AC of tin-foil hat is 0.
Effectiveness of tin-foil hat is 0.
GA of tin-foil hat is 0.
Traits of tin-foil hat is {"grungy"}.
Placement of tin-foil hat is "head".
Descmod of tin-foil hat is "A tin-foil hat covers your head, providing a dubious level of protection against... something.".
Slot of tin-foil hat is "head".
Scent of tin-foil hat is "The hat smells a bit like metal".

Section 2 - Hair Accessories

Part 1 - Large Bows

Table of Game Objects (continued)
name	desc	weight	object
"large white bow"	"A large white bow with a glossy finish. Its appearance seems more fitting for someone of a much younger age, or someone who simply loves cartoons and anime. Judging by the bow's appearance, it's [']feminine['] and pretty [']cute[']."	0	large white bow
"large black bow"	"A large black bow with a glossy finish. Its appearance seems more fitting for someone of a much younger age, or someone who simply loves cartoons and anime. Judging by the bow's appearance, it's [']feminine['] and pretty [']rebellious[']."	0	large black bow
"large pink bow"	"A large pink bow with a glossy finish. Its appearance seems more fitting for someone of a much younger age, or someone who simply loves cartoons and anime. Judging by the bow's appearance, it's [']feminine['] and pretty [']cute[']."	0	large pink bow
"large polka dot bow"	"A large polka dot bow with a glossy finish. Its appearance seems more fitting for someone of a much younger age, or someone who simply loves cartoons and anime. Judging by the bow's appearance, it's [']feminine['] and pretty [']cute[']."	0	large polka dot bow

large white bow is a grab object.
large white bow is equipment.
It is not temporary.
Plural of large white bow is false.
Taur-compatible of large white bow is true.
Size of large white bow is 3.
AC of large white bow is 0.
Effectiveness of large white bow is 0.
GA of large white bow is -1.
Traits of large white bow is {"cute"}.
Placement of large white bow is "head".
Descmod of large white bow is "A large white bow is attached to your hair, giving you a cute and sweet appearance.".
Slot of large white bow is "hair".
Scent of large white bow is "The bow smells a bit like satin".

large black bow is a grab object.
large black bow is equipment.
It is not temporary.
Plural of large black bow is false.
Taur-compatible of large black bow is true.
Size of large black bow is 3.
AC of large black bow is 0.
Effectiveness of large black bow is 0.
GA of large black bow is -1.
Traits of large black bow is {"rebellious"}.
Placement of large black bow is "head".
Descmod of large black bow is "A large black bow is attached to your hair, its dark color almost mocking the traditional [']cutesy['] stereotype.".
Slot of large black bow is "hair".
Scent of large black bow is "The bow smells a bit like satin".

large pink bow is a grab object.
large pink bow is equipment.
It is not temporary.
Plural of large pink bow is false.
Taur-compatible of large pink bow is true.
Size of large pink bow is 3.
AC of large pink bow is 0.
Effectiveness of large pink bow is 0.
GA of large pink bow is -1.
Traits of large pink bow is {"cute"}.
Placement of large pink bow is "head".
Descmod of large pink bow is "A large pink bow is attached to your hair, giving you a cute and sweet appearance.".
Slot of large pink bow is "hair".
Scent of large pink bow is "The bow smells a bit like satin".

large polka dot bow is a grab object.
large polka dot bow is equipment.
It is not temporary.
Plural of large polka dot bow is false.
Taur-compatible of large polka dot bow is true.
Size of large polka dot bow is 3.
AC of large polka dot bow is 0.
Effectiveness of large polka dot bow is 0.
GA of large polka dot bow is -1.
Traits of large polka dot bow is {"cute"}.
Placement of large polka dot bow is "head".
Descmod of large polka dot bow is "A large polka dot bow is attached to your hair, giving you a cute and sweet appearance.".
Slot of large polka dot bow is "hair".
Scent of large polka dot bow is "The bow smells a bit like satin".

Section 3 - Glasses

Part 1 - Sunglasses

Table of Game Objects (continued)
name	desc	weight	object
"simple sunglasses"	"A set of fairly simple sunglasses with a black plastic frame. Nothing special, but they'll protect your eyes. Judging by the glasses['] appearance, it's [']unisex['] and pretty [']basic[']."	0	simple sunglasses
"designer sunglasses"	"A set of Lu-Beam sunglasses with a very fancy shape. These are sure to make anyone look like a star. Judging by the glasses['] appearance, it's [']unisex['] and pretty [']stylish[']."	0	designer sunglasses

simple sunglasses is a grab object.
simple sunglasses is equipment.
It is not temporary.
Plural of simple sunglasses is true.
Taur-compatible of simple sunglasses is true.
Size of simple sunglasses is 0.
AC of simple sunglasses is 0.
Effectiveness of simple sunglasses is 0.
GA of simple sunglasses is 0.
Traits of simple sunglasses is {"basic"}.
Placement of simple sunglasses is "head".
Descmod of simple sunglasses is "A cheap set of sunglasses sits on your nose, protecting your eyes from bright light.".
Slot of simple sunglasses is "eyes".
Scent of simple sunglasses is "The glasses don't smell like anything really.".

designer sunglasses is a grab object.
designer sunglasses is equipment.
It is not temporary.
Plural of designer sunglasses is true.
Taur-compatible of designer sunglasses is true.
Size of designer sunglasses is 0.
AC of designer sunglasses is 0.
Effectiveness of designer sunglasses is 0.
GA of designer sunglasses is 0.
Traits of designer sunglasses is {"stylish"}.
Placement of designer sunglasses is "head".
Descmod of designer sunglasses is "An expensive set of sunglasses sits on your nose, giving you a stylish look and protecting your eyes.".
Slot of designer sunglasses is "eyes".
Scent of designer sunglasses is "The glasses don't smell like anything really.".

Part 2 - Regular Glasses

Table of Game Objects (continued)
name	desc	weight	object
"horn-rimmed glasses"	"A pair of dignified horn-rimmed glasses with slightly curved lenses. Judging by the glasses['] appearance, it's [']unisex['] and pretty [']smart['] looking."	0	horn-rimmed glasses

horn-rimmed glasses is a grab object.
horn-rimmed glasses is equipment.
It is not temporary.
Plural of horn-rimmed glasses is true.
Taur-compatible of horn-rimmed glasses is true.
Size of horn-rimmed glasses is 0.
AC of horn-rimmed glasses is 0.
Effectiveness of horn-rimmed glasses is 0.
GA of horn-rimmed glasses is 0.
Traits of horn-rimmed glasses is {"smart"}.
Placement of horn-rimmed glasses is "head".
Descmod of horn-rimmed glasses is "A pair of horn-rimmed glasses on your nose give you a dignified look.".
Slot of horn-rimmed glasses is "eyes".
Scent of horn-rimmed glasses is "The glasses don't smell like anything really.".

Part 3 - Specialty Glasses

Table of Game Objects (continued)
name	desc	weight	object
"prop glasses"	"A pair of stylish glasses with clear glass lenses in their frames. These are what you'd see on stage or in a movie, creating the right appearance without giving people headaches from wearing glasses even if they are not needed. Judging by the glasses['] appearance, it's [']unisex['] and pretty [']cool[']."	0	prop glasses
"rose-tinted glasses"	"A pair of rose-tinted glasses with frilly edges. There even are some glass gemstones with reflective backing glued to them. Judging by the glasses['] appearance, it's [']feminine['] and pretty [']stylish[']."	0	rose-tinted glasses

prop glasses is a grab object.
prop glasses is equipment.
It is not temporary.
Plural of prop glasses is true.
Taur-compatible of prop glasses is true.
Size of prop glasses is 0.
AC of prop glasses is 0.
Effectiveness of prop glasses is 0.
GA of prop glasses is 0.
Traits of prop glasses is {"cool"}.
Placement of prop glasses is "head".
Descmod of prop glasses is "A pair of prop glasses on your nose gives you an intelligent air.".
Slot of prop glasses is "eyes".
Scent of prop glasses is "The glasses don't smell like anything really.".

rose-tinted glasses is a grab object.
rose-tinted glasses is equipment.
It is not temporary.
Plural of rose-tinted glasses is true.
Taur-compatible of rose-tinted glasses is true.
Size of rose-tinted glasses is 0.
AC of rose-tinted glasses is 0.
Effectiveness of rose-tinted glasses is 0.
GA of rose-tinted glasses is -1.
Traits of rose-tinted glasses is {"stylish"}.
Placement of rose-tinted glasses is "head".
Descmod of rose-tinted glasses is "A pair of somewhat kitschy glasses on your nose gives you a rose-tinted outlook of the world.".
Slot of rose-tinted glasses is "eyes".
Scent of rose-tinted glasses is "The glasses don't smell like anything really.".

Section 4 - Masks

Table of Game Objects (continued)
name	desc	weight	object
"latex mouse mask"	"A dark-purple mask in the shape of an innocent and cute lil['] mouse, however in contradiction to its sweet appearance it has words like [']Squeak-Slut['] and [']Cheese-Whore[']. The mask is skin-tight with a buckle in back to hold it in place. Judging by the mask's appearance, it's [']unisex['] and look like it would be fitting for a sex [']slave[']."	0	latex mouse mask

latex mouse mask is a grab object.
latex mouse mask is equipment.
It is not temporary.
Plural of latex mouse mask is false.
Taur-compatible of latex mouse mask is true.
Size of latex mouse mask is 0.
AC of latex mouse mask is 0.
Effectiveness of latex mouse mask is 0.
GA of latex mouse mask is 0.
Traits of latex mouse mask is {"slave"}.
Placement of latex mouse mask is "head".
Descmod of latex mouse mask is "A latex mouse mask on your face that makes you look both sweet as cheesecake and as slutty as a back alley squeak-toy.".
Slot of latex mouse mask is "face".
Scent of latex mouse mask is "The mask smells of latex and bodily fluids.".

Section 5 - Neckwear

Section 6 - Necklaces

Section 7 - Jackets

Section 8 - Shirts

Part 1 - T-shirts

Table of Game Objects (continued)
name	desc	weight	object
"white t-shirt"	"A simple white t-shirt, without any pattern or frills to it. Judging by the garment's appearance, it's [']unisex['] and pretty [']basic[']."	1	white t-shirt
"black t-shirt"	"A simple black t-shirt, without any pattern or frills to it. Judging by the garment's appearance, it's [']unisex['] and pretty [']basic[']."	1	black t-shirt
"pink t-shirt"	"A simple pink t-shirt, without any pattern or frills to it. Judging by the garment's appearance, it's [']unisex['] and pretty [']basic[']."	1	pink t-shirt
"blue t-shirt"	"A simple blue t-shirt, without any pattern or frills to it. Judging by the garment's appearance, it's [']unisex['] and pretty [']basic[']."	1	blue t-shirt
"green t-shirt"	"A simple green t-shirt, without any pattern or frills to it. Judging by the garment's appearance, it's [']unisex['] and pretty [']basic[']."	1	green t-shirt
"red t-shirt"	"A simple red t-shirt, without any pattern or frills to it. Judging by the garment's appearance, it's [']unisex['] and pretty [']basic[']."	1	red t-shirt
"purple t-shirt"	"A simple purple t-shirt, without any pattern or frills to it. Judging by the garment's appearance, it's [']unisex['] and pretty [']basic[']."	1	purple t-shirt
"yellow t-shirt"	"A simple yellow t-shirt, without any pattern or frills to it. Judging by the garment's appearance, it's [']unisex['] and pretty [']basic[']."	1	yellow t-shirt
"orange t-shirt"	"A simple orange t-shirt, without any pattern or frills to it. Judging by the garment's appearance, it's [']unisex['] and pretty [']basic[']."	1	orange t-shirt
"tie-dye t-shirt"	"A simple tie-dye t-shirt, without any pattern or frills to it. Judging by the garment's appearance, it's [']unisex['] and pretty [']basic[']."	1	tie-dye t-shirt
"camo shirt"	"A t-shirt with camo patterns in various shades of green. Clearly, it belongs to the uniform of a soldier of the US army. Judging by the shirt's appearance, it's [']unisex['] and pretty [']cool['] looking."	1	camo shirt

white t-shirt is a grab object.
white t-shirt is equipment.
It is not temporary.
Plural of white t-shirt is false.
Taur-compatible of white t-shirt is true.
Size of white t-shirt is 3.
AC of white t-shirt is 0.
Effectiveness of white t-shirt is 0.
GA of white t-shirt is 0.
Traits of white t-shirt is {"basic"}.
Placement of white t-shirt is "body".
Descmod of white t-shirt is "Your upper body is covered by a white t-shirt.".
Slot of white t-shirt is "chest".
Scent of white t-shirt is "The fabric has the typical faintly musky scent of clothing that has been worn a few days. Still, it's good enough for a few more, at least. During the nanite apocalypse, one can give some leeway in terms of body hygiene - survival comes first...".

black t-shirt is a grab object.
black t-shirt is equipment.
It is not temporary.
Plural of black t-shirt is false.
Taur-compatible of black t-shirt is true.
Size of black t-shirt is 3.
AC of black t-shirt is 0.
Effectiveness of black t-shirt is 0.
GA of black t-shirt is 0.
Traits of black t-shirt is {"basic"}.
Placement of black t-shirt is "body".
Descmod of black t-shirt is "Your upper body is covered by a black t-shirt.".
Slot of black t-shirt is "chest".
Scent of black t-shirt is "The fabric has the typical faintly musky scent of clothing that has been worn a few days. Still, it's good enough for a few more, at least. During the nanite apocalypse, one can give some leeway in terms of body hygiene - survival comes first...".

pink t-shirt is a grab object.
pink t-shirt is equipment.
It is not temporary.
Plural of pink t-shirt is false.
Taur-compatible of pink t-shirt is true.
Size of pink t-shirt is 3.
AC of pink t-shirt is 0.
Effectiveness of pink t-shirt is 0.
GA of pink t-shirt is 0.
Traits of pink t-shirt is {"basic"}.
Placement of pink t-shirt is "body".
Descmod of pink t-shirt is "Your upper body is covered by a pink t-shirt.".
Slot of pink t-shirt is "chest".
Scent of pink t-shirt is "The fabric has the typical faintly musky scent of clothing that has been worn a few days. Still, it's good enough for a few more, at least. During the nanite apocalypse, one can give some leeway in terms of body hygiene - survival comes first...".

blue t-shirt is a grab object.
blue t-shirt is equipment.
It is not temporary.
Plural of blue t-shirt is false.
Taur-compatible of blue t-shirt is true.
Size of blue t-shirt is 3.
AC of blue t-shirt is 0.
Effectiveness of blue t-shirt is 0.
GA of blue t-shirt is 0.
Traits of blue t-shirt is {"basic"}.
Placement of blue t-shirt is "body".
Descmod of blue t-shirt is "Your upper body is covered by a blue t-shirt.".
Slot of blue t-shirt is "chest".
Scent of blue t-shirt is "The fabric has the typical faintly musky scent of clothing that has been worn a few days. Still, it's good enough for a few more, at least. During the nanite apocalypse, one can give some leeway in terms of body hygiene - survival comes first...".

green t-shirt is a grab object.
green t-shirt is equipment.
It is not temporary.
Plural of green t-shirt is false.
Taur-compatible of green t-shirt is true.
Size of green t-shirt is 3.
AC of green t-shirt is 0.
Effectiveness of green t-shirt is 0.
GA of green t-shirt is 0.
Traits of green t-shirt is {"basic"}.
Placement of green t-shirt is "body".
Descmod of green t-shirt is "Your upper body is covered by a green t-shirt.".
Slot of green t-shirt is "chest".
Scent of green t-shirt is "The fabric has the typical faintly musky scent of clothing that has been worn a few days. Still, it's good enough for a few more, at least. During the nanite apocalypse, one can give some leeway in terms of body hygiene - survival comes first...".

red t-shirt is a grab object.
red t-shirt is equipment.
It is not temporary.
Plural of red t-shirt is false.
Taur-compatible of red t-shirt is true.
Size of red t-shirt is 3.
AC of red t-shirt is 0.
Effectiveness of red t-shirt is 0.
GA of red t-shirt is 0.
Traits of red t-shirt is {"basic"}.
Placement of red t-shirt is "body".
Descmod of red t-shirt is "Your upper body is covered by a red t-shirt.".
Slot of red t-shirt is "chest".
Scent of red t-shirt is "The fabric has the typical faintly musky scent of clothing that has been worn a few days. Still, it's good enough for a few more, at least. During the nanite apocalypse, one can give some leeway in terms of body hygiene - survival comes first...".

purple t-shirt is a grab object.
purple t-shirt is equipment.
It is not temporary.
Plural of purple t-shirt is false.
Taur-compatible of purple t-shirt is true.
Size of purple t-shirt is 3.
AC of purple t-shirt is 0.
Effectiveness of purple t-shirt is 0.
GA of purple t-shirt is 0.
Traits of purple t-shirt is {"basic"}.
Placement of purple t-shirt is "body".
Descmod of purple t-shirt is "Your upper body is covered by a purple t-shirt.".
Slot of purple t-shirt is "chest".
Scent of purple t-shirt is "The fabric has the typical faintly musky scent of clothing that has been worn a few days. Still, it's good enough for a few more, at least. During the nanite apocalypse, one can give some leeway in terms of body hygiene - survival comes first...".

yellow t-shirt is a grab object.
yellow t-shirt is equipment.
It is not temporary.
Plural of yellow t-shirt is false.
Taur-compatible of yellow t-shirt is true.
Size of yellow t-shirt is 3.
AC of yellow t-shirt is 0.
Effectiveness of yellow t-shirt is 0.
GA of yellow t-shirt is 0.
Traits of yellow t-shirt is {"basic"}.
Placement of yellow t-shirt is "body".
Descmod of yellow t-shirt is "Your upper body is covered by a yellow t-shirt.".
Slot of yellow t-shirt is "chest".
Scent of yellow t-shirt is "The fabric has the typical faintly musky scent of clothing that has been worn a few days. Still, it's good enough for a few more, at least. During the nanite apocalypse, one can give some leeway in terms of body hygiene - survival comes first...".

orange t-shirt is a grab object.
orange t-shirt is equipment.
It is not temporary.
Plural of orange t-shirt is false.
Taur-compatible of orange t-shirt is true.
Size of orange t-shirt is 3.
AC of orange t-shirt is 0.
Effectiveness of orange t-shirt is 0.
GA of orange t-shirt is 0.
Traits of orange t-shirt is {"basic"}.
Placement of orange t-shirt is "body".
Descmod of orange t-shirt is "Your upper body is covered by a orange t-shirt.".
Slot of orange t-shirt is "chest".
Scent of orange t-shirt is "The fabric has the typical faintly musky scent of clothing that has been worn a few days. Still, it's good enough for a few more, at least. During the nanite apocalypse, one can give some leeway in terms of body hygiene - survival comes first...".

tie-dye t-shirt is a grab object.
tie-dye t-shirt is equipment.
It is not temporary.
Plural of tie-dye t-shirt is false.
Taur-compatible of tie-dye t-shirt is true.
Size of tie-dye t-shirt is 3.
AC of tie-dye t-shirt is 0.
Effectiveness of tie-dye t-shirt is 0.
GA of tie-dye t-shirt is 0.
Traits of tie-dye t-shirt is {"basic"}.
Placement of tie-dye t-shirt is "body".
Descmod of tie-dye t-shirt is "Your upper body is covered by a tie-dye t-shirt.".
Slot of tie-dye t-shirt is "chest".
Scent of tie-dye t-shirt is "The fabric has the typical faintly musky scent of clothing that has been worn a few days. Still, it's good enough for a few more, at least. During the nanite apocalypse, one can give some leeway in terms of body hygiene - survival comes first...".

camo shirt is a grab object.
camo shirt is equipment.
It is not temporary.
Plural of camo shirt is false.
Taur-compatible of camo shirt is true.
Size of camo shirt is 3.
AC of camo shirt is 0.
Effectiveness of camo shirt is 0.
GA of camo shirt is 0.
Traits of camo shirt is {"cool"}.
Placement of camo shirt is "body".
Descmod of camo shirt is "Your upper body is covered by a camo pattern t-shirt in shades of green.".
Slot of camo shirt is "chest".
Scent of camo shirt is "The fabric has the typical faintly musky scent of clothing that has been worn a few days. Still, it's good enough for a few more, at least. During the nanite apocalypse, one can give some leeway in terms of body hygiene - survival comes first...".

Part 2 - Pullovers

Table of Game Objects (continued)
name	desc	weight	object
"white pullover"	"A fairly large white pullover. It is perfect to keep its wearer warm. Judging by the pullover's appearance, it's [']unisex['] and pretty [']basic['] looking."	1	white pullover
"black pullover"	"A fairly large black pullover. It is perfect to keep its wearer warm. Judging by the pullover's appearance, it's [']unisex['] and pretty [']basic['] looking."	1	black pullover
"pink pullover"	"A fairly large pink pullover. It is perfect to keep its wearer warm. Judging by the pullover's appearance, it's [']unisex['] and pretty [']basic['] looking."	1	pink pullover
"blue pullover"	"A fairly large blue pullover. It is perfect to keep its wearer warm. Judging by the pullover's appearance, it's [']unisex['] and pretty [']basic['] looking."	1	blue pullover
"green pullover"	"A fairly large green pullover. It is perfect to keep its wearer warm. Judging by the pullover's appearance, it's [']unisex['] and pretty [']basic['] looking."	1	green pullover
"red pullover"	"A fairly large red pullover. It is perfect to keep its wearer warm. Judging by the pullover's appearance, it's [']unisex['] and pretty [']basic['] looking."	1	red pullover
"purple pullover"	"A fairly large purple pullover. It is perfect to keep its wearer warm. Judging by the pullover's appearance, it's [']unisex['] and pretty [']basic['] looking."	1	purple pullover
"yellow pullover"	"A fairly large yellow pullover. It is perfect to keep its wearer warm. Judging by the pullover's appearance, it's [']unisex['] and pretty [']basic['] looking."	1	yellow pullover
"orange pullover"	"A fairly large orange pullover. It is perfect to keep its wearer warm. Judging by the pullover's appearance, it's [']unisex['] and pretty [']basic['] looking."	1	orange pullover
"maroon pullover"	"A fairly large maroon pullover. It is perfect to keep its wearer warm. Judging by the pullover's appearance, it's [']unisex['] and pretty [']basic['] looking."	1	maroon pullover

white pullover is a grab object.
white pullover is equipment.
It is not temporary.
Plural of white pullover is false.
Taur-compatible of white pullover is true.
Size of white pullover is 3.
AC of white pullover is 0.
Effectiveness of white pullover is 0.
GA of white pullover is 0.
Traits of white pullover is {"basic"}.
Placement of white pullover is "body".
Descmod of white pullover is "Your upper body is covered by a white pullover.".
Slot of white pullover is "chest".
Scent of white pullover is "The fabric has the typical faintly musky scent of clothing that has been worn a few days. Still, it's good enough for a few more, at least. During the nanite apocalypse, one can give some leeway in terms of body hygiene - survival comes first...".

black pullover is a grab object.
black pullover is equipment.
It is not temporary.
Plural of black pullover is false.
Taur-compatible of black pullover is true.
Size of black pullover is 3.
AC of black pullover is 0.
Effectiveness of black pullover is 0.
GA of black pullover is 0.
Traits of black pullover is {"basic"}.
Placement of black pullover is "body".
Descmod of black pullover is "Your upper body is covered by a black pullover.".
Slot of black pullover is "chest".
Scent of black pullover is "The fabric has the typical faintly musky scent of clothing that has been worn a few days. Still, it's good enough for a few more, at least. During the nanite apocalypse, one can give some leeway in terms of body hygiene - survival comes first...".

pink pullover is a grab object.
pink pullover is equipment.
It is not temporary.
Plural of pink pullover is false.
Taur-compatible of pink pullover is true.
Size of pink pullover is 3.
AC of pink pullover is 0.
Effectiveness of pink pullover is 0.
GA of pink pullover is 0.
Traits of pink pullover is {"basic"}.
Placement of pink pullover is "body".
Descmod of pink pullover is "Your upper body is covered by a pink pullover.".
Slot of pink pullover is "chest".
Scent of pink pullover is "The fabric has the typical faintly musky scent of clothing that has been worn a few days. Still, it's good enough for a few more, at least. During the nanite apocalypse, one can give some leeway in terms of body hygiene - survival comes first...".

blue pullover is a grab object.
blue pullover is equipment.
It is not temporary.
Plural of blue pullover is false.
Taur-compatible of blue pullover is true.
Size of blue pullover is 3.
AC of blue pullover is 0.
Effectiveness of blue pullover is 0.
GA of blue pullover is 0.
Traits of blue pullover is {"basic"}.
Placement of blue pullover is "body".
Descmod of blue pullover is "Your upper body is covered by a blue pullover.".
Slot of blue pullover is "chest".
Scent of blue pullover is "The fabric has the typical faintly musky scent of clothing that has been worn a few days. Still, it's good enough for a few more, at least. During the nanite apocalypse, one can give some leeway in terms of body hygiene - survival comes first...".

green pullover is a grab object.
green pullover is equipment.
It is not temporary.
Plural of green pullover is false.
Taur-compatible of green pullover is true.
Size of green pullover is 3.
AC of green pullover is 0.
Effectiveness of green pullover is 0.
GA of green pullover is 0.
Traits of green pullover is {"basic"}.
Placement of green pullover is "body".
Descmod of green pullover is "Your upper body is covered by a green pullover.".
Slot of green pullover is "chest".
Scent of green pullover is "The fabric has the typical faintly musky scent of clothing that has been worn a few days. Still, it's good enough for a few more, at least. During the nanite apocalypse, one can give some leeway in terms of body hygiene - survival comes first...".

red pullover is a grab object.
red pullover is equipment.
It is not temporary.
Plural of red pullover is false.
Taur-compatible of red pullover is true.
Size of red pullover is 3.
AC of red pullover is 0.
Effectiveness of red pullover is 0.
GA of red pullover is 0.
Traits of red pullover is {"basic"}.
Placement of red pullover is "body".
Descmod of red pullover is "Your upper body is covered by a red pullover.".
Slot of red pullover is "chest".
Scent of red pullover is "The fabric has the typical faintly musky scent of clothing that has been worn a few days. Still, it's good enough for a few more, at least. During the nanite apocalypse, one can give some leeway in terms of body hygiene - survival comes first...".

purple pullover is a grab object.
purple pullover is equipment.
It is not temporary.
Plural of purple pullover is false.
Taur-compatible of purple pullover is true.
Size of purple pullover is 3.
AC of purple pullover is 0.
Effectiveness of purple pullover is 0.
GA of purple pullover is 0.
Traits of purple pullover is {"basic"}.
Placement of purple pullover is "body".
Descmod of purple pullover is "Your upper body is covered by a purple pullover.".
Slot of purple pullover is "chest".
Scent of purple pullover is "The fabric has the typical faintly musky scent of clothing that has been worn a few days. Still, it's good enough for a few more, at least. During the nanite apocalypse, one can give some leeway in terms of body hygiene - survival comes first...".

yellow pullover is a grab object.
yellow pullover is equipment.
It is not temporary.
Plural of yellow pullover is false.
Taur-compatible of yellow pullover is true.
Size of yellow pullover is 3.
AC of yellow pullover is 0.
Effectiveness of yellow pullover is 0.
GA of yellow pullover is 0.
Traits of yellow pullover is {"basic"}.
Placement of yellow pullover is "body".
Descmod of yellow pullover is "Your upper body is covered by a yellow pullover.".
Slot of yellow pullover is "chest".
Scent of yellow pullover is "The fabric has the typical faintly musky scent of clothing that has been worn a few days. Still, it's good enough for a few more, at least. During the nanite apocalypse, one can give some leeway in terms of body hygiene - survival comes first...".

orange pullover is a grab object.
orange pullover is equipment.
It is not temporary.
Plural of orange pullover is false.
Taur-compatible of orange pullover is true.
Size of orange pullover is 3.
AC of orange pullover is 0.
Effectiveness of orange pullover is 0.
GA of orange pullover is 0.
Traits of orange pullover is {"basic"}.
Placement of orange pullover is "body".
Descmod of orange pullover is "Your upper body is covered by a orange pullover.".
Slot of orange pullover is "chest".
Scent of orange pullover is "The fabric has the typical faintly musky scent of clothing that has been worn a few days. Still, it's good enough for a few more, at least. During the nanite apocalypse, one can give some leeway in terms of body hygiene - survival comes first...".

maroon pullover is a grab object.
maroon pullover is equipment.
It is not temporary.
Plural of maroon pullover is false.
Taur-compatible of maroon pullover is true.
Size of maroon pullover is 3.
AC of maroon pullover is 0.
Effectiveness of maroon pullover is 0.
GA of maroon pullover is 0.
Traits of maroon pullover is {"basic"}.
Placement of maroon pullover is "body".
Descmod of maroon pullover is "Your upper body is covered by a maroon pullover.".
Slot of maroon pullover is "chest".
Scent of maroon pullover is "The fabric has the typical faintly musky scent of clothing that has been worn a few days. Still, it's good enough for a few more, at least. During the nanite apocalypse, one can give some leeway in terms of body hygiene - survival comes first...".

Part 3 - Zephyr Shirts
[Want to have a cute animal mascot on each of these shirts one for every different form that you can give Larissa]

[
Table of Game Objects (continued)
name	desc	weight	object
]

Part 4 - Sleeveless Shirts

Table of Game Objects (continued)
name	desc	weight	object
"white sleeveless shirt"	"A white sleeveless shirt, made from thin and stretchy fabric. It looks suitable to be working out in it. Judging by the shirt's appearance, it's [']unisex['] and pretty [']sporty['] looking."	1	white sleeveless shirt
"black sleeveless shirt"	"A black sleeveless shirt, made from thin and stretchy fabric. It looks suitable to be working out in it. Judging by the shirt's appearance, it's [']unisex['] and pretty [']sporty['] looking."	1	black sleeveless shirt
"pink sleeveless shirt"	"A pink sleeveless shirt, made from thin and stretchy fabric. It looks suitable to be working out in it. Judging by the shirt's appearance, it's [']unisex['] and pretty [']sporty['] looking."	1	pink sleeveless shirt
"blue sleeveless shirt"	"A blue sleeveless shirt, made from thin and stretchy fabric. It looks suitable to be working out in it. Judging by the shirt's appearance, it's [']unisex['] and pretty [']sporty['] looking."	1	blue sleeveless shirt
"green sleeveless shirt"	"A green sleeveless shirt, made from thin and stretchy fabric. It looks suitable to be working out in it. Judging by the shirt's appearance, it's [']unisex['] and pretty [']sporty['] looking."	1	green sleeveless shirt
"red sleeveless shirt"	"A red sleeveless shirt, made from thin and stretchy fabric. It looks suitable to be working out in it. Judging by the shirt's appearance, it's [']unisex['] and pretty [']sporty['] looking."	1	red sleeveless shirt
"purple sleeveless shirt"	"A purple sleeveless shirt, made from thin and stretchy fabric. It looks suitable to be working out in it. Judging by the shirt's appearance, it's [']unisex['] and pretty [']sporty['] looking."	1	purple sleeveless shirt
"yellow sleeveless shirt"	"A yellow sleeveless shirt, made from thin and stretchy fabric. It looks suitable to be working out in it. Judging by the shirt's appearance, it's [']unisex['] and pretty [']sporty['] looking."	1	yellow sleeveless shirt
"orange sleeveless shirt"	"A orange sleeveless shirt, made from thin and stretchy fabric. It looks suitable to be working out in it. Judging by the shirt's appearance, it's [']unisex['] and pretty [']sporty['] looking."	1	orange sleeveless shirt

white sleeveless shirt is a grab object.
white sleeveless shirt is equipment.
It is not temporary.
Plural of white sleeveless shirt is false.
Taur-compatible of white sleeveless shirt is true.
Size of white sleeveless shirt is 3.
AC of white sleeveless shirt is 0.
Effectiveness of white sleeveless shirt is 0.
GA of white sleeveless shirt is 0.
Traits of white sleeveless shirt is {"sporty"}. [Note: maybe give the sleeveless shirts sporty & sexy or so? to differentiate from sporty t-shirts]
Placement of white sleeveless shirt is "body".
Descmod of white sleeveless shirt is "Your upper body is covered by a white sleeveless shirt.".
Slot of white sleeveless shirt is "chest".
Scent of white sleeveless shirt is "The fabric has the typical faintly musky scent of clothing that has been worn a few days. Still, it's good enough for a few more, at least. During the nanite apocalypse, one can give some leeway in terms of body hygiene - survival comes first...".

black sleeveless shirt is a grab object.
black sleeveless shirt is equipment.
It is not temporary.
Plural of black sleeveless shirt is false.
Taur-compatible of black sleeveless shirt is true.
Size of black sleeveless shirt is 3.
AC of black sleeveless shirt is 0.
Effectiveness of black sleeveless shirt is 0.
GA of black sleeveless shirt is 0.
Traits of black sleeveless shirt is {"sporty"}. [Note: maybe give the sleeveless shirts sporty & sexy or so? to differentiate from sporty t-shirts]
Placement of black sleeveless shirt is "body".
Descmod of black sleeveless shirt is "Your upper body is covered by a black sleeveless shirt.".
Slot of black sleeveless shirt is "chest".
Scent of black sleeveless shirt is "The fabric has the typical faintly musky scent of clothing that has been worn a few days. Still, it's good enough for a few more, at least. During the nanite apocalypse, one can give some leeway in terms of body hygiene - survival comes first...".

pink sleeveless shirt is a grab object.
pink sleeveless shirt is equipment.
It is not temporary.
Plural of pink sleeveless shirt is false.
Taur-compatible of pink sleeveless shirt is true.
Size of pink sleeveless shirt is 3.
AC of pink sleeveless shirt is 0.
Effectiveness of pink sleeveless shirt is 0.
GA of pink sleeveless shirt is 0.
Traits of pink sleeveless shirt is {"sporty"}. [Note: maybe give the sleeveless shirts sporty & sexy or so? to differentiate from sporty t-shirts]
Placement of pink sleeveless shirt is "body".
Descmod of pink sleeveless shirt is "Your upper body is covered by a pink sleeveless shirt.".
Slot of pink sleeveless shirt is "chest".
Scent of pink sleeveless shirt is "The fabric has the typical faintly musky scent of clothing that has been worn a few days. Still, it's good enough for a few more, at least. During the nanite apocalypse, one can give some leeway in terms of body hygiene - survival comes first...".

blue sleeveless shirt is a grab object.
blue sleeveless shirt is equipment.
It is not temporary.
Plural of blue sleeveless shirt is false.
Taur-compatible of blue sleeveless shirt is true.
Size of blue sleeveless shirt is 3.
AC of blue sleeveless shirt is 0.
Effectiveness of blue sleeveless shirt is 0.
GA of blue sleeveless shirt is 0.
Traits of blue sleeveless shirt is {"sporty"}. [Note: maybe give the sleeveless shirts sporty & sexy or so? to differentiate from sporty t-shirts]
Placement of blue sleeveless shirt is "body".
Descmod of blue sleeveless shirt is "Your upper body is covered by a blue sleeveless shirt.".
Slot of blue sleeveless shirt is "chest".
Scent of blue sleeveless shirt is "The fabric has the typical faintly musky scent of clothing that has been worn a few days. Still, it's good enough for a few more, at least. During the nanite apocalypse, one can give some leeway in terms of body hygiene - survival comes first...".

green sleeveless shirt is a grab object.
green sleeveless shirt is equipment.
It is not temporary.
Plural of green sleeveless shirt is false.
Taur-compatible of green sleeveless shirt is true.
Size of green sleeveless shirt is 3.
AC of green sleeveless shirt is 0.
Effectiveness of green sleeveless shirt is 0.
GA of green sleeveless shirt is 0.
Traits of green sleeveless shirt is {"sporty"}. [Note: maybe give the sleeveless shirts sporty & sexy or so? to differentiate from sporty t-shirts]
Placement of green sleeveless shirt is "body".
Descmod of green sleeveless shirt is "Your upper body is covered by a green sleeveless shirt.".
Slot of green sleeveless shirt is "chest".
Scent of green sleeveless shirt is "The fabric has the typical faintly musky scent of clothing that has been worn a few days. Still, it's good enough for a few more, at least. During the nanite apocalypse, one can give some leeway in terms of body hygiene - survival comes first...".

red sleeveless shirt is a grab object.
red sleeveless shirt is equipment.
It is not temporary.
Plural of red sleeveless shirt is false.
Taur-compatible of red sleeveless shirt is true.
Size of red sleeveless shirt is 3.
AC of red sleeveless shirt is 0.
Effectiveness of red sleeveless shirt is 0.
GA of red sleeveless shirt is 0.
Traits of red sleeveless shirt is {"sporty"}. [Note: maybe give the sleeveless shirts sporty & sexy or so? to differentiate from sporty t-shirts]
Placement of red sleeveless shirt is "body".
Descmod of red sleeveless shirt is "Your upper body is covered by a red sleeveless shirt.".
Slot of red sleeveless shirt is "chest".
Scent of red sleeveless shirt is "The fabric has the typical faintly musky scent of clothing that has been worn a few days. Still, it's good enough for a few more, at least. During the nanite apocalypse, one can give some leeway in terms of body hygiene - survival comes first...".

purple sleeveless shirt is a grab object.
purple sleeveless shirt is equipment.
It is not temporary.
Plural of purple sleeveless shirt is false.
Taur-compatible of purple sleeveless shirt is true.
Size of purple sleeveless shirt is 3.
AC of purple sleeveless shirt is 0.
Effectiveness of purple sleeveless shirt is 0.
GA of purple sleeveless shirt is 0.
Traits of purple sleeveless shirt is {"sporty"}. [Note: maybe give the sleeveless shirts sporty & sexy or so? to differentiate from sporty t-shirts]
Placement of purple sleeveless shirt is "body".
Descmod of purple sleeveless shirt is "Your upper body is covered by a purple sleeveless shirt.".
Slot of purple sleeveless shirt is "chest".
Scent of purple sleeveless shirt is "The fabric has the typical faintly musky scent of clothing that has been worn a few days. Still, it's good enough for a few more, at least. During the nanite apocalypse, one can give some leeway in terms of body hygiene - survival comes first...".

yellow sleeveless shirt is a grab object.
yellow sleeveless shirt is equipment.
It is not temporary.
Plural of yellow sleeveless shirt is false.
Taur-compatible of yellow sleeveless shirt is true.
Size of yellow sleeveless shirt is 3.
AC of yellow sleeveless shirt is 0.
Effectiveness of yellow sleeveless shirt is 0.
GA of yellow sleeveless shirt is 0.
Traits of yellow sleeveless shirt is {"sporty"}. [Note: maybe give the sleeveless shirts sporty & sexy or so? to differentiate from sporty t-shirts]
Placement of yellow sleeveless shirt is "body".
Descmod of yellow sleeveless shirt is "Your upper body is covered by a yellow sleeveless shirt.".
Slot of yellow sleeveless shirt is "chest".
Scent of yellow sleeveless shirt is "The fabric has the typical faintly musky scent of clothing that has been worn a few days. Still, it's good enough for a few more, at least. During the nanite apocalypse, one can give some leeway in terms of body hygiene - survival comes first...".

orange sleeveless shirt is a grab object.
orange sleeveless shirt is equipment.
It is not temporary.
Plural of orange sleeveless shirt is false.
Taur-compatible of orange sleeveless shirt is true.
Size of orange sleeveless shirt is 3.
AC of orange sleeveless shirt is 0.
Effectiveness of orange sleeveless shirt is 0.
GA of orange sleeveless shirt is 0.
Traits of orange sleeveless shirt is {"sporty"}. [Note: maybe give the sleeveless shirts sporty & sexy or so? to differentiate from sporty t-shirts]
Placement of orange sleeveless shirt is "body".
Descmod of orange sleeveless shirt is "Your upper body is covered by a orange sleeveless shirt.".
Slot of orange sleeveless shirt is "chest".
Scent of orange sleeveless shirt is "The fabric has the typical faintly musky scent of clothing that has been worn a few days. Still, it's good enough for a few more, at least. During the nanite apocalypse, one can give some leeway in terms of body hygiene - survival comes first...".

Part 5 - Specialty Shirts

Table of Game Objects (continued)
name	desc	weight	object
"mesh shirt"	"A tight shirt made of some kind of black, sheer mesh. You can literally see right through it. Judging by the shirt's appearance, it's [']unisex['] and pretty [']sexy['] looking."	1	mesh shirt

mesh shirt is a grab object.
mesh shirt is equipment.
It is not temporary.
Plural of mesh shirt is false.
Taur-compatible of mesh shirt is true.
Size of mesh shirt is 3.
AC of mesh shirt is 0.
Effectiveness of mesh shirt is 0.
GA of mesh shirt is 0.
Traits of mesh shirt is {"sexy"}.
Placement of mesh shirt is "body".
Descmod of mesh shirt is "Your upper body is covered by a black mesh shirt. With its sheer fabric, you can literally see right through it.".
Slot of mesh shirt is "chest".
Scent of mesh shirt is "The fabric has the typical faintly musky scent of clothing that has been worn a few days. Still, it's good enough for a few more, at least. During the nanite apocalypse, one can give some leeway in terms of body hygiene - survival comes first...".

Section 9 - Bras

Table of Game Objects (continued)
name	desc	weight	object
"simple black bra"	"A simple black bra made of a firm and glossy material. As far as bras go this one is fairly comfortable to move around in. Judging by the bra's appearance, it's [']feminine['] and pretty [']basic['] looking."	1	simple black bra

simple black bra is a grab object.
simple black bra is equipment.
It is not temporary.
Plural of simple black bra is false.
Taur-compatible of simple black bra is true.
Size of simple black bra is 3.
AC of simple black bra is 0.
Effectiveness of simple black bra is 0.
GA of simple black bra is -1.
Traits of simple black bra is {"basic"}.
Placement of simple black bra is "body".
Descmod of simple black bra is "Your breasts are covered by a simple black bra. The soft and glossy material hugging your chest.".
Slot of simple black bra is "breast".
Scent of simple black bra is "The fabric has the typical faintly musky scent of clothing that has been worn a few days. Still, it's good enough for a few more, at least. During the nanite apocalypse, one can give some leeway in terms of body hygiene - survival comes first...".

Section 10 - Stomach Trainers

Section 11 - Gloves

Section 12 - Rings

Section 13 - Belts

Section 14 - Pants

Part 1 - Slacks

Table of Game Objects (continued)
name	desc	weight	object
"black slacks"	"A pair of black cloth pants, most likely belonging to a business suit. Judging by the slacks['] appearance, it's [']unisex['] and pretty [']stylish['] looking."	1	black slacks
"gray slacks"	"A pair of gray cloth pants, most likely belonging to a business suit. Judging by the slacks['] appearance, it's [']unisex['] and pretty [']stylish['] looking."	1	gray slacks

black slacks is a grab object.
black slacks is equipment.
It is not temporary.
Plural of black slacks is true.
Taur-compatible of black slacks is false.
Size of black slacks is 3.
AC of black slacks is 0.
Effectiveness of black slacks is 0.
GA of black slacks is 0.
Traits of black slacks is {"stylish"}.
Placement of black slacks is "body".
Descmod of black slacks is "A pair of black slacks cover your hips and legs. They are fairly light and soft, but you worry how long they'll last given the regular fights you can get into.".
Slot of black slacks is "legs".
Scent of black slacks is "The pants have the typical faintly musky scent of clothing that has been worn a few days. But surely they're clean enough to wear another week or two at least...".

gray slacks is a grab object.
gray slacks is equipment.
It is not temporary.
Plural of gray slacks is true.
Taur-compatible of gray slacks is false.
Size of gray slacks is 3.
AC of gray slacks is 0.
Effectiveness of gray slacks is 0.
GA of gray slacks is 0.
Traits of gray slacks is {"stylish"}.
Placement of gray slacks is "body".
Descmod of gray slacks is "A pair of gray slacks cover your hips and legs. They are fairly light and soft, but you worry how long they'll last given the regular fights you can get into.".
Slot of gray slacks is "legs".
Scent of gray slacks is "The pants have the typical faintly musky scent of clothing that has been worn a few days. But surely they're clean enough to wear another week or two at least...".

Part 2 - Jeans [sturdy jeans have been replaced with the dark-blue jeans since the name and color was the only difference between them and the black jeans]

Table of Game Objects (continued)
name	desc	weight	object
"black jeans"	"A pair of solid black jeans. They're well-worn and a little washed out in places, but quite comfortable even in the most dire situations. Judging by the pants['] appearance, it's [']unisex['] and pretty [']basic['] looking."	1	black jeans
"dark-blue jeans"	"A pair of dark-blue jeans. They're well-worn and a little washed out in places, but quite comfortable even in the most dire situations. Judging by the pants['] appearance, it's [']unisex['] and pretty [']basic['] looking."	1	dark-blue jeans

black jeans is a grab object.
black jeans is equipment.
It is not temporary.
Plural of black jeans is true.
Taur-compatible of black jeans is false.
Size of black jeans is 3.
AC of black jeans is 0.
Effectiveness of black jeans is 0.
GA of black jeans is 0.
Traits of black jeans is {"basic"}.
Placement of black jeans is "body".
Descmod of black jeans is "A pair of solid black jeans cover your hips and legs. The sturdy fabric gives you a well-protected feeling.".
Slot of black jeans is "legs".
Scent of black jeans is "The jeans have the typical faintly musky scent of pants that have been worn a few days. But surely they're clean enough to wear another week or two at least...".

dark-blue jeans is a grab object.
dark-blue jeans is equipment.
It is not temporary.
Plural of dark-blue jeans is true.
Taur-compatible of dark-blue jeans is false.
Size of dark-blue jeans is 3.
AC of dark-blue jeans is 0.
Effectiveness of dark-blue jeans is 0.
GA of dark-blue jeans is 0.
Traits of dark-blue jeans is {"basic"}.
Placement of dark-blue jeans is "body".
Descmod of dark-blue jeans is "A pair of dark-blue jeans cover your hips and legs. The sturdy fabric gives you a well-protected feeling.".
Slot of dark-blue jeans is "legs".
Scent of dark-blue jeans is "The jeans have the typical faintly musky scent of pants that have been worn a few days. But surely they're clean enough to wear another week or two at least...".

Part 3 - ripped blue jeans

Table of Game Objects (continued)
name	desc	weight	object
"ripped black jeans"	"A pair of black jeans with some rips and slashes in them. Before all of this started, their look might have been a fashion statement, but these days one usually ends up with ripped clothing after a fight. Judging by the pants['] appearance, it's [']unisex['] and pretty [']rebellious['] looking."	1	ripped black jeans
"ripped blue jeans"	"A pair of blue jeans with some rips and slashes in them. Before all of this started, their look might have been a fashion statement, but these days one usually ends up with ripped clothing after a fight. Judging by the pants['] appearance, it's [']unisex['] and pretty [']rebellious['] looking."	1	ripped blue jeans

ripped black jeans is a grab object.
ripped black jeans is equipment.
It is not temporary.
Plural of ripped black jeans is true.
Taur-compatible of ripped black jeans is false.
Size of ripped black jeans is 3.
AC of ripped black jeans is 0.
Effectiveness of ripped black jeans is 0.
GA of ripped black jeans is 0.
Traits of ripped black jeans is {"rebellious"}.
Placement of ripped black jeans is "body".
Descmod of ripped black jeans is "A pair of black ripped and torn jeans cover your hips and legs. Even though they have holes, wearing them gives you a somewhat protected feeling.".
Slot of ripped black jeans is "legs".
Scent of ripped black jeans is "The jeans have the typical faintly musky scent of pants that have been worn a few days. But surely they're clean enough to wear another week or two at least...".

ripped blue jeans is a grab object.
ripped blue jeans is equipment.
It is not temporary.
Plural of ripped blue jeans is true.
Taur-compatible of ripped blue jeans is false.
Size of ripped blue jeans is 3.
AC of ripped blue jeans is 0.
Effectiveness of ripped blue jeans is 0.
GA of ripped blue jeans is 0.
Traits of ripped blue jeans is {"rebellious"}.
Placement of ripped blue jeans is "body".
Descmod of ripped blue jeans is "A pair of blue ripped and torn jeans cover your hips and legs. Even though they have holes, wearing them gives you a somewhat protected feeling.".
Slot of ripped blue jeans is "legs".
Scent of ripped blue jeans is "The jeans have the typical faintly musky scent of pants that have been worn a few days. But surely they're clean enough to wear another week or two at least...".

Part 4 - Skinny Jeans

Table of Game Objects (continued)
name	desc	weight	object
"black skinny jeans"	"A pair of black jeans made from thin and fairly flexible material. They look like they'd be snug just about everywhere on any person that can wiggle their way into such a tight garment. Judging by the pants['] appearance, it's [']unisex['] and pretty [']cool['] looking."	1	black skinny jeans
"light-blue skinny jeans"	"A pair of light-blue jeans made from thin and fairly flexible material. They look like they'd be snug just about everywhere on any person that can wiggle their way into such a tight garment. Judging by the pants['] appearance, it's [']unisex['] and pretty [']cool['] looking."	1	light-blue skinny jeans

black skinny jeans is a grab object.
black skinny jeans is equipment.
It is not temporary.
Plural of black skinny jeans is true.
Taur-compatible of black skinny jeans is false.
Size of black skinny jeans is 3.
AC of black skinny jeans is 0.
Effectiveness of black skinny jeans is 0.
GA of black skinny jeans is 0.
Traits of black skinny jeans is {"cool"}.
Placement of black skinny jeans is "body".
Descmod of black skinny jeans is "A pair of black jeans cover your hips and legs. They look almost painted onto you, with stretchy fabric that follows every last curve of your legs and hips.".
Slot of black skinny jeans is "legs".
Scent of black skinny jeans is "The jeans have the typical faintly musky scent of pants that have been worn a few days. But surely they're clean enough to wear another week or two at least...".

light-blue skinny jeans is a grab object.
light-blue skinny jeans is equipment.
It is not temporary.
Plural of light-blue skinny jeans is true.
Taur-compatible of light-blue skinny jeans is false.
Size of light-blue skinny jeans is 3.
AC of light-blue skinny jeans is 0.
Effectiveness of light-blue skinny jeans is 0.
GA of light-blue skinny jeans is 0.
Traits of light-blue skinny jeans is {"cool"}.
Placement of light-blue skinny jeans is "body".
Descmod of light-blue skinny jeans is "A pair of light-blue jeans cover your hips and legs. They look almost painted onto you, with stretchy fabric that follows every last curve of your legs and hips.".
Slot of light-blue skinny jeans is "legs".
Scent of light-blue skinny jeans is "The jeans have the typical faintly musky scent of pants that have been worn a few days. But surely they're clean enough to wear another week or two at least...".


Part 5 - Hot Pants

Table of Game Objects (continued)
name	desc	weight	object
"scarlet hot pants"	"A pair of glittering scarlet hot pants, barely long enough to cover someone's thighs even to about a third. Judging by the tight garment's appearance, it's [']feminine['] and pretty [']sexy['], but possibly something a bimbo would be interested in."	1	scarlet hot pants
"emerald hot pants"	"A pair of glittering emerald hot pants, barely long enough to cover someone's thighs even to about a third. Judging by the tight garment's appearance, it's [']feminine['] and pretty [']sexy['], but possibly something a bimbo would be interested in."	1	emerald hot pants
"amethyst hot pants"	"A pair of glittering amethyst hot pants, barely long enough to cover someone's thighs even to about a third. Judging by the tight garment's appearance, it's [']feminine['] and pretty [']sexy['], but possibly something a bimbo would be interested in."	1	amethyst hot pants

scarlet hot pants is a grab object.
scarlet hot pants is equipment.
It is not temporary.
Plural of scarlet hot pants is true.
Taur-compatible of scarlet hot pants is false.
Size of scarlet hot pants is 3.
AC of scarlet hot pants is 0.
Effectiveness of scarlet hot pants is 0.
GA of scarlet hot pants is -1.
Traits of scarlet hot pants is {"sexy", "bimbo"}. [Note: maybe add slutty and bimbo/himbo]
Placement of scarlet hot pants is "body".
Descmod of scarlet hot pants is "A pair of glittering scarlet hot pants cover your hips and legs. They are really skimpy, barely covering a third of your thighs. If they were any tighter, you could call them underwear.".
Slot of scarlet hot pants is "legs".
Scent of scarlet hot pants is "The pants have the typical faintly musky scent of clothing that has been worn a few days. But surely they're clean enough to wear another week or two at least...".

emerald hot pants is a grab object.
emerald hot pants is equipment.
It is not temporary.
Plural of emerald hot pants is true.
Taur-compatible of emerald hot pants is false.
Size of emerald hot pants is 3.
AC of emerald hot pants is 0.
Effectiveness of emerald hot pants is 0.
GA of emerald hot pants is -1.
Traits of emerald hot pants is {"sexy", "bimbo"}. [Note: maybe add slutty and bimbo/himbo]
Placement of emerald hot pants is "body".
Descmod of emerald hot pants is "A pair of glittering emerald hot pants cover your hips and legs. They are really skimpy, barely covering a third of your thighs. If they were any tighter, you could call them underwear.".
Slot of emerald hot pants is "legs".
Scent of emerald hot pants is "The pants have the typical faintly musky scent of clothing that has been worn a few days. But surely they're clean enough to wear another week or two at least...".

amethyst hot pants is a grab object.
amethyst hot pants is equipment.
It is not temporary.
Plural of amethyst hot pants is true.
Taur-compatible of amethyst hot pants is false.
Size of amethyst hot pants is 3.
AC of amethyst hot pants is 0.
Effectiveness of amethyst hot pants is 0.
GA of amethyst hot pants is -1.
Traits of amethyst hot pants is {"sexy", "bimbo"}. [Note: maybe add slutty and bimbo/himbo]
Placement of amethyst hot pants is "body".
Descmod of amethyst hot pants is "A pair of glittering amethyst hot pants cover your hips and legs. They are really skimpy, barely covering a third of your thighs. If they were any tighter, you could call them underwear.".
Slot of amethyst hot pants is "legs".
Scent of amethyst hot pants is "The pants have the typical faintly musky scent of clothing that has been worn a few days. But surely they're clean enough to wear another week or two at least...".

Part 6 - Camo Pants

Table of Game Objects (continued) [These need to be altered as army pants since camo pants can be bought and worn by anyone]
name	desc	weight	object
"green camo pants"	"A pair of camo pants in various shades of green. Judging by the pants['] appearance, it's [']masculine['] and pretty [']cool['] looking."	1	green camo pants
"green army camo pants"	"A pair of army camo pants in various shades of green. Clearly, these belong to the uniform of a soldier of the US army. Judging by the pants['] appearance, it's [']unisex['] and pretty [']authoritive['] looking."	1	green army camo pants

green camo pants is a grab object.
green camo pants is equipment.
It is not temporary.
Plural of green camo pants is true.
Taur-compatible of green camo pants is false.
Size of green camo pants is 3.
AC of green camo pants is 0.
Effectiveness of green camo pants is 0.
GA of green camo pants is 1.
Traits of green camo pants is {"cool"}.
Placement of green camo pants is "body".
Descmod of green camo pants is "A pair of green camo pants covers your hips and legs. The sturdy fabric gives you a well-protected feeling.".
Slot of green camo pants is "legs".
Scent of green camo pants is "The pants have the typical faintly musky scent of clothing that has been worn a few days. But surely they're clean enough to wear another week or two at least...".

green army camo pants is a grab object.
green army camo pants is equipment.
It is not temporary.
Plural of green army camo pants is true.
Taur-compatible of green army camo pants is false.
Size of green army camo pants is 3.
AC of green army camo pants is 0.
Effectiveness of green army camo pants is 0.
GA of green army camo pants is 0.
Traits of green army camo pants is {"authoritive"}.
Placement of green army camo pants is "body".
Descmod of green army camo pants is "A pair of green army camo pants covers your hips and legs. The sturdy fabric gives you a well-protected feeling.".
Slot of green army camo pants is "legs".
Scent of green army camo pants is "The pants have the typical faintly musky scent of clothing that has been worn a few days. But surely they're clean enough to wear another week or two at least...".

Part 7 - Jogging Pants

Table of Game Objects (continued)
name	desc	weight	object
"black jogging pants"	"A pair of black jogging pants made from fairly soft and stretchy fabric. Judging by the pants['] appearance, it's [']unisex['] and pretty [']sporty['] looking."	1	black jogging pants
"pink jogging pants"	"A pair of pink jogging pants made from fairly soft and stretchy fabric, it also has swirling hearts across the material. Judging by the pants['] appearance, it's [']feminine['] and pretty [']sporty['] looking."	1	pink jogging pants

black jogging pants is a grab object.
black jogging pants is equipment.
It is not temporary.
Plural of black jogging pants is true.
Taur-compatible of black jogging pants is false.
Size of black jogging pants is 3.
AC of black jogging pants is 0.
Effectiveness of black jogging pants is 0.
GA of black jogging pants is 0.
Traits of black jogging pants is {"sporty"}.
Placement of black jogging pants is "body".
Descmod of black jogging pants is "A pair of black jogging pants cover your hips and legs. They are fairly light and soft, but you worry how long they'll last given the regular fights you can get into.".
Slot of black jogging pants is "legs".
Scent of black jogging pants is "The pants have the typical faintly musky scent of clothing that has been worn a few days. But surely they're clean enough to wear another week or two at least...".

pink jogging pants is a grab object.
pink jogging pants is equipment.
It is not temporary.
Plural of pink jogging pants is true.
Taur-compatible of pink jogging pants is false.
Size of pink jogging pants is 3.
AC of pink jogging pants is 0.
Effectiveness of pink jogging pants is 0.
GA of pink jogging pants is -1.
Traits of pink jogging pants is {"sporty"}.
Placement of pink jogging pants is "body".
Descmod of pink jogging pants is "A pair of pink jogging pants with swirling hearts cover your hips and legs. They are fairly light and soft, but you worry how long they'll last given the regular fights you can get into.".
Slot of pink jogging pants is "legs".
Scent of pink jogging pants is "The pants have the typical faintly musky scent of clothing that has been worn a few days. But surely they're clean enough to wear another week or two at least...".

Part 8 - Bermuda Shorts

Table of Game Objects (continued)
name	desc	weight	object
"beige bermuda shorts"	"A pair of wide beige shorts. They look fitting to be worn by a tourist or vacationer. Judging by the shorts['] appearance, it's [']unisex['] and pretty [']basic['] looking."	1	 beige bermuda shorts
"flowered bermuda shorts"	"A pair of wide shorts covered in patterns of leaves and bright flowers. They look fitting to be worn by a tourist or vacationer. Judging by the shorts['] appearance, it's [']feminine['] and pretty [']basic['] looking."	1	 flowered bermuda shorts

beige bermuda shorts is a grab object.
beige bermuda shorts is equipment.
It is not temporary.
Plural of beige bermuda shorts is true.
Taur-compatible of beige bermuda shorts is false.
Size of beige bermuda shorts is 3.
AC of beige bermuda shorts is 0.
Effectiveness of beige bermuda shorts is 0.
GA of beige bermuda shorts is 0.
Traits of beige bermuda shorts is {"basic"}.
Placement of beige bermuda shorts is "body".
Descmod of beige bermuda shorts is "A pair of beige bermuda shorts cover your hips and legs. With their simple and dulled down colors you will have a better chance of fading into the background.".
Slot of beige bermuda shorts is "legs".
Scent of beige bermuda shorts is "The shorts have the typical faintly musky scent of clothing that has been worn a few days. But surely they're clean enough to wear another week or two at least...".

flowered bermuda shorts is a grab object.
flowered bermuda shorts is equipment.
It is not temporary.
Plural of flowered bermuda shorts is true.
Taur-compatible of flowered bermuda shorts is false.
Size of flowered bermuda shorts is 3.
AC of flowered bermuda shorts is 0.
Effectiveness of flowered bermuda shorts is 0.
GA of flowered bermuda shorts is -1.
Traits of flowered bermuda shorts is {"basic"}.
Placement of flowered bermuda shorts is "body".
Descmod of flowered bermuda shorts is "A pair of colorful flowered bermuda shorts cover your hips and legs. With their bright and colorful patterns, they'll surely draw attention to you.".
Slot of flowered bermuda shorts is "legs".
Scent of flowered bermuda shorts is "The shorts have the typical faintly musky scent of clothing that has been worn a few days. But surely they're clean enough to wear another week or two at least...".

Part 9 - Shorts

Table of Game Objects (continued)
name	desc	weight	object
"striped board shorts"	"A pair of striped board shorts. They have three broad stripes that are red, white, and beige. Judging by the appearance of the shorts, they're [']masculine['] and pretty [']sporty['] looking."	1	striped board shorts

striped board shorts is a grab object.
striped board shorts is equipment.
It is not temporary.
Plural of striped board shorts is true.
Taur-compatible of striped board shorts is false.
Size of striped board shorts is 3.
AC of striped board shorts is 0.
Effectiveness of striped board shorts is 0.
GA of striped board shorts is 0.
Traits of striped board shorts is {"sporty"}.
Placement of striped board shorts is "body".
Descmod of striped board shorts is "A pair of striped board shorts cover your hips and thighs. They have three broad stripes that are red, white, and beige.".
Slot of striped board shorts is "legs".
Scent of striped board shorts is "The shorts smell faintly of the ocean.".

Section 15 - Skirts

Part 1 - Miniskirts

Table of Game Objects (continued)
name	desc	weight	object
"black miniskirt"	"A simple black miniskirt, barely long enough to cover someone's thighs even halfway. Judging by the skirt's appearance, it's [']feminine['] and pretty [']sexy['] and [']slutty['] looking."	1	black miniskirt
"pink miniskirt"	"A simple pink miniskirt, barely long enough to cover someone's thighs even halfway. Judging by the skirt's appearance, it's [']feminine['] and pretty [']basic['] and [']slutty['] looking."	1	pink miniskirt

black miniskirt is a grab object.
black miniskirt is equipment.
It is not temporary.
Plural of black miniskirt is false.
Taur-compatible of black miniskirt is false.
Size of black miniskirt is 3.
AC of black miniskirt is 0.
Effectiveness of black miniskirt is 0.
GA of black miniskirt is -1.
Traits of black miniskirt is {"slutty", "sexy"}.
Placement of black miniskirt is "body".
Descmod of black miniskirt is "A simple black miniskirt covers your hips and legs. It is really quite easy to accidentally (or on purpose) expose yourself while wearing it.".
Slot of black miniskirt is "legs".
Scent of black miniskirt is "The skirt has the typical faintly musky scent of clothing that has been worn a few days. But surely it is clean enough to wear another week or two at least...".

pink miniskirt is a grab object.
pink miniskirt is equipment.
It is not temporary.
Plural of pink miniskirt is false.
Taur-compatible of pink miniskirt is false.
Size of pink miniskirt is 3.
AC of pink miniskirt is 0.
Effectiveness of pink miniskirt is 0.
GA of pink miniskirt is -1.
Traits of pink miniskirt is {"slutty", "sexy"}.
Placement of pink miniskirt is "body".
Descmod of pink miniskirt is "A simple pink miniskirt covers your hips and legs. It is really quite easy to accidentally (or on purpose) expose yourself while wearing it.".
Slot of pink miniskirt is "legs".
Scent of pink miniskirt is "The skirt has the typical faintly musky scent of clothing that has been worn a few days. But surely it is clean enough to wear another week or two at least...".

Part 2 - Pencil Skirts

Table of Game Objects (continued)
name	desc	weight	object
"light-blue pencil skirt"	"A light-blue pencil skirt, long enough to cover an average person's whole thighs, down to the knees. Judging by the skirt's appearance, it's [']feminine['] and pretty [']stylish['] looking."	1	light-blue pencil skirt

light-blue pencil skirt is a grab object.
light-blue pencil skirt is equipment.
It is not temporary.
Plural of light-blue pencil skirt is false.
Taur-compatible of light-blue pencil skirt is false.
Size of light-blue pencil skirt is 3.
AC of light-blue pencil skirt is 0.
Effectiveness of light-blue pencil skirt is 0.
GA of light-blue pencil skirt is -1.
Traits of light-blue pencil skirt is {"stylish"}.
Placement of light-blue pencil skirt is "body".
Descmod of light-blue pencil skirt is "A light-blue pencil skirt covers your hips and legs. It is long and narrow, giving you a slim look.".
Slot of light-blue pencil skirt is "legs".
Scent of light-blue pencil skirt is "The skirt has the typical faintly musky scent of clothing that has been worn a few days. But surely it is clean enough to wear another week or two at least...".

Part 3 - Gypsy Skirts

Table of Game Objects (continued)
name	desc	weight	object
"gypsy floral skirt"	"A light full-length skirt, covered with a floral print that depicts cherry blossoms. Judging by the skirt's appearance, it's [']feminine['] and pretty [']sexy['] looking."	1	gypsy floral skirt

gypsy floral skirt is a grab object.
gypsy floral skirt is equipment.
It is not temporary.
Plural of gypsy floral skirt is false.
Taur-compatible of gypsy floral skirt is false.
Size of gypsy floral skirt is 3.
AC of gypsy floral skirt is 0.
Effectiveness of gypsy floral skirt is 0.
GA of gypsy floral skirt is -1.
Traits of gypsy floral skirt is {"sexy"}.
Placement of gypsy floral skirt is "body".
Descmod of gypsy floral skirt is "A light floor length skirt covers your hips and legs. It is covered in a floral pattern that depics cherry blossoms.".
Slot of gypsy floral skirt is "legs".
Scent of gypsy floral skirt is "The skirt has the typical faintly musky scent of clothing that has been worn a few days. But surely it is clean enough to wear another week or two at least...".

Section 16 - Underwear

Part 1 - Briefs

Table of Game Objects (continued)
name	desc	weight	object
"white briefs"	"A pair of tight white briefs. Simple, yet functional. Judging by the appearance of the underwear, it's [']masculine['] and pretty [']basic['] looking."	0	white briefs

white briefs is a grab object.
white briefs is equipment.
It is not temporary.
Plural of white briefs is true.
Taur-compatible of white briefs is false.
Size of white briefs is 3.
AC of white briefs is 0.
Effectiveness of white briefs is 0.
GA of white briefs is 1.
Traits of white briefs is {"basic"}.
Placement of white briefs is "body".
Descmod of white briefs is "A pair of tight white briefs cover your crotch.".
Slot of white briefs is "crotch".
Scent of white briefs is "Smells a little bit musky. Apparently the underwear has been worn before, but is fairly clean.".

Part 2 - Boxers

[Table of Game Objects (continued)
name	desc	weight	object
]
Part 3 - Boxer Briefs

Table of Game Objects (continued)
name	desc	weight	object
"black boxer briefs"	"A pair of black boxer briefs with a gray band of elastic at the top. Simple, yet functional. Judging by the appearance of the underwear, it's [']masculine['] and pretty [']basic['] looking."	0	boxer briefs

black boxer briefs is a grab object.
black boxer briefs is equipment.
It is not temporary.
Plural of black boxer briefs is true.
Taur-compatible of black boxer briefs is false.
Size of black boxer briefs is 3.
AC of black boxer briefs is 0.
Effectiveness of black boxer briefs is 0.
GA of black boxer briefs is 1.
Traits of black boxer briefs is {"basic"}.
Placement of black boxer briefs is "body".
Descmod of black boxer briefs is "A pair of black boxer briefs cover your crotch.".
Slot of black boxer briefs is "crotch".
Scent of black boxer briefs is "Smells a little bit musky. Apparently the underwear has been worn before, but is fairly clean.".

Part 4 - Thongs

[Table of Game Objects (continued)
name	desc	weight	object
]
Part 5 - G-strings

[Table of Game Objects (continued)
name	desc	weight	object
]
Part 6 - Panties

Table of Game Objects (continued)
name	desc	weight	object
"pink panties"	"A pair of pink panties with frilly edges. Judging by the appearance of the underwear, it's [']feminine['] and pretty [']basic['] looking."	0	pink panties

pink panties is a grab object.
pink panties is equipment.
It is not temporary.
Plural of pink panties is true.
Taur-compatible of pink panties is false.
Size of pink panties is 3.
AC of pink panties is 0.
Effectiveness of pink panties is 0.
GA of pink panties is -1.
Traits of pink panties is {"basic"}.
Placement of pink panties is "body".
Descmod of pink panties is "A frilly pair of pink panties cover your crotch.".
Slot of pink panties is "crotch".
Scent of pink panties is "Smells a little bit musky. Apparently the underwear has been worn before, but is fairly clean.".

Part 7 - Loinclothes

Table of Game Objects (continued)
name	desc	weight	object
"orc loincloth"	"A ragged piece of brown fabric that belonged to one of the traveling orcs of the city. Judging by the appearance of the loincloth, it's [']masculine['] and pretty [']sexy['] and [']violent[']looking."	0	orc loincloth
"ragged brown loincloth"	"A ragged piece of brown fabric that one can tie around their hips to cover the bare essentials. Judging by the appearance of the loincloth, it's [']masculine['] and pretty [']sexy['] looking."	0	ragged brown loincloth
"simple white loincloth"	"A simple white cotton loincloth. One can tie it around their hips to cover the bare essentials. Judging by the appearance of the loincloth, it's [']masculine['] and pretty [']sexy['] looking."	0	simple white loincloth

orc loincloth is a grab object.
orc loincloth is equipment.
It is not temporary.
Plural of orc loincloth is false.
Taur-compatible of orc loincloth is false.
Size of orc loincloth is 3.
AC of orc loincloth is 0.
Effectiveness of orc loincloth is 0.
GA of orc loincloth is 1.
Traits of orc loincloth is {"violent", "sexy"}.
Placement of orc loincloth is "body".
Descmod of orc loincloth is "An orc loincloth barely covers your crotch. It is fairly easy to expose yourself with the wrong (or right?) move.".
Slot of orc loincloth is "crotch".
Scent of orc loincloth is "The cloth has the scent of manly musk clinging to it. Just breathing in with it under your nose makes you think of orcs.".

An everyturn rule:
	if orc loincloth is equipped:
		if Player is male and (("Modest Organs" is not listed in feats of Player and Cock Length of Player < 14) or Cock Length of Player < 8) and a random chance of 1 in 3 succeeds:
			say "You feel yourself getting slightly hard under the short loincloth, showing a semi-erect bulge to the world. Seems like it's bigger than before too.";
			increase Cock Length of Player by 1;
			follow the cock descr rule;
		else if Player is male and Ball Size of Player < 4 and a random chance of 1 in 5 succeeds:
			say "Your balls throb and seem to grow a little.";
			BallsGrow Player by 1;
			if "Modest Organs" is not listed in feats of Player or Cock Length of Player < 8:
				increase Cock Length of Player by 1;
			follow the cock descr rule;
		if a random chance of 1 in 2 succeeds:
			say "[bold type]Your skin tingles a little bit where it touches the orc loincloth.[roman type][line break]";
			infect "Orc Warrior";

ragged brown loincloth is a grab object.
ragged brown loincloth is equipment.
It is not temporary.
Plural of ragged brown loincloth is false.
Taur-compatible of ragged brown loincloth is false.
Size of ragged brown loincloth is 3.
AC of ragged brown loincloth is 0.
Effectiveness of ragged brown loincloth is 0.
GA of ragged brown loincloth is 1.
Traits of ragged brown loincloth is {"sexy"}.
Placement of ragged brown loincloth is "body".
Descmod of ragged brown loincloth is "A ragged brown loincloth barely covers your crotch. It is fairly easy to expose yourself with the wrong (or right?) move.".
Slot of ragged brown loincloth is "crotch".
Scent of ragged brown loincloth is "Smells a little bit musky. Apparently the loincloth has been worn before, but is fairly clean.".

simple white loincloth is a grab object.
simple white loincloth is equipment.
It is not temporary.
Plural of simple white loincloth is false.
Taur-compatible of simple white loincloth is false.
Size of simple white loincloth is 3.
AC of simple white loincloth is 0.
Effectiveness of simple white loincloth is 0.
GA of simple white loincloth is 1.
Traits of simple white loincloth is {"sexy"}.
Placement of simple white loincloth is "body".
Descmod of simple white loincloth is "A simple white loincloth is tied around your crotch.".
Slot of simple white loincloth is "crotch".
Scent of simple white loincloth is "Smells a little bit musky. Apparently the loincloth has been worn before, but is fairly clean.".

Part 8 - Jockstraps

Table of Game Objects (continued)
name	desc	weight	object
"orange jockstrap"	"A jockstrap in bright orange, clearly made for people who do not mind showing off quite a bit. Judging by the appearance of the jockstrap, it's [']masculine['] and pretty [']sexy['] while [']sporty['] looking."	0	orange jockstrap

orange jockstrap is a grab object.
orange jockstrap is equipment.
It is not temporary.
Plural of orange jockstrap is false.
Taur-compatible of orange jockstrap is false.
Size of orange jockstrap is 3.
AC of orange jockstrap is 0.
Effectiveness of orange jockstrap is 0.
GA of orange jockstrap is 1.
Traits of orange jockstrap is {"sexy", "sporty"}.
Placement of orange jockstrap is "body".
Descmod of orange jockstrap is "An orange jockstrap covers your crotch while leaving your ass bare. This makes you feel somewhat exposed, yet at the same time you can't help but want to show off.".
Slot of orange jockstrap is "crotch".
Scent of orange jockstrap is "Smells a little bit musky. Apparently the underwear has been worn before, but is fairly clean.".

Part 9 - Mesh Briefs

Table of Game Objects (continued)
name	desc	weight	object
"black mesh briefs"	"Briefs made of sheer black mesh. You can literally see right through it. Judging by the appearance of the briefs, it's [']masculine['] and pretty [']sexy['] looking."	0	black mesh briefs

black mesh briefs is a grab object.
black mesh briefs is equipment.
It is not temporary.
Plural of black mesh briefs is true.
Taur-compatible of black mesh briefs is false.
Size of black mesh briefs is 3.
AC of black mesh briefs is 0.
Effectiveness of black mesh briefs is 0.
GA of black mesh briefs is 1.
Traits of black mesh briefs is {"sexy"}.
Placement of black mesh briefs is "body".
Descmod of black mesh briefs is "A pair of black mesh briefs around your hips expose more than they conceal.".
Slot of black mesh briefs is "crotch".
Scent of black mesh briefs is "Smells a little bit musky. Apparently the underwear has been worn before, but is fairly clean.".

Part 10 - Mesh Panties

[Table of Game Objects (continued)
name	desc	weight	object
]

Section 17 - Cock Accessories

Section 18 - Cunt Accessories

Section 19 - Socks

Section 20 - Shoes

Part 1 - Sandals

Table of Game Objects (continued)
name	desc	weight	object
"brown leather sandals"	"A pair of brown leather sandals. They have a number of straps that can be used to fasten them to your feet. Judging by the appearance of the sandals, it's [']unisex['] and pretty [']basic['] looking."	1	brown leather sandals

brown leather sandals is a grab object.
brown leather sandals is equipment.
It is not temporary.
Plural of brown leather sandals is true.
Taur-compatible of brown leather sandals is false.
Size of brown leather sandals is 3.
AC of brown leather sandals is 0.
Effectiveness of brown leather sandals is 0.
GA of brown leather sandals is 0.
Traits of brown leather sandals is {"basic"}.
Placement of brown leather sandals is "body".
Descmod of brown leather sandals is "Two brown leather sandals are strapped to your feet.".
Slot of brown leather sandals is "feet".
Scent of brown leather sandals is "The sandals smell like leather.".

Part 2 - Loafers


Table of Game Objects (continued)
name	desc	weight	object
"brown loafers"	"A pair of brown loafers. They look comfortable and one can just slide right in without having to worry about tying them. Judging by the appearance of the loafers, it's [']unisex['] and pretty [']basic['] looking."	1	brown loafers

brown loafers is a grab object.
brown loafers is equipment.
It is not temporary.
Plural of brown loafers is true.
Taur-compatible of brown loafers is false.
Size of brown loafers is 3.
AC of brown loafers is 0.
Effectiveness of brown loafers is 0.
GA of brown loafers is 0.
Traits of brown loafers is {"basic"}.
Placement of brown loafers is "body".
Descmod of brown loafers is "You are wearing comfortable brown loafers.".
Slot of brown loafers is "feet".
Scent of brown loafers is "The loafers smell like leather.".

Part 3 - Pumps

Table of Game Objects (continued)
name	desc	weight	object
"bright-red pumps"	"A pair of bright-red woman's pumps, with moderately high heels. Not exactly the best thing to run around wearing at top speed. Judging by the appearance of the heels, it's [']feminine['] and pretty [']stylish['] looking."	1	bright-red pumps

bright-red pumps is a grab object.
bright-red pumps is equipment.
It is not temporary.
Plural of bright-red pumps is true.
Taur-compatible of bright-red pumps is false.
Size of bright-red pumps is 3.
AC of bright-red pumps is 0.
Effectiveness of bright-red pumps is 0.
GA of bright-red pumps is -1.
Traits of bright-red pumps is {"stylish"}.
Placement of bright-red pumps is "body".
Descmod of bright-red pumps is "You are wearing two bright-red pumps. It won't be easy to run in these, but you sure look fabulous like this.".
Slot of bright-red pumps is "feet".
Scent of bright-red pumps is "The shoes smell a bit of laquer and plastic.".

Part 4 - Stiletto Heels

Table of Game Objects (continued)
name	desc	weight	object
"black stiletto heels"	"A pair of black slingbacks with very high heels, each shoe exposing your toes. Not exactly the best thing to run around wearing at top speed. Judging by the appearance of the heels, it's [']feminine['] and pretty [']sexy['] looking."	1	black stiletto heels

black stiletto heels is a grab object.
black stiletto heels is equipment.
It is not temporary.
Plural of black stiletto heels is true.
Taur-compatible of black stiletto heels is false.
Size of black stiletto heels is 3.
AC of black stiletto heels is 0.
Effectiveness of black stiletto heels is 0.
GA of black stiletto heels is -1.
Traits of black stiletto heels is {"sexy"}.
Placement of black stiletto heels is "body".
Descmod of black stiletto heels is "You are wearing two black stiletto heels. They're quite high with very narrow heels, but they do showcase your legs quite nicely.".
Slot of black stiletto heels is "feet".
Scent of black stiletto heels is "The shoes smell a bit of laquer and plastic.".

Part 5 - Running Shoes

Table of Game Objects (continued)
name	desc	weight	object
"blue running shoes"	"A pair of blue athlete's running shoes. They look new and are still bright and shiny. Judging by the appearance of the shoes, it's [']unisex['] and pretty [']sporty['] looking."	1	blue running shoes

blue running shoes is a grab object.
blue running shoes is equipment.
It is not temporary.
Plural of blue running shoes is true.
Taur-compatible of blue running shoes is false.
Size of blue running shoes is 3.
AC of blue running shoes is 0.
Effectiveness of blue running shoes is 0.
GA of blue running shoes is 0.
Traits of blue running shoes is {"sporty"}.
Placement of blue running shoes is "body".
Descmod of blue running shoes is "You are wearing fairly new blue running shoes. Just perfect to run with.".
Slot of blue running shoes is "feet".
Scent of blue running shoes is "The shoes smell like plastic and not much else. Good thing these are new.".

Book 3

[Try to let the player manipulate the 'black jeans' object when black ripped or skinny jeans are also owned. Only covers the main interaction types for items, which should be sufficient.]
Does the player mean grabbing black jeans when ripped black jeans are visible or black skinny jeans are visible: it is likely.	[get black jeans]

Does the player mean using black jeans when ripped black jeans are visible or black skinny jeans are visible: it is likely.	[use black jeans]
Does the player mean examining black jeans when ripped black jeans are visible or black skinny jeans are visible: it is likely.	[look black jeans]
Does the player mean sniffing black jeans when ripped black jeans are visible or black skinny jeans are visible: it is likely.	[smell black jeans]
Does the player mean littering black jeans when ripped black jeans are visible or black skinny jeans are visible: it is likely.	[drop black jeans]
Does the player mean burninating black jeans when ripped black jeans are visible or black skinny jeans are visible: it is likely.	[junk black jeans]

Does the player mean stashing black jeans when ripped black jeans are visible or black skinny jeans are visible: it is likely.	[stash black jeans]
Does the player mean retrieving black jeans when ripped black jeans are visible or black skinny jeans are visible: it is likely.	[retrieve black jeans]

Equipment ends here.
