Version 3 of Diego Events by Vinickus begins here.
[Version 1 - Transplanted two old events (originally written by Stripes) into a new file]
[Version 2 - Added College Flakes event]
[Version 3 - Added Spartan Usurpation event]
[Version 4 - Added One Fiery Trick event - Gherod]

Table of GameEventIDs (continued)
Object	Name
Trickster	"Trickster"

Trickster is a situation.
ResolveFunction of Trickster is "[ResolveEvent Trickster]". The level of Trickster is 4.
Sarea of Trickster is "Outside".
wolffight is a number that varies.
when play begins:
	add Trickster to BadSpots of FurryList;
	add Trickster to BadSpots of MaleList;
	add Trickster to BadSpots of FemaleList;

to say ResolveEvent Trickster:
	setmonster "Feral Wolf Male";
	say "     As you are traveling along, you spot some activity in the distance. At first, fearing that it is another band of monsters, you take cover. But a few moments later, you discover it to be a small team of soldiers moving stealthily through the city. They may be doing recon or on some other kind of mission, but you may be able to get assistance, or even be rescued by them. But even as you're walking up and trying to decide how best to approach them, you see a coyote [if Diegochanged is 0]man[else if Diegochanged is 1]herm[else]woman[end if] carrying a large sack dash into their midst[if PlayerMet of Diego is true and Diegochanged is 0]. You recognize Diego, the coyote trickster, and have to wonder what he is up to this time[else if PlayerMet of Diego is true]. You recognize Diego, the coyote trickster, and have to wonder what she is up to this time[end if][if Diegochanged is 0]. He[else]. She[end if] passes the bag quickly to a flabbergasted soldier with a quick 'Here, hold this' before continuing on with a happy chuckle.";
	say "     As the stunned soldiers watch the coyote run off in the direction of the city park and look at the mysterious sack, you hear some approaching howls. If you're going to get out of here, you'll have to do it right now.";
	say "     [bold type]Do you move to join the soldiers or run and hide to watch what happens?[roman type][line break]";
	LineBreak;
	say "     ([link]Y[as]y[end link]) - Stay.";
	say "     ([link]N[as]n[end link]) - Run.";
	if Player consents:
		say "     You dash up to the soldiers and pull out your weapon. Knowing your luck, trouble's on the way. You run up to the soldier left holding the bag. Your sudden appearance after the coyote's keeps him off guard long enough to pull the sack from him, finding it stuffed with gray fur inside. You barely have a chance to look up when a large pack of wolves come running around the corner, slamming into the unexpected team of soldiers. Several of the men are knocked down immediately.";
		let the bonus be (( Dexterity of Player minus 10 ) divided by 2);
		let the dice be a random number from 1 to 20;
		say "You roll 1d20([dice])+[bonus] -- [dice plus bonus] vs 15: ";
		if dice plus bonus > 15:
			say "     You toss the bag of fur in the face of one wolf about the slam into you. He has large sections of his pelt shaved off, exposing wide patches of pink skin. The bagged fur is sent flying, floating in the air all around the area. You cough and brush it out of your eyes in time to see another wolf moving in to attack you.";
		else:
			decrease HP of Player by 10;
			say "     You are slammed into by one of the wolves and knocked to the side, taking [special-style-2]10[roman type] damage. You can see as he continues past you that this wolf is the largest of them all and probably the pack alpha. He has large sections of his pelt poorly shaved off, exposing wide patches of pink skin. The bagged fur is sent flying, floating in the air all around the area. You cough and brush it out of your eyes as you get back to your feet in time to see another wolf moving in to attack you.";
		now wolffight is 3;
		challenge "Feral Wolf Male";
		if wolffight is 1:
			now wolffight is 3;
			say "     You manage to dispatch one of the wolves and look around, seeing several of the others dealing with the struggling soldiers. Some of the men have already been taken down, but others are still putting up a fight against the lupine pack that's suddenly surrounded them. You try to make your way free and charge a second wolf at the edge of the pack.";
			challenge "Feral Wolf Male";
			if wolffight is 1:
				now wolffight is 3;
				say "     Having beaten the second wolf, you find yourself at the edge of the fight start to move away. Most of the soldiers are down now, many of them pounced by the wolves. You can see several of the men being face-fucked or buggered by the feral wolf creatures. These soldiers are starting to show signs of transformation, gaining ears, tails, muzzles or fur. Before you can make a break for it, you are spotted by the wolfpack leader. Switching from standing upright onto all fours, the shaved wolf recognizes you as the one with the bag and growls. He leaps across some moaning piles of wolf and man to close on you to fight.";
				challenge "Alpha Wolf";
				if wolffight is 1:
					say "     Having beaten the pack alpha and sent him packing, the wolves['] assault on the few remaining soldiers wavers. With a howl from their leader, they snatch up the fallen, partially transformed soldiers and drag them off into the city. They'll be taking them back to their den to finish mating them until they're fully members of the pack. Too tired from the fight, you and the other soldiers are in no shape to give pursuit. As the last of the wolves are running off, you hear some distant laughter, probably from the coyote trickster who enjoyed the show while it lasted[if Park Entrance is unknown]. You may be able to track down the coyote if you can find a way to the Park Entrance[end if].";
					say "     The remaining soldiers thank you for the assistance. Because of the cloud of wolf fur, nearly all of them have picked up ears or tails, but their humanity is mostly intact thanks to your help. They'll have to scrub their recon mission and return to base. You're told they can't take you with them at this time, but they do give over some of their supplies, as they'll re-equip at the base earlier than planned. They keep their guns and ammo, but one of the few who remained fully unchanged passes you his combat knife with a silent nod. After packing the food and water away and strapping on the knife, you're given another round of thanks before they head off.";
					ItemGain food by 1;
					ItemGain water bottle by 1;
					ItemGain combat knife by 1;
					increase score by 20;
					now Resolution of Trickster is 1;		[Won against wolves]
		if wolffight is 3:
			say "     Deciding to give up on fighting entirely, you push your way free of the wild fight. You hop over one wolf who's mounted one poor soldier and are almost knocked down as your pursuer runs into a soldier getting up. Finding an [']eager volunteer['] for his cock, the wolf drives it into the soldier's mouth and starts pounding away. The wolves get the last of the soldiers as you're turning into an alleyway. You can hear the laughter of what is probably the coyote trickster, amused by the results of [if diegochanged is 0]his[else]her[end if] prank[if Park Entrance is unknown]. You may be able to track down the coyote if you can find a way to the Park Entrance[end if].";
			infect "Feral Wolf Male";
			now Resolution of Trickster is 2;		[Ran from wolves]
		if wolffight is 2:
			if Player is female:
				say "     Before you can get back up, you are mounted by one of the other wolves, moaning loudly as he drives his thick cock into you. He fucks you hard and fast, eager to fill you with cum and pups before moving on to another victim. His wild, feral rutting is a mix of pain and pleasure as that thick cock pumps in and out of your wet hole. 'Mmm... my bitch...' he rumbles softly, and you are surprised to hear one of the feral wolves speak. You respond to his words by pressing your ass back, moaning louder as he pounds into your abused pussy. Your excitement builds, finally peaking when he unleashes his hot, lupine seed into you with a howl[if Player is male]. Your cock throbs and sprays its load onto the pavement as you're stuffed full of creamy wolf cum[end if]. Withdrawing, he licks your cheek and growls softly before pouncing on a soldier, tearing away some partially shredded clothes to uncover a fresh pussy for him to fuck.";
				CreatureSexAftermath "Player" receives "PussyFuck" from "Feral Wolf Male";
			else:
				say "     Before you can get back up, you are pushed down by one of the other wolves. He pushes your clothes aside with his paws, scratching at your back with his claws, then growls and mounts you. You can feel his wet, sticky cock slide against your ass before finding your tight pucker and pushing it open. You moan loudly as he drives his thick cock into you. He fucks you hard and fast, eager to fill you with cum before moving on to another victim. His wild, feral rutting is a mix of pain and pleasure as that thick cock pumps in and out of your tight hole. 'Mmm... my bitch...' he rumbles softly, and you are surprised to hear one of the feral wolves speak. You respond to his words by pressing your ass back, moaning louder as he pounds into your abused asshole, pressing that lupine shaft against your prostate. Your excitement builds, finally peaking when he unleashes his hot, lupine seed into you with a howl. Your cock throbs and sprays its load onto the pavement as you're stuffed full of creamy wolf cum. Withdrawing, he licks your cheek and growls softly before pouncing on a soldier, tearing away some partially shredded clothes to uncover a fresh pussy for him to fuck.";
				CreatureSexAftermath "Player" receives "AssFuck" from "Feral Wolf Male";
			say "     Just as your head is starting to clear, another wolf moves up to you, sticky cock hanging under him. Seizing what may be your only opportunity to escape, you grab a fallen, half-transformed soldier beside you and press his growing muzzle onto the wolf's cock. He latches onto it hungrily and starts licking and sucking. Distracted, the wolf turns his attention on the changing soldier and thrusts into his muzzle. Crawling carefully past a few more distracted wolves, you make it to the edge of the orgy and dash into a nearby building. You rush out the back, having to leave the soldiers to their fate as bitches for a wolf pack - a fate you almost shared. As you run off, over the sounds of mating wolves, you catch the faint laughter of someone, probably the coyote trickster, enjoying the results of [if diegochanged is 0]his[else]her[end if] prank[if Park Entrance is unknown]. You may be able to track down the coyote if you can find a way to the Park Entrance[end if].";
			now Resolution of Trickster is 3;		[Lost to wolves]
			infect "Feral Wolf Male";
	else:
		say "     Turning tail before the coyote's trick is set off, you dash into a burned out shop and watch from there. The howls get louder and a pack of wolves come rushing around the corner, right into the soldiers. Several of the soldiers are bowled over as the wolves weren't expecting obstacles. At the head of the pack is a large wolf with large, poorly shaved patches his pelt, showing the pink skin beneath. The bag, sent flying by the collision, flips in the air and opens, spilling out what must be the shaved wolf's fur. Deciding that the soldiers must ultimately be responsible for his shaving, he and the other wolves attack.";
		say "     The soldiers, unprepared for such an assault, are soon borne down by the powerful wolves and wild rutting ensues. You watch as soldiers are forced to suck wolfcock or are buggered by the angry pack. The humans begin to transform, gaining fur, ears or tails as the lupine infection starts to spread. As some start to gain pussies, these new holes are stuffed full of wolfcock to breed pups in them. When the soldiers succumb enough to stop resisting, they are dragged off by the wolves, probably to their den to finish mating with them until they're fully members of the pack. The remaining wolves start sniffing around the area, spreading out. Worried they'll pick up the trail of your scent you think it best to make your escape. You slip out the back of the store and make a break for it, sure that you could hear some laughing in the distance[if Park Entrance is unknown]. You may be able to track down the coyote if you can find a way to the Park Entrance[end if].";
		increase score by 5;
		now Resolution of Trickster is 4;		[Did not engage wolves]
	now wolffight is 0;
	now Trickster is resolved;

[combat knife moved to Core Mechanics/Weapons.i7x]

Table of GameEventIDs (continued)
Object	Name
Prank Aftermath	"Prank Aftermath"

Prank Aftermath is a situation.
ResolveFunction of Prank Aftermath is "[ResolveEvent Prank Aftermath]". Prank Aftermath is inactive. The level of Prank Aftermath is 7.
Sarea of Prank Aftermath is "Outside".
when play begins:
	add Prank Aftermath to BadSpots of FurryList;
	add Prank Aftermath to badspots of HermList;

to say ResolveEvent Prank Aftermath:
	say "     As you travel through the city, you hear some moaning mewls coming from up ahead. On your guard, you sneak forward and take in the sight of several of those puma creatures playing with what was once a team of six soldiers. The cougars have the men pinned to the ground and are having their way with them. As you watch, the cougars force them to nurse from their breasts or suck their cocks until they develop a wet, new pussy for the herm kitties to fuck. Outnumbered, the soldiers have no chance to escape and there are several felines waiting for their turn to sate their lusts on the transforming humans.";
	say "     Not normally native to this part of the city, you start to wonder how such a large band of the felines got here when you spot one of them eating a large fish from a basket while she waits for her next turn with the new breedtoys. Remembering that you told Diego an idea you had about using fish to lure some of the felines around for a prank, it seems you've run into the aftermath of your idea";
	if Libido of Player - humanity of Player < -25:
		say ". Being too far gone into your lustful urges and the infection taking over, you feel some remorse for your actions, but are too aroused by what you see to do anything but watch.";
		SanLoss 10;
		decrease morale of Player by 5;
		increase Libido of Player by 20;
		if "Cold Fish" is listed in feats of Player, decrease Libido of Player by 5;
		if "Horny Bastard" is listed in feats of Player, increase Libido of Player by 5;
		if Libido of Player > 100, now Libido of Player is 100;
	else:
		say ". You find the sight strangely arousing, though your guilt over assisting in the infection of these soldiers does sadden you.";
		decrease humanity of Player by 2;
		decrease morale of Player by 25;
		increase Libido of Player by 8;
		if "Cold Fish" is listed in feats of Player, decrease Libido of Player by 2;
		if "Horny Bastard" is listed in feats of Player, increase Libido of Player by 2;
		if Libido of Player > 100, now Libido of Player is 100;
	WaitLineBreak;
	say "     As you watch, the last of the soldiers is made into a herm with a pair of swelling breasts on her chest and a pair of feline ears. She is pushed into the arms of two of her former teammates. Too far gone in their own infection, they push her onto all fours, one taking her virgin pussy with her feline cock and the other forces her cock into his mouth. As they fuck her, all three continue to change until they are full puma herms, fucking with mrowls of lustful delight. The former soldiers cum hard into their ex-teammate, filling her new pussy and feline muzzle with their hot cum. Watching this arousing show, you can't help but get turned on and start masturbating. As you climax, you groan loudly and cum hard, unable to stop yourself. But this doesn't go unheard and several of the powerful felines come after you. Having just cum, you barely manage to get yourself back on your feet and ready to fight by the time the first one reaches you.";
	LineBreak;
	challenge "Cougar";
	say "     Recovering from your encounter with the first feline, you try to get away, but have to deal with another who moves to bar your path.";
	LineBreak;
	challenge "Cougar";
	say "     With the second battle over, the other pumas move in to capture you. You manage to dive into a building and bar the door with a filing cabinet. As they pound at it, you find another exit from the building and weave through some side streets to make sure that you've lost the lustful felines.";
	now Prank Aftermath is resolved;

Table of GameEventIDs (continued)
Object	Name
Prankster's Delight	"Prankster's Delight"

Prankster's Delight is a situation.
ResolveFunction of Prankster's Delight is "[ResolveEvent Prankster's Delight]". The level of Prankster's Delight is 7.
Sarea of Prankster's Delight is "Outside".
when play begins:
	add Prankster's Delight to BadSpots of FurryList;
	add Prankster's Delight to Badspots of MaleList;

to say ResolveEvent Prankster's Delight:
	say "     It's just another walk through the desolate city. Chaos, moans, some scattered fires, nothing of interest comes about until you hear snickering off to the side. It appears to be coming from an alley up ahead, and as you get closer, you hear the snickering get louder and more familiar. However, just when you round the corner, the laughter stops, and nothing out of the ordinary catches your eye. Chalking it up to something best not messed with, you continue past the alley. Not ten minutes later there's a loud screech, and seconds after that you hear a cacophony of screaming metal and falling rubble. It takes a minute to pin down the exact street to run towards, but the shouts that soon start up help clue you in.";
	say "     When you get within a good distance to make out what's being yelled about, you perk your ears and hold steady, almost holding your breath as you try to hear exactly what's going on. 'Get this damn truck out of the way!' a gruff voice sounds out. 'With what, sir?!' The second voice sounds shaken, impatient and yet fearful. Whether the accident set him off, his CO, or something else, you can't be sure. Your best guess is that they may have been under a lot of strain and everything is slowly wearing them down. After you begin to relax and move closer, you hear a snickering, the exact same snickering from before: directly above your head. Glancing up you see the orange fur of some kind of canine, his tail flicking back and forth in what looks like amusement. It's hard to make out the rest the person, or even the face, but it's quite clear they're lithe with a bit of muscle.";
	say "     [if park entrance is unknown]Bewildered by the new appearance, you stay stock still to avoid attention[else]You sigh to yourself as you realize who the assailant is[end if].";
	WaitLineBreak;
	say "     With the snickering more or less identified, you manage to stay hidden from [if park entrance is unknown]the crazy entity[else]Diego[end if]. So with little else deterring you, it's quite easy to sneak around the edges of the building and make it within sight of the disturbance. You're currently behind the soldiers, and close to a burned-out car. It is but one of multiple strewn-about wrecks blocking the road. You'd no doubt make a lot of noise if you tried to get around or over all of it, so you simply huddle behind the car. With a good hiding place, and sightlines, you examine the scene more fully. There's a fire truck blocking the road beyond where you're at, probably a good thirty feet from the current blockage. Between you and the firetruck is a squad of ten male soldiers, their urban camo fatigues doing nothing to hide them as they pace back and forth. Eight of them are closer to you than the firetruck, while two examine the wreckage.";
	say "     'How the fuck did this even get here?' came the voice you figure is the CO. He sounds different now that he's not yelling himself hoarse, but he's still boisterous. The other man by him turns and starts talking, but it's hard to make out what he's saying, all you can tell is that he's quite an animated personality. Even without his voice, his posture and arms waving about give a good impression of his mood. Obviously tensions are running high, and the eight soldiers in the back are themselves looking quite beleaguered. Many pace about or simply lean against walls or in corners. You get ready to leave them to whatever their plans are, but as you step back, there's a sudden burst of motion off to the side.";
	WaitLineBreak;
	say "     As you glance towards it, you see nothing but a camo hat on the ground. However, as you think back, you could've sworn a soldier was there moments ago. You count out the numbers again, and realize there is in fact a missing soldier. Another burst of motion catches your attention, this time to the left, and once more all that's left is a camo hat. Whatever is happening, it seems like it's focusing on the soldiers nearest to walls. Maybe you should warn them, but then again you could just leave, or let the little devil in your ear lead the way: a few sexy men getting taken down could be fun to watch.";
	LineBreak;
	say "     [bold type]Do you leave, warn them, or stay quiet and watch what's going on?[roman type][line break]";
	say "     [link](1)[as]1[end link] - Leave.";
	say "     [link](2)[as]2[end link] - Yell out.";
	say "     [link](3)[as]3[end link] - Simply watch.";
	now calcnumber is 0;
	while calcnumber < 1 or calcnumber > 3:
		say "Choice? (1-3)>[run paragraph on]";
		get a number;
		if calcnumber is 1 or calcnumber is 2 or calcnumber is 3:
			break;
		else:
			say "Invalid choice. Type [link]1[end link] to Leave, [link]2[end link] to Yell out or [link]3[end link] to Simply watch.";
	if calcnumber is 1:
		LineBreak;
		say "     You take your time to back away, keeping sight-lines as a soldier disappears every few seconds. Soon you're around a corner and out of sight, giving you the chance to book it.";
		now Resolution of Prankster's Delight is 1; [Player ran away.]
	else if calcnumber is 2:
		LineBreak;
		say "     You yell out a warning, trying to give them a heads up that something is after them. They noticeably jump, turning and grabbing at the wall nearest them. The soldiers then all glance at each other and then back towards you. 'Where'd the equipment go!?' Their obvious anger forces you to back up, as the men seem eager to direct all of their substantial ire your way, at least before a yell breaks the tension: or redirects it. There were eight soldiers glaring you down seconds ago, but now there are only seven. The two who were yelling by the firetruck rush back to rejoin their squad. They all huddle up back-to-back as the CO looks your way. 'What is going on?' he questions. You only get a momentary second to shrug before he's yanked down into the ground, vanishing completely. Strangely, there aren't any holes or debris anywhere around where he was moments ago. Something is very twisted here.";
		say "     His second in command is yanked down next, and as soon as this happens, everything goes haywire. The remaining seven split apart and begin running in various directions. The ones farthest from you make a break for the firetruck, moving to clamber over it. As soon as one is almost up the side, a thin, bony hand shoots from the asphalt below and grabs his ankle. The others nearby try to kick at the arm, but there own assailants soon reveal themselves. More bony hands and insectoid-like appendages grip their ankles and wrists. They get yanked into the ground seconds later, leaving the man hanging onto the truck for dear life.";
		WaitLineBreak;
		say "     Looking for the other soldiers, you see them getting pulled into the walls by more bony and insect-like appendages. That leaves the last soldier dangling on the firetruck, hoping to get away. His arms clearly shake more and more as the moments tick by, and he's soon too weak to keep a grip, falling back into the hold of more appendages. They break his fall, but they also keep him above ground, not quite yanking him below yet. Various new arms and growths surface from the asphalt like it was merely a placid sea. These new ones seem to be covered in tiny little hairs and no visible hands, but soon they're slicing and flicking through the air all around the soldier, leaving him to struggle as an odd dance is carried out before you. Within seconds every scrap of clothing sheds from the man's form, leaving him in only his bare skin as those new appendages sink back into the earth. The original arms and hands still keep a grip on him though, and hold him a few feet off the ground.";
		say "     Soon you see new, long and slick looking lengths emerge from the asphalt. They each look rather... phallic, and they even throb in the open air. However, they appear different than even what's often seen around the city. The lengths look almost bony at first, but soon the top halves split like petals in the morning, revealing dozens of red beads clumped together in what can only be described as a mass of throbbing spheres. It all comes together to form a rather thick and bumpy looking structure, and you can only imagine what it'd feel like inside your [if player is male]ass[else if player is female]pussy[else]mouth[end if]. Each bead seems to be about the size of a large marble, and the width of the phallic things is at least three of the beads across. It's hard to tell the true length though, as there could always be more to be revealed under the rest of the boney structure. All you know is that the current revealed length could no doubt reach deep, deep inside one's body.";
		WaitLineBreak;
		say "     That's exactly what they do too, the red throbbing lengths angling at the man's mouth and ass, poking and prodding at each newfound entrance. They must be slick with some kind of lube, because the one between the solder's legs quickly slams forward, sinking half-a-dozen inches at once. The man quickly breaks after that, releasing screeching moans as he begins to gyrate his hips, helping to sink the weird phallus deeper into his ass. His tongue also reaches out to the length over his mouth, lapping at it like a man dying of thirst. All of the limbs shutter at once, like they're all one being. It takes no time at all for both phallic shapes to begin taking action, one sinking into the man's mouth and throat, as the other begins to push in and out of the soldier's ass. Another shudder goes through the limbs as you watch the two dick-like things pulse and throb. A thick, white substance bursts from the man's mouth as his head lulls, the same liquid dripping from between his legs as his stomach swells. This keeps going and going, and neither cock stops pushing in and out of the male's form. The hands grip tighter around his arms and legs as he convulses and shakes.";
		say "     It takes little time for you to see a meager stream of cum shooting up from around the man's waist. It's hard to tell entirely from where you are, but you're certain he's cumming what's left of his brains out. The limbs then begin to shrink, no, sink into the ground, dragging the soldier with them. Soon you only see the soldier's sweaty, cum slick chest, but moments later even that disappears beneath the asphalt. 'Well, that was fun,' came a voice above you. Glancing up there's nothing to see, but you have a feeling as to who, or what, it was.";
		now Resolution of Prankster's Delight is 2; [Player tried to warn the squad]
	else:
		LineBreak;
		say "     You watch as more and more soldiers disappear from view, soon leaving four soldiers and the two by the firetruck. The CO and his partner soon get yanked down as well. The only ones left glance back at where their superiors were, noticing nothing but camo hats. They split up and jump towards the walls, looking as if they were expecting to find something leaning against them. Each man glances around before bony hands and appendages burst from the walls like breaching whales. But these insect-like things don't immediately drag them from view. They hold them in place, the bony hands gripping tight to their squirming forms. Soon, insect-like lengths that are covered in tiny hairs slip from the walls, surrounding them, slashing and dancing through the air around the pinned soldiers. Your eyes are then met with the sight of the fatigues shedding off the men, the fabric completely shredded and falling to the ground below them.";
		say "     Each side of the area has two men held from the walls and off the ground, letting you glance right and left to see the nude backs of soldiers. Some of the arms split into almost prehensile fingers, gripping and spreading the ass of each man in view, giving you the full view of their twitching holes. Other arms soon appear and split open to reveal red throbbing beads inside, they look and throb like dicks, but are made up of clusters of red beads compacted into a solid shape. They almost look like anal beads glued together into a thick, long construct. The beads are each the size of large marbles, and each of the lengths are three of these beads across, at least. They hover in-front of each man's face, and even as the males seems to try to lean away, their holes twitch ever more. Your eyes then catch more movement in the middle of the area, right between the four men. A single hand emerges from the asphalt and points a finger at you before pointing at the men to each side of it. It appears to be making an offer.";
		say "     [bold type]Do you take this appendage up on its offer?[roman type][line break]";
		LineBreak;
		say "     ([link]Y[as]y[end link]) - You crawl across the car you've been hiding behind, giving a sly grin as you turn towards two of the men.";
		say "     ([link]N[as]n[end link]) - You shake your head in respectful refusal.";
		if player consents:
			if player is a male: [check for if the player has a cock to penetrate with.]
				LineBreak;
				say "     Standing behind the now nude soldiers really gets you going. Their fine, bubble butts are fully on display, and their winking holes draw you in. Your cock was already hard from the show before, but now you can't wait to sink it into one of these fine specimens of masculinity. Unable to decide, but growing lost to lust, you simply step forward and grind against the ass closest to you, hotdogging between his muscular cheeks. With things growing more and more slick down their, and the twitching hole making his need obvious, you find your tip pops in without any attempt by you. With this, you wrap your arms around your temporary mate, shoving balls-deep into him as he gasps out. His gasp lets the throbbing, red length before him pop into his mouth. This seems to make your fucking all the better as the flesh around your cock grips even tighter, drawing your needs to new heights as you begin to pull out to the tip.";
				say "     You then slam right back in, picking up into a rhythm of vigorous fucking. Your partner soon begins to grind back into your thrusts, begging for more with his muscular body. You try to focus on not cumming so quickly, but it's hard not to when faced with such an eager fuckpuppet, and such a hot one at that. Your efforts are short-lived however, as you feel your balls pull up and cock throb. You slam balls deep once more, holding your hips tight against the soldier's ass as you unload shot after shot of seed. Your cum fills him up enough to where it even begins to dribble out around your shaft. However, this isn't enough for you, and as he is yanked into the wall and off your cock, your eyes turn to his friend. His mouth is already filled with the phallic length before him, making his ass even easier to slip into. That, and all of the cum already caking your cock works as great lube.";
				WaitLineBreak;
				say "     You hump and pound into this man even harder than the last, your mind lost to the need to breed this eager soldier. It takes even less time for your needs to reach a peak. Your cock throbs and your hips slap into his ass a few more times before slapping and holding against his cheeks, unloading what feels like pints of cum. Once more the seed spills out of the hole and around your cock, making it easier for the body to be ripped away from you and into the wall. Hunching over, you realize how exhausted you are. Turning and glancing at where the other two were, you realize they're all gone now. Not even the weird disembodied limbs remain in your sight. Sliding down the wall you were just fucking the soldier's against, you rest for a few moments. Cries in the distance remind you that you have to keep moving though, drawing you to stand and return to your exploration.";
				now Resolution of Prankster's Delight is 3; [Player watched and partook]
			else:
				Linebreak;
				say "     You don't think you're quite equipped for this, so you watch as The hand slips back beneath the asphalt, the four men soon getting yanked into the walls and out of sight. 'Oh well,' a voice says from above. You glance up and see nothing, but are all too aware as to who, or what, it probably was. Straightening yourself up and making sure you're safe to move, you turn away from the pinned in alcove. You then head out and resume your exploration.";
				now Resolution of Prankster's Delight is 4; [Player watched but weren't equipped to partake]
		else:
			LineBreak;
			say "     The hand slips back beneath the asphalt, the four men soon getting yanked into the walls and out of sight. 'Oh well,' a voice says from above. You glance up and see nothing, but are all too aware as to who, or what, it probably was. Straightening yourself up and making sure you're safe to move, you turn away from the pinned in alcove. You then head out and resume your exploration.";
			now Resolution of Prankster's Delight is 5; [Player watched but turned down the offer]
	now Prankster's Delight is resolved;

Table of GameEventIDs (continued)
Object	Name
College Flakes	"College Flakes"

College Flakes is a situation.
ResolveFunction of College Flakes is "[ResolveEvent College Flakes]". The level of College Flakes is 7.
The sarea of College Flakes is "Outside".
when play begins:
	add College Flakes to BadSpots of FurryList;
	add College Flakes to Badspots of MaleList;
	add College Flakes to badspots of FemaleList;

to say ResolveEvent College Flakes:
	say "     As you once more journey about the collapsed society that is this city, you hear mumbling and hushed whispers. You can't tell the exact direction it's coming from, but as you continue on your path you find it's getting more discernible. You're eventually able to nail down the general street that the noises are originating from, giving you a chance to get close and find a hiding spot in a nearby alleyway. From your position you have a clear sightline right down a long, broad street. There's little debris or trashed cars along it, giving an unfettered view of the pristine, almost crimson buildings on each side of the asphalt path. It's from one of those big, red bricked buildings that the voices seem to be most concentrated. The building is only a dozen or so feet away, but given you know nothing about the source of the voices, you're not sure getting any closer would be a smart idea.";
	say "     At first it's hard to make anything out, at least anything distinct, but as the people talking step out in the open, you manage to catch a bit more. 'There's nothing to be done. We had to leave or we'd be caught up in whatever shit they were doing.' The first voice you can make out comes from an ebony skinned, broad shouldered man. He looks like a quintessential running back, and he's even wearing a varsity jacket to boot. With him are two blonde, pale skinned and skimpily dressed cheerleaders. Their shoulder-length hair is artfully ruffled, their breasts are perky and at least C cup in size, and their eyes are a striking blue. Their pale skin contrasts with the open, dark environment, and while the jock wears pants and a varsity jacket, the two women are wearing short, short skirts and shirts that barely cover their chests: revealing underboob for days. The skirts also leave almost nothing to the imagination, showing every bit of skin up to their asses.";
	WaitLineBreak;
	say "     The three of them look like college students, in both age and dress, but least they're not too cocky to go unarmed. The two blondes are carrying baseball bats at their sides, eyes focused. The jock carries a simple lead pipe instead, face slack as his back hunches in obvious fatigue. All three are obviously on edge, not much of a surprise, and the broad man seems to be constantly adjusting his grip on the metal pipe. His eyes betray his interests though, darting up and down the bodies of the women beside him. The crotch of his bluejeans stretching out in an obvious, significant bulge. You could swear you even see a wet spot spreading from there, leaving no doubt in your mind of how much the environment is getting to him. There's little hope for them long term resisting things, but it's interesting to see such untainted, or seemingly untainted, youths running about.";
	say "     Everything beyond their seeming normalcy is quite expected, even mundane given the current situation. As the silence grows stale, a loud crash draws your attention to the roof of the building they just left. 'Dammit. I thought he was down,' the jock spits out. 'I told you it was pointless,' came a reply from one of the cheerleaders. 'That's only because you're a horny bitch,' said the other blonde. This drew a shake of the head from the previous cheerleader. She'd obviously heard the same trite before, and had no interest in getting into a fight at that time. Still, she glanced back up at the building and looked almost forlorn in her gaze. 'There she goes again, fantasizing about some furry menace. Horny bitch.' This time the jock stepped in, standing fully between them and glancing from one to the other. 'You two done? That coyote-thing will be back after us soon.' All he got was a shake of the head from each woman. Resigning to a good enough expression, the jock begins to sneak along the building walls. His path will eventually take him right by your hiding spot, giving you a few choices about your next action.";
	LineBreak;
	say "     [bold type]Do you get involved in the situation, watch, or simply leave?[roman type][line break]";
	say "     [link](1)[as]1[end link] - Alert them to your location and wave them over to you.";
	say "     [link](2)[as]2[end link] - Stay hidden and watch what happens if you do nothing.";
	say "     [link](3)[as]3[end link] - Back away and down the alley to leave unseen.";
	now calcnumber is 0;
	while calcnumber < 1 or calcnumber > 3:
		say "Choice? (1-3)>[run paragraph on]";
		get a number;
		if calcnumber is 1 or calcnumber is 2 or calcnumber is 3:
			break;
		else:
			say "Invalid choice. Type [link]1[end link] to Alert them, [link]2[end link] to Watch or [link]3[end link] to Leave.";
	if calcnumber is 1:
		LineBreak;
		say "     Seeing them approach where you are, draws you to lean out and wave them over, ";
		if BodyName of player is "Human":
			say "they quickly move over to your location, sneaking into the alley as you let them move by you. The cheerleaders stop in-front of you and glance at each other before shrugging. They then move in to kiss your cheeks, one on each side. They're sloppy, wet kisses, and you could swear you feel a bit of tongue lapping over your skin. These two are most certainly becoming a bit changed by things: how much so is uncertain. As they pull back and you stare into their striking blue eyes, your concerns are erased. The jock looks confused as you glance over to him, but he quickly shrugs and moves away, followed by the two blondes";
		else:
			say "they hesitate, unsure of your motivations, but as more crashing can be heard from the building they left, that hesitation evaporates. Once the three are in the alley with you, the two women hesitate before kissing your face. The jock then looks a bit concerned before hussling away, quickly followed by the two cheerleaders. To avoid spooking them, you wait a bit before heading out yourself.";
		now resolution of College Flakes is 1; [Player helped them leave, but noticed something odd about the cheerleaders]
	else if calcnumber is 2:
		LineBreak;
		say "     Deciding to simply watch things unfold, you stay hidden and keep an eye on the trio. Soon you notice movement above, something jumping from roof to roof right above them. They don't look up, don't even seem to notice anything odd. The movement doesn't stop until it's a few buildings ahead of the college students' path. That's when you get a clear look at whoever, or whatever, has been pursuing these three survivors. An orange, anthro coyote stands right at the edge of the roof, and his hands are furiously moving back and forth on his crotch, fluids dribbling down from where he is and splattering on the sidewalk. The trio don't notice this until it's too late and the coyote arches his back, releasing a surge of cum all over the three from above. Confused and panicked, they look up, eyes no doubt wide as the coyote gives a toothy grin before disappearing. Well, [if park entrance is known]typical Diego[else]what a strange canine[end if].";
		say "     The three begin to run down the street in a tizzy, all ready to keep going until the jock hunches over, grabbing his stomach. The two cheerleaders stop moments later and do the same. Soon they're all leaning against a wall, groaning out in discomfort. 'So... hot,' the jock grunts out. 'Yeah,' the cheerleaders reply. You have a feeling on what's going on, but you still wait and see. The first change is the jock's new plan, he quickly removes his varsity jacket and undershirt, moving to take his jeans off next. The cheerleaders watch as he does this, bodies shaking before they glance at each other. The jock's shoes are in the way of him stripping, and he quickly rips them off, letting him remove his jeans and underwear moments after.";
		WaitLineBreak;
		say "     The now nude jock is built for days. His stomach is just a washboard of abs, an eight pack at least, and his chest is tight and built in the best of ways. His legs are defined with grooves and bulges of muscle. The man's arms are much the same as the muscles underneath twist and bulge out in his effort to keep himself under control. It's all in vein however, as he quickly moves on the cheerleaders, grabbing them and pulling them against his nude body. His lips press against their mouths when his tongue isn't lapping at them. For all the cheerleader's movements, not a single one looks like resistance. They wrap their arms around him and grind into his form, their hands slipping down and grabbing at his bubble butt as their groins grind against him.";
		say "     The ebony and pale skins of the three crash together in what could almost be seen as a work of art, their passions unleashing together. The jock is soon pushing them to their kness, offering up his cock as they grab his ass even tighter. Each of the women takes a side of the rod, licking up and down the length as the jock releases a sigh through gritted teeth. One of the cheerleaders then deepthroats his cock as the other moves down to his balls. The jock shoves his hips forward at this, his hands grabbing at the head of the one his dick is buried in, humping at her face as you see his ass clench. A strangled grunt escapes the man, and it's clear from the cheerleader's throat that he's cumming already. The man pulls out his still rock hard length, slapping his cock against the woman's exhausted face, giving the other cheerleader a chance to gobble him down. Much the same happens, him pulling out a few moments later still rock hard, and having deposited a load down the second cheerleaders throat.";
		if player is male and anallevel > 1:
			say "     [bold type]Do you try to get your own fun out of the coyote's mischief, or move on?[roman type][line break]";
			LineBreak;
			say "     ([link]Y[as]y[end link]) - Have your own fun with the jock and cheerleaders.";
			say "     ([link]N[as]n[end link]) - Move on";
			if player consents:
				LineBreak;
				say "     Stepping out of the alley, none of them notice you as you approach, your cock already at the ready.";
				if anallevel is 3:
					say "     You know just what to do to move things along as well. You step behind the jock as he trades who he facefucks, falling down to your knees. His ass is immaculately sculped, like that of a Michelangelo statue. The crack is smooth, hairless with a healthy glaze of sweat, and a scent of musky need. He's perfectly clean and free of any undesirable scents, all that's waiting for you is the smell of a man. As soon as your hands grip his ass, he jolts, turning his head to look down at you with wide eyes. 'W-what? Get..' That's all that he manages to utter out before his body shudders again, no doubt more cum pumped down a cheerleader's throat. With that distraction, you shove your face into his ass, jabbing your tongue into his hole and getting right to the tongue-fucking. The jock begins moaning in short order, even louder than before. You can feel each orgasm pulse through his anal muscles, and between his legs, as you keep up your vigorous rimming and tonguing. It's only after you've thoroughly salivated his hole that you lean back, kissing his ass once more before standing. Once you're standing fully behind the jock, you jab your dick at his hole, letting the distractions from his numerous orgasms help you penetrate his slick hole.";
				else:
					say "     Once you're standing fully behind the jock, you jab your dick at his hole, letting the distractions from his numerous orgasms help you penetrate his tight fuck-chute.";
				say "     You're soon taking this previously, no doubt, straight jock for a ride. Pounding at his ass like there's no tomorrow, leaving him nothing but a sloppy mess as the cheerleaders trade off who gets his next load. He had to have gone through at least a dozen orgasms by the time you were inside him, and now that you're fucking him, he's no doubt going through several more every minute. You can feel each pulse, each jerk and tightening of his sphincter, and it makes your pounding all the more fun. You doubt you will be able to last long with this kind of situation, and so move to pound your load as deep into him as you can. Slapping sounds fill the street as you pick up speed and slam your hips into his bubble butt with each thrust. It takes only a minute more before one loud slap sounds out. You're balls deep now, and your scrotum pulls up as you unload shot after shot of cum inside this bimboed jock.";
				WaitLineBreak;
				say "     Your erection doesn't die down even a bit, still throbbing within the tight ass you've marked as yours. However, your ideas of what to do next shift. You pull your cock from the jock, wiping your length off on his ass as your walk up beside him, patting him on his sweaty back and glancing down at the cheerleaders eager for his cock. Soon they're eager for yours as well, not even hesitating to swap between the two of you. Their mouths swap from ebony jock-cock, to your own [cock of player] one. There's not much like this: ass to ass with a sexy jock as two hot cheerleaders worship you both. You turn and forcefully make out with the man beside you, showing him who's boss as your load drips from his ass. You're soon grabbing the head of the cheerleader currently gagging on your cock, gyrating your hips as you begin to facefuck the eager slut. It takes little time to deposit your own cum into her stomach, adding to the no doubt copious amounts already there.";
				say "     Decidng to move things along to something more interesting, you pull out, splattering the last of your load all over her face. You then lift her up and spin her around, pressing her barely clothed breasts into a brick wall. Your hands stroke down her body, stopping at her hips and pulling them towards your crotch, grinding your cock against her clothed ass. With a flick of the hand, her short-shorts are halfway down her thighs, leaving her pussy and ass on full display. Looking to your left you see the jock is doing much the same. However, he's much further along, his cheerleader already breathlessly moaning as he slams balls deep. Not wanting to keep your own woman waiting, you slam into her slick pussy. Her walls clamp down on you, slightly delaying your penetration, but it does nothing to stop the last inches from slipping inside.";
				WaitLineBreak;
				say "     The pleasure and heat is far too intense to resist, and you're quickly pounding away at her tunnel, unable to control yourself: or even slow down. Your rapid thrusts leave her scraping against the wall, yanked back and forth as you vapidly pound at her breeding hole. She doesn't get fucked quietly either, her moans sounding out as you keep going harder and harder... and yet still harder. You're dripping with sweat within minutes, and your balls tighten seconds after that. Your cock begins to pulse inside her, and her own vagina begins to do the same. As soon as your first shot of cum fills her, she lets out a shriek, her pussy clamping down on your cock as you unload what feels like pints of cum inside her.";
				say "     You hear much the same going on beside you, and once your orgasm subsides, you glance over and watch that jock's ebony ass clench up as he unloads deep inside his friend. Slapping his ass, you give him a grin, both of you satisfied for once. The cheerleaders seem less so however, as when you both pull out, the women start making out, fingering the cum further inside each other as they press their barely clothed boobs together. You're quick to push the dazed jock to his knees, pressing your cock against his lips as he opens wide, sucking your length down his throat. Once your cum, and the pussy juice, are sucked clean off your cock, you let him back up.";
				WaitLineBreak;
				say "     You let them know there's a safe place for them to hold up and fuck all they want, and while they seem far less than capable of understanding much more than sex, they eagerly follow you back to the bunker[if park entrance is known]. You thank your stars for Diego as you lead them back[else]. That coyote is your new best friend[end if].";
				say "     AUTHOR'S NOTE: These three will likely be put in the bunker at a later time, for now I hope you enjoyed the event.";
				now resolution of College Flakes is 2; [Player used the college clique for his own fun and took them as his]
			else:
				LineBreak;
				say "     Deciding to move on, you turn and head down the alley you were hiding in, hearing the sounds of quickly escalating sex behind you.";
				now resolution of College Flakes is 4; [Player left the college flakes to their lusts and corruption]
		else:
			say "     Seeing all you needed to of the current situation, you head down the alley you were hiding in. You're quickly out in another street, the sounds of escalating sex still audible as you head on your way.";
			now resolution of College Flakes is 5; [Player wasn't properly equipped at the time]
	else:
		LineBreak;
		say "     Deciding not to get involved in whatever these college students got themselves into, you just head down the alley and to another street, hustling away as quickly as you can.";
		now resolution of College Flakes is 3; [Player left the area before anything happened]
	now College Flakes is resolved;

Table of GameEventIDs (continued)
Object	Name
Spartan Usurpation	"Spartan Usurpation"

Spartan Usurpation is a situation.
ResolveFunction of Spartan Usurpation is "[ResolveEvent Spartan Usurpation]". Spartan Usurpation is inactive. The level of Spartan Usurpation is 7.
The sarea of Spartan Usurpation is "Outside".
when play begins:
	add Spartan Usurpation to Badspots of MaleList;

to say ResolveEvent Spartan Usurpation:
	say "     The city is never short of the sound of moans, rubble clattering from buildings, or fiery combat. However, the sounds of metal clanging off metal is quite unusual, it's a sound that makes you feel as if you were thrown near a medieval battlefield. You are still surrounded by the ruins of a modern city, so curiosity drives you to check out the ruckus, and even though you're quick to check it all out, you're all too aware of the potential dangers. Your feet move carefully, and your legs, while fast, swivel about to avoid knocking anything over in the alleys you've chosen to run along. There's no telling what you'll come upon, and unwanted attention would spoil any chance of discovery. So you move with dedicated speed, and silent swiftness, until you find yourself coming upon an open street. There's nowhere to hide along it, and so you rush back to the alley you just ran from, peaking around the corner as you peer upon the battle before you.";
	say "     You can see the back of a squad of half-a-dozen camouflage donned men. They seem to be squaring off against unknown assailants, ones hard to make out with the soldiers between you. All you can easily tell is a splash of red here and there, as if capes are flapping about. However, that seems a big garish for this environment, so you settle on waiting to see what's really going on. It's clear there's a stalemate, and neither side is making a move. The soldiers are holding what look like large knives, each one almost the length of your forearm. No tarnishes are visible along the shiny blades, so they've no doubt been on the defensive. Though, their tattered clothing could've told you that. All of the camoed sleeves and pants are torn to shreads, revealing pretty much every inch of the soldiers' legs, thighs and arms. Thanks to the shredded clothing, you can easily tell that they're all wearing jockstraps, but even more surprising are the buttplugs.";
	WaitLineBreak;
	say "     Each man in the squad has a bejeweled plug sticking out of their holes. They're clearly wedged in thoroughly, because even with all of the sweat and movement, the buttplugs don't look to have moved even an inch out of those perfectly smooth, firm asses. This is no doubt causing the men no shortage of distractions, as several seem to reach back halfway before stopping themselves, as if they can't help but want to fiddle with the plug. The movement could be from a desire to ensure they're still in, or something more... lustful. In either case, this distraction is no doubt what leads to the next burst of motion. Whoever they're going against, this was their opportunity. Within moments, half the soldiers are disarmed, pinned to the ground by... red cape donned men. These aren't ordinary men either, as your mind can only conjure up images of ancient spartans, adonises of high renown. The soldiers never stood a chance, and as the rest of the squad is taken down, you can't even muster an iota of shock.";
	say "     You can see the glee in the body language of the red cape donned men, and this glee grows as they straddle the soldiers. Each spartan takes a soldier, and each one has a grin that'd rival a big bad wolf. Even then, however, it's clear who will take, and who will give. The spartans stand up and yank the soldiers to their feet, guiding the exhausted, dazed men to a nearby wall. The men in tattered camo clothing are then forced against the brick surface, hands and legs spread as their palms rest against the wall before them. It's clear what's going to happen, especially when the spartans begin to poke and grip at the anal plugs.";
	say "     [bold type]Do you stick around to see exactly what the spartans do? For research purposes, obviously.[roman type][line break]";
	LineBreak;
	say "     ([link]Y[as]y[end link]) - Watch the sexy hunk squad get taken by the equally sexy spartans.";
	say "     ([link]N[as]n[end link]) - Take your leave while you can.";
	if player consents:
		LineBreak;
		say "     You settle in, leaning further out from the alley so as to get the perfect angle. From where you are, you can see the backs of the soldiers and spartans, which gives you a good glimpse of those bejeweled buttplugs. They're twitching off and on as the soldiers appear to grow more receptive of their captures. This draws quite a hearty chuckle from the adonises of old, and they poke and prod at those delightful anal spreaders. They even begin to tug at the plugs, giving short efforts before releasing the solid ends. These efforts draw languid moans from the soldiers, and you can even see light flickering off the fluids dribbling down from between their legs. The soldiers are leaking like faucets. For the first time since this all began, you hear clear words from the spartans. They appear to be making denigrating remarks, but it's hard to make out anything exact. You manage to catch a [']sluts['] and a couple of [']bitch['] remarks.";
		say "     Beyond that, it's hard to discern exactly what's being said, but given the fact that the spartans are pulling out their cocks, their goals are pretty clear. Their leather briefs are soon around their knees; the soldiers are coaxed to hunch over even further. Before long, you see the spartans grip at the buttplugs, yanking them out with little care for their bottoms. In response, the military men release pained moans. Those pained sounds then turn to loud shouts of pleasure as each spartan shoves balls deep into the men. It seems the spartans have once more declared superiority over this city, and you think you can see even more of them further away, watching the rutting before them. However, there does seem to be something different about the observers, something in their hunched forms that strikes you as decidedly unspartan.";
		WaitLineBreak;
		if player is male:
			say "     You could go and see who they are, while the rutting continues, or you could try to get some spartan ass. One would decidedly require more effort, however.";
			LineBreak;
			say "     [bold type]What do you want to do?[roman type][line break]";
			say "     [link](1)[as]1[end link] - Go and see what those other men are up to.";
			say "     [link](2)[as]2[end link] - Try and take on the half-dozen spartans.";
			say "     [link](3)[as]3[end link] - You're quite decided on leaving, actually.";
			now calcnumber is 0;
			while calcnumber < 1 or calcnumber > 3:
				say "Choice? (1-3)>[run paragraph on]";
				get a number;
				if calcnumber is 1 or calcnumber is 2 or calcnumber is 3:
					break;
				else:
					say "Invalid choice. Type [link]1[end link] to check on the other men, [link]2[end link] to try to fight the weakened spartans or [link]3[end link] to simply leave.";
			if calcnumber is 1:
				LineBreak;
				say "     You sneak back down your alley, and head along other alleyways as you try and remember exactly how far away those men were. After a few minutes of wandering, you do find what looks like an alley that'd lead to where they were, and so you quickly head down it. Thankfully, you were right, and in fact it has given you the chance to sneak up behind the observers. They are decidedly different than the spartans. Not only are they more lithe and less muscled, but their demeanors are far more submissive. This gives you quite the idea as you grab one from behind, covering his mouth and pulling him from the group. You take him a good dozen or so feet away, and then press his back into the alley wall. As soon as your hand comes off his mouth, your lips go to his, pressing desperately against this sexy man. Your cock is soon pressing against his, your hips frotting the two of your lengths as your tongue jabs into his mouth. There's little resistance from him, and as you pull back, and as the saliva strands between you break, his eyes stare in utter adoration. This man is desperate.";
				say "     Under normal circumstances, you'd take your time with someone this needy, but there are far too many risks here, and so you quickly spin him around and press his chest against the wall. You spit onto your length, quickly rubbing the saliva and precum all up and down your cock. It is soon pressed against that twitching mass of muscles, that eager hole, and with just one thrust, you sink half of your cock into your temporary bitch. There's nothing between you and savagery, and so you begin to ravage this man. Your cock pulls at his hole every time you yank out, and slams the hole forward as you go balls deep. His muscles are so tight around your cock that you feel his anus may come with you, but the pleasure from the tigthness is too insane to complain about. The slapping noises get louder, and you can only hope that it's covered up by the spartans['] use of those soldiers. In either case, your balls begin to pull up, and your cock throbs. Seconds later, you're balls deep, holding this man's hips to yours as you press as hard as you can into his ass. His cheeks are flat against your crotch, and your cock is as deep as it can get. That is the position that you choose to let yourself go over the edge in, filling the bitch up.";
				WaitLineBreak;
				say "     Your cum almost feels like it's burning you as you fire your first volley into the male before you. Each shot after that feels just as hot, and it only serves to heat that ass up even more. Soon your entire cock is getting lathered in your hot seed, tightly compressed by that eager hole. It's almost maddening how good it feels, and how long it lasts. You could swear you've cum a gallon, at least, but there's no telling, because that hole holds onto every ounce. It's not until your orgasm begins to subside, that even a trickle leaks out, and that only gets worse once you yank free from that tight ass. You then give a quick kiss to the back of the man's neck before slapping his ass, sprinting off now that you've drained your balls.";
				CreatureSexAftermath "Helot Manservant" receives "AssFuck" from "Player";
				now resolution of Spartan Usurpation is 2; [Player fucked a Helot]
			else if calcnumber is 2:
				LineBreak;
				say "     You sneak up behind the madly humping spartans, their minds stuck in their dicks as they plow the now eager soldiers. There's still some ratty camo clothing draped across the now ex-military men, and dog tags rattling aroud their necks, but there's little left in military attitude. You then clear your throat, getting the spartans to turn around and stare at you in annoyance. They yanks their cocks from the mewling bottoms, turning to face you with erect, precum slathered dicks. It's clear they're not as prepared as usual, giving you at least some chance to succeed.";
				SUSpartanSquadFight;
			else:
				LineBreak;
				say "     You back down the alley you came from, sure to be quick and yet quiet. Soon you're back on a street far from those adonises, huffing it along to explore some more.";
				now resolution of Spartan Usurpation is 1; [Player ran]
		else if player is female:
			Linebreak;
			say "     It is clear that this group prefers males, and looking the way you do, you would be spotted immediately and not in a very warm welcome manner. Without many options left, you simply retreat.";
			now resolution of Spartan Usurpation is 1; [Player ran]
		else:
			LineBreak;
			say "     You back your way down the alley you came from, quick to sprint off when you're out of earshot. Hopefully no one saw you.";
			now resolution of Spartan Usurpation is 1; [Player ran]
	now Spartan Usurpation is resolved;

to SUSpartanSquadFight:
	let GroupFightCounter be 0;
	now fightoutcome is 0; [reset]
	while fightoutcome < 20 and GroupFightCounter < 6: [runs for 6 times or until the player loses or flees]
		choose a row with name of "Spartan Warrior" in the Table of Random Critters;
		now HP entry is 23;
		now wdam entry is 6;
		challenge "Spartan Warrior";
		now HP entry is 95;
		now wdam entry is 15;
		increase GroupFightCounter by 1;
	if fightoutcome < 20: [won]
		say "     You somehow managed to take out all six spartans, exceeding even the squad of soldiers before you. However, you did it for one very specific reason, and you walk over to one spartan in particular, gripping him by his hair as you whip out your dick.";
		WaitLineBreak;
		SUSpartanSquadWin;
	else if fightoutcome > 19 and fightoutcome < 30: [lost]
		say "     You fall on your ass, the soldiers all turning and looking at you with glassy eyes. You're not going to get another chance at this, and you have a sneaking feeling of what'll be next. It excites a part of you, but also fills you with an uncertainty that you haven't felt before.";
		WaitLineBreak;
		SUSpartanSquadLoss;
	else if fightoutcome is 30: [fled]
		say "     You turn and flee from the spartans coming for you. There's little need for them to leave their bounties, right?";
		WaitLineBreak;
		SUSpartanSquadRun;

to SUSpartanSquadWin:
	say "     You quickly press your length against this great man's lips, sliding your precum all around his mouth as he reluctently opens up. As soon as it's open, you shove your cock balls deep into his throat. He gags and lightly pushes against your thighs with his free hands, but you hold him steady. There is no doubt who he belongs to, and you're going to thoroughly prove it. The other five spartans simply watch uncertainly, waiting for something. You give them that something, ordering them to come over to you and help get the one you're holding against your groin more receptive. They hesitate, but they fall in line, like the organized men they are. Soon the man sucking you off, sheathed around your dick, is getting stroked up and down by his spartan allies. Their hands eventually find their ways to his ass and cock, stroking and rubbing over his waist and lower body. Of course, his length stands at attention, like the rest of them. So it's even easier for the others to make him all the more receptive to your uses. There is no need to just stand there with him swallowing around your cock, however, and so you begin to move your hips. You begin to thrust in and out of his throat, stirring up spit and mucous with your increasingly vigorous facefucking of a former enemy.";
	say "     With his gagging around your cock, the pleasure going through your body spikes even more, drawing you to almost cum on the spot. However, you stop yourself just on the edge, leaving yourself once more sheathed down his throat. He manages to breathe enough while you're shoving him in your crotch, so there's no concern for losing your new toy. Though, given his heavy breathing as his brethren begin to finger his ass and tweak his nipples, he may be a bit light headed soon. You care very little as you keep him swallowing around your cock, leaking your copious precum down his throat. There's really no reason to let him have a break, right? And so you keep things up, keeping using his mouth as a fleshlight, and his head a handle for such. Even when his spartan allies begin to finger-fuck him, you can't care about more than your own pleasure. So you keep using his mouth to stay on the edge of absolute ecstasy. Hell, the other spartans are soon positioning themselves behind him, forming a line as he shows weakness under you. They're just about to run a train on him, and you know it'll only drive his throat to be even tighter.";
	WaitLineBreak;
	say "     The first spartan in the line spits downward, no doubt onto his own dick, and then probes at the hole of your fleshlight. You can feel the now ex-spartan offering meek struggles, but he's more than willing, and you can tell as soon as he's penetrated from behind. He begins to drool around your cock, his eyes roll back, and he becomes nothing more than a doll for you to get off with. Given what you've started, you do decide to move things along, however, and so you begin to eagerly face-fuck him once more. Your hips slap against his face as you fuck his throat, as you drag your cock out across his tongue before shoving it back down his gullet. You know he loves this, you know he can breathe just fine, and you know that the spartans behind him are going to break him in. So you simply watch the muscles of the topping spartan flex as he fucks your toy. They're all nothing to you, but the one you're balls deep inside of, is even less than the others.";
	say "     So you watch as these men flex and show their power as they revel in their base needs, either of submission, or dominance. You've given the other five a new toy, and now their look of defeat has changed to a look of eager demand. You look down at your fleshlight as you feel yourself right on the edge, and you then slam fully down his throat once more, unloading what feels like pints of cum. Shot after shot fires into his stomach, and you see his face light up with utter glee at getting his reward. You hold him there too, keeping him gagging around you even as you soften, and only when you're almost completely flaccid, do you slip out of him. 'Thank you, master,' he says in a breathy tone. You simply pat him on the head as the spartan behind him tenses up, releasing his own load inside the new bitch.";
	WaitLineBreak;
	say "     Having finished up with breaking in the toy, you gather your things and head off with a raised head.";
	CreatureSexAftermath "Spartan Warrior" receives "OralCock" from "Player";
	now resolution of Spartan Usurpation is 4;

to SUSpartanSquadLoss:
	say "     The spartans all descend upon your fallen form. Six adonises surround you as grins dust their faces. There's nothing you can do but get up on your knees and prove your worth. The spartan that got the last hit on you steps forward. He presses his cock to your lips without even the slightest hesitation, easily slipping it into your mouth. The man sighs out in approval, his cock lurching in your maw as he pushes even more into you, eventually guiding the length down your throat. It's not that long before his balls press against your chin. Everything he's doing, is clear and methodical. He's taking all that he wants in a calm and collected fashion, with little real rush. All of the spartans here know you're theirs now, and that this is the only true place for you. This spartan, the one sheathed down your throat, begins to move his hips more rigorously, humping at your throat and maw. The humping grows more intense as the seconds tick by, and soon he's all out skullfucking you, hands gripping your head as he pounds his crotch into your face. There's nothing for you to do but relax and take it, find what enjoyment you can in your new position.";
	say "     The other spartans soon step forward as well, two wrapping your hands around the dicks, and another stepping up behind you. The one behind gets on his knees and presses his chest against you, leveling his cock with your ass. From this angle it'd be hard for him to spear you, but he finds a solution. You feel hands gripping at your thighs, lifting you up and pressing your mouth even harder into the crotch before you. After that, you feel a cock poking at your entrance, the head slick with fluids as he slides in with ease. They know what they're doing and what they want. Warm fluids splatter all over your head and upper body; you choke around the cock down your throat in surprise. You realize that the two cocks in your hands are firing off their loads, and at the same time, the one down your gullet throbs out its own warning. You're then filled with warmth and cum from one of your betters. Without any hesitation, you happily gobble each shot of cum down, letting the prodigious amount of fluid head straight into your stomach. It'll keep you warm and content to have so much cum inside you, and you know it'll only get better the more cum there is.";
	WaitLineBreak;
	say "     Your ass is still kept grinding down into the lap of the spartan behind you, his hips only giving light thrusts as you're fed and coated in spartan cum. Each one of these adonises that cums then turns back to the soldiers, going back to pounding their holes. The military men hadn't even tried to move away, to escape while you distracted their captors. So they were rewarded with the vigorous fucking they had coming since they were beaten. There was no longer anything between them and subservience. The spartans even yanked the tattered camoed clothing off the men they were pounding, leaving their sweat glistened bodies entirely exposed to the world. So you are treated to quite the show of gay sex, all while you yourself are taken from behind. The two spartans that haven't used you yet get into position, one getting on his knees in-front of you and lifting your hips up, angling his own cock against his compatriot already inside you, and another simply stands there, jacking off right next to your face.";
	say "     Soon there's an intense pressure against your anus, the second cock pressing forcefully against your hole as the man already inside you waits patiently. That pressure builds up and up and up, and up, until a sharp pain fills you and the second cock slips inside. The dagger of pain is short lived, however, as pleasure shoots through your body, originating from those two glorious lengths within you. They haven't even started moving yet, and so when one begins to pull out, you see stars. There's no conscious thought left for you, not as the first cock slips almost entirely out and slams back in, not when the second cock repeats the same action, and most definitely not when they begin to seesaw back and forth. You're lost in mind and body, everything now taken by these adonises of old. You barely even notice when they each fill you with cum, when the third splatters your face in his own, and you care little when the two inside you start back up again, using you again and again...";
	WaitLineBreak;
	CreatureSexAftermath "Player" receives "AssFuck" from "Spartan Warrior";
	CreatureSexAftermath "Player" receives "OralCock" from "Spartan Warrior";
	follow the turnpass rule;
	follow the turnpass rule;
	infect "Spartan Warrior";
	infect "Spartan Warrior";
	say "     Hours have passed. You don't know how many, but you find yourself someplace else, sore and covered in dry layers of cum, which at this point you're not even sure whose it is. One thing is certain, perhaps you shouldn't underestimate a group of ancient greek horny men, as distracted as they may seem...";
	now resolution of Spartan Usurpation is 3;

to SUSpartanSquadRun:
	say "     You hear footfalls behind you, sandaled feet slapping along the concrete as you rush away. There's little reason to stop, and you have no desire to be broken like those soldiers. Still, the sounds behind you get louder and louder, the feeling of breath on the back of your neck almost overbearing. You then trip and catch yourself on a nearby wall. That's exactly what your pursuers were waiting for too. A heavy weight slams into your back, pressing you against the brick before you. You feel the pursuer pressing into you as he[if player is not naked] grabs at your clothing and yanks it off[else] runs his hands up and down your nude form[end if]. Those smooth hands are not calloused in the slightest, no scratches, roughness or even the slightest imperfection can be felt along those palms and fingers. These can't be the same spartans from before, can they? You then feel more hands grab at you, yanking your arms back as you're pulled into the body behind you. The body then moves, causing you to fall back and almost slam into the concrete. Luckily, the hands gripping you keep anything like that from happening, lowering you carefully to the ground as you look up at your captors.";
	say "     These men above you are not spartans, not in the least. They are donned only in a loincloth and sandals. They're also notably more lithe and twink-y than the spartans from before. You must have been chased down by the men you had seen observing the fight from the far side of the battle. As the loincloths are pulled to the side, you realize these men are very needy, and are going to take what they can from you. That's confirmed in the next instant, when one of them places his feet on each side of your head, glaring down at you with a grin dripping with lust. He then lowers himself towards your face,[if anallevel > 2] but instead of his dick being shoved down your throat, his ass is forced against your face. You nose is met with the scent of a musky and needy male, one who is clean of all scents other than sweat and sex. There's even a hint of a taste of cum as your tongue instinctively jabs out to lick at that hole. He grinds down into you as you eat him out with a vengence. His hole soon clamps down on your tongue, and you can hear moans sound out seconds later. The telltale sounds of cum splattering across concrete rings out[else] shoving his cock right into your maw. It's then fed right down your throat as he begins to thrust his hips back and forth, taking your face as a hole to breed. His movements are quick, savage and needy. He goes and goes with greater effort after just a scant few second, his cock lurching and jerking about in your throat as you feel his length thicken. The balls resting against your chin begin to pull up as well, leaving no guessing to how close he is. That knowledge is then confirmed as warmth fills your throat and stomach, several shots of cum firing from the length in your mouth. He even begins to pull out halfway through, leaving a nice deposit of seed right on your tongue. You're then slapped with the man's dick; this sudden impact forces you to swallow what he left in your maw seconds earlier[end if].";
	WaitLineBreak;
	say "     You're not done serving anyone, yet. The others soon grab at your legs and spread you wide, letting another memeber slide between them and press against your hole. He's unceremonious in his efforts, rubbing his precum into your hole for just a few seconds before the main event. That main event is him spearing you on his rod, a rod that spreads you wide and leaves you gasping. Your gasps only encourage him, and he's soon pounding at your ass with all the gusto of a feral dog. There's nothing left for you to hide, and so you let out wanton moans of desperate desire. The rest of the men take this as their cue. Two grab your hands, another places his cock at your mouth, and another one saddles your waist. Soon your hands and mouth are filled with cock, and your own length is spearing into the depths of another male.";
	say "     That man on top of you is tight as hell, and warm too. There's not much keeping you in the land of the reasonable and conscious, and you begin to drift in and out. Your hands automatically milking cocks, your throat undulating around another, while your ass and dick throb. You can feel the edge coming, your cock lurching as you leak more and more, warming up that hole. Soon you're planting your own seed deep inside that ass, and you feel the very same thing happen to you. While filling another man, you yourself are filled to the brim as well. Seed goes flying all over you in the next instant too, your hands and arms getting caked in it as the man riding your cock unloads on you torso. Finally, the male down your throat also unloads his pent up need, filling you with what feels like pints of cum. You don't remember much after that, and your body quickly takes you down with its exhausted state.";
	WaitLineBreak;
	CreatureSexAftermath "Player" receives "AssFuck" from "Helot Manservant";
	CreatureSexAftermath "Player" receives "OralCock" from "Helot Manservant";
	follow the turnpass rule;
	follow the turnpass rule;
	infect "Helot Manservant";
	infect "Helot Manservant";
	say "     You soon wake covered in dry cum. It seems like there's only as much cum as you recall those men coating you with, but who knows. Some of it does feel oddly fresh, so you quickly gather your things and move on with haste.";
	now resolution of Spartan Usurpation is 5; [Player got used by Helots]

an everyturn rule:
	if Hellfire Club is known:
		now One Fiery Trick is active;

OFTKnowsItsArad is a truth state that varies. OFTKnowsItsArad is usually false.[@Tag:NotSaved]

[The following event, One Fiery Trick, is only available for players who have discovered the Hellfire Club. It otherwise follows the same level requirements as the others, and does not require the player to have interacted with Diego in the past.]
[The explanation behind this requirement is that Diego really only starts paying attention to this faction once the player discovers and, in consequence, leaves them more exposed. He'd know of the player's relationship with the Hellfire Demons, thus he would know that one of the outcomes, which tricks the player into getting gangbanged by more Hellfire Demons, would do no damage to them.]
[The bound demon is Arad, one of the Hellfire Club's bouncers, who is known for getting into trouble very frequently.]

[If the soldiers reach the demons, a whole sex fight starts as they wrestle around. The demons, rather than forcing them, seduce every soldier and end up having a wild orgy. To Diego's surprise, the demons do not turn the soldiers into more demons, instead freeing Arad after they understand it was enough punishment to leave him out of the action, hearing only the moans and grunts.]

[If the demons reach the player and Arad, they'll free Arad and, instead, bound the player, as they understand they were at fault. With this, they will proceed to "punish" the player with a lot of sex as they relief themselves on them.]

[In conclusion, this event can end up in a trick to either faction (military or demons) or a twist trick on the player.]

[FUTURE STUFF]
[Could do aftermath events if soldiers end up being carried to the club?]
[Could also open up a scene with Arad, seeing how he likes being tied up...]

Table of GameEventIDs (continued)
Object	Name
One Fiery Trick	"One Fiery Trick"

One Fiery Trick is a situation.
ResolveFunction of One Fiery Trick is "[ResolveEvent One Fiery Trick]". One Fiery Trick is inactive. The level of One Fiery Trick is 7.
The sarea of One Fiery Trick is "Outside".
when play begins:
	add One Fiery Trick to Badspots of MaleList;
	add One Fiery Trick to Badspots of DemonList;

to say ResolveEvent One Fiery Trick:
	say "     It is another day exploring the outskirts of a desolated city, seeing the same old abandonment caused by the apocalypse, in hopes of finding something of interest to you. You spend a good amount of time in this quest, finding nothing of use, but you come across a few isolated alleys of previously inhabited shacks. It is a small settlement, but remains completely empty and seems like it was already ransacked by scavengers. Either way, you decide to go on ahead and give it a look, since you do not really remember having passed by this particular area in the past. The scenario is what you would expect, just some grass and dirt on the way and silent shacks, the wood still creaking with the wind. It makes for a certainly spooky ambience.";
	say "     You do not really take care to move silently at all, your footsteps cracking dry leaves and branches loudly, until you hear something alike a groan coming from one of the wooden buildings. Someone must have heard you coming, but it does sound like they are trying to alert you of their presence, due to how sudden it was. Carefully, you walk in the direction of the noise and keep quiet, now with lighter footsteps, and go up the small wooden stairs leading to a door. When you get there, you try the handle to see if it is locked, but unsurprisingly, it is not. Moreover, it is not even closed properly, so you can push it open easily. As you do this, the door creaks very loudly, which startles you a ton and definitely ruins your attempts at being sneaky, but you figure you should just enter now.";
	WaitLineBreak;
	say "     Though, when you fully open the door and take a peek inside, you get an intriguing view. In the middle of this hall section is a large hellfire demon, completely naked, tied to a chair, blindfolded and gagged. A quick inspection reveals that it is definitely a male, due to a quite large endowment hanging between his muscled legs, which were spread and tied to each of the chair's. His arms were placed behind, leaving the devil completely exposed, with ropes and knots sturdy enough to not allow him to move an inch. Whoever did this knew what they were doing, but you fail to conclude for what reason. You take a glance around you to see if anyone is nearby, and find nobody nor any suspicious clues, besides toppled furniture and clear signs of abandonment.";
	say "     And when you look back at the demon, you notice that his cock looks bigger than when you arrived. It hardens as soon as you take another step forward, now hanging half-hard, which leaves you a lot of questions in your mind. It seems this situation... arouses the demon? Confused, you ponder your options, until you hear [if park entrance is known]a familiar[else]an unknown[end if] voice speaking from one of the corners of the room, someone who was completely out of view before. You are able to identify [if park entrance is known]Diego right away, with a mischievous grin,[else]a strange orange coyote with a mischievous grin[end if] and you immediately have an idea of what is going on.";
	WaitLineBreak;
	say "     'You got here early! The squads are still on their way here!' he says, and you immediately ask which squads. 'The soldiers, dummy! And the other demons!' You put two and two together, realizing that this is probably some sort of setup for both parties, but it also means that if you got here early, you can potentially change the outcome of this situation before the worst happens. But before you can say anything, the coyote speaks again 'Hurry up and hide! Unless you wanna get caught in the middle!' Now, you get to intervene.";
	LineBreak;
	say "     [bold type]What do you want to do?[roman type][line break]";
	say "     [link](1)[as]1[end link] - Seek a place to hide and watch.";
	say "     [link](2)[as]2[end link] - Convince the coyote to leave the demon to you.";
	say "     [link](3)[as]3[end link] - You want to have nothing to do this and will simply leave immediately.";
	now calcnumber is 0;
	while calcnumber < 1 or calcnumber > 3:
		say "Choice? (1-3)>[run paragraph on]";
		get a number;
		if calcnumber is 1 or calcnumber is 2 or calcnumber is 3:
			break;
		else:
			say "Invalid choice. Type [link]1[end link] to hide and see what happens, [link]2[end link] to try to have the demon for yourself or [link]3[end link] to simply leave.";
	if calcnumber is 1:
		LineBreak;
		say "[OFTDemonsAndSoldiers]";
		now Resolution of One Fiery Trick is 1; [Saw the soldiers with the demons, soldiers were carried over to the club. Maybe an aftermath event?]
	else if calcnumber is 2:
		LineBreak;
		say "     Seeing such a hunky devil so vulnerable, and even aroused, you ask [if park entrance is known]Diego[else]the coyote[end if] if there is a chance you could have the red horned guy all alone with you, as you find yourself quite entertained by the sight of an attractive masculine demon bound to a chair, clearly enjoying his predicament. As the captive lets out an appreciative grunt, the prankster thinks to himself before replying, 'Well, that's... I didn't see that one coming. But I've had so much work setting this up! What's in it for me?' He expects you to make an offering that would compensate him for the loss of the satisfaction he would get from seeing the chaos he sowed happen. You think about it, but the canine immediately makes a proposal, 'Can I watch, then?'";
		LineBreak;
		say "     ([link]Y[as]y[end link]) - Allow the coyote to watch you mess with the demon.";
		say "     ([link]N[as]n[end link]) - Refuse and just leave, in that case.";
		if player consents:
			LineBreak;
			say "     Giving it some thought, you decide to accept these conditions. The coyote then gets up and rushes to the exit. 'Just gotta lead them away, then! I'll be right back!'";
			say "     It is mere seconds until the coyote is out of reach, so you head towards the demon, who... unexpectedly starts to chuckle.";
			LineBreak;
			say "     ([link]Y[as]y[end link]) - Unbound him.";
			say "     ([link]N[as]n[end link]) - Wait for the coyote and do as you agreed.";
			if player consents:
				LineBreak;
				now OFTKnowsItsArad is true;
				say "     You head over to him and begin to remove his blindfold carefully. Then, you are quite shocked. It turns out that you know who this demon is. You then proceed to remove the gag, allowing him to speak. 'What's up, cute stuff? Heh, didn't think you'd end up here.' It is Arad, one of the Hellfire Club's twin main bouncers. He truly seems to have a knack for finding himself in sticky situations, but he does not seem bothered in the slightest. 'Just so you know, then... That dude's probably tricked you. I think he's gonna lead the soldiers away, but not the demons. Not sure if you know him, but he does quite some fun stuff! Doubt boss would approve of me partaking in these, though... Don't tell him anything, alright?'";
				say "     As he mentions that [if park entrance is known]Diego[else]the coyote[end if] could have tricked you, you immediately ask what he meant, ignoring his last words. 'Oh, yeah, well, you'll probably end up gangbanged by a bunch of other demons if they see you here messing around with me. That's the kind of show he wants!' You are only left with more questions, so many that the possibility of just freeing Arad and end this completely vanishes from your mind. 'If you leave now, the others will arrive here and just leave with me, nothing fun happens... So, you could just... Let it happen? It'd be fun, yeah?' Before you get into deciding what you will do, you ask Arad if he has gotten into this on purpose, by any chance...";
				WaitLineBreak;
				say "     'Ah... Kind of? I mean... I was scavenging and kinda got knocked out? And I could've freed myself from here if I burned this rope down, but I guess I wanted to see what'd happen? Nothing wrong with that, right?'";
				LineBreak;
				say "     ([link]Y[as]y[end link]) - Tie him up again and wait for the coyote.";
				say "     ([link]N[as]n[end link]) - You shall leave immediately.";
				if player consents:
					LineBreak;
					if player is kinky:
						say "     [italic type]Due to your kinky nature, you begin to think that this might not be such a bad idea, after all... Even though the situation is quite absurd. You then proceed to place the gag and the blindfold back around Arad's head and mouth, pretending you did not remove them in the first place, but just the feeling of putting these back on him begins to arouse you... He gladly cooperates and lets you put them back on as closely as they were before. Then, you proceed to wait for the coyote while half-hoping what Arad said is actually true...[roman type][line break]";
						increase Libido of Player by 10;
					else:
						say "     Finding this whole situation rather absurd, you proceed to place the gag and the blindfold back around Arad's head and mouth, pretending you did not remove them in the first place. He gladly cooperates and lets you put them back on as closely as they were before. Then, you proceed to wait for the coyote... and whatever awaits you.";
					if player is dominant:
						WaitLineBreak;
						say "     [italic type]You sort of wish that you could just dominate this helpless demon all by yourself, though. A thought even comes across your mind as he remains here, so exposed, and you eye him from his head to his feet. Perhaps you could have some fun with him while you wait? You consider grabbing his cock and slowly rub your fingers around that tip for an excruciating amount of time, pull on his balls and squeeze them just enough to make him squirm... You just know that you could turn him into the biggest slut... Only if you had the time.[roman type][line break]";
						increase Libido of Player by 10;
					WaitLineBreak;
					say "[OFTDemonGangBang]";
					now Resolution of One Fiery Trick is 2; [Got gangbanged]
				else:
					LineBreak;
					say "     This is absolutely crazy. You shake your head and dismiss this whole situation as you walk outside the shack, ignoring whatever you heard and saw. 'Hey, c'mon...! It's gonna be lame without you!' he says as he sees that you are leaving, though you are quite set on doing so. Walking outside, you go down the wooden stairs and just remove yourself from the area, leaving Arad and whatever is going on behind.";
					now Resolution of One Fiery Trick is 98; [left, but knew Arad was there]
			else:
				LineBreak;
				say "     You made a deal with the coyote and you would like to honor that, even though that only makes the devil excited. One can only wonder what is going on in his head right now...";
				if player is dominant:
					WaitLineBreak;
					say "     [italic type]You sort of wish that you could just dominate this helpless demon all by yourself, though. A thought even comes across your mind as he remains here, so exposed, and you eye him from his head to his feet. Perhaps you could have some fun with him while you wait? You consider grabbing his cock and slowly rub your fingers around that tip for an excruciating amount of time, pull on his balls and squeeze them just enough to make him squirm... You just know that you could turn him into the biggest slut... But you have a deal, so you must wait until you can have your fun.[roman type][line break]";
					increase Libido of Player by 10;
				WaitLineBreak;
				say "[OFTDemonGangBang]";
				now Resolution of One Fiery Trick is 2; [Got gangbanged]
		else:
			LineBreak;
			say "     You shake your head and dismiss this whole situation as you walk outside the shack, ignoring whatever you heard and saw. The demon grunts as he understands that you are leaving, though you are quite set on doing so. Walking outside, you go down the wooden stairs and just remove yourself from the area.";
			now Resolution of One Fiery Trick is 99; [left]
	else if calcnumber is 3:
		LineBreak;
		say "     You shake your head and dismiss this whole situation as you walk outside the shack, ignoring whatever you saw. The demon grunts as he understands that you are leaving, though you are quite set on doing so. Walking outside, you go down the wooden stairs and just remove yourself from the area.";
		now Resolution of One Fiery Trick is 99; [left]
	now One Fiery Trick is resolved;

to say OFTDemonsAndSoldiers:
	say "     Looking around the hall once more, you try to find a good place to hide, as the coyote points to a toppled down large armoire, which is missing its doors, that seems to serve as good cover... With a few adjustments. Quickly, you go over it, give yourself enough space behind it, and hide. The canine then slides a kitchen knife your way. 'To make a hole so you can see through!' You frown, at first, but it does not seem to be that bad of an idea. It will allow you to observe the events that will unfold without risking being seen. Having decided to follow through his suggestion, you grab the knife and put a hole on the armoire's back panel, which is not too hard to make, as the wood is already very deteriorated. Eventually, you can make a hole large enough to allow you to peek into the other side, but discrete.";
	say "     Then, you remain there, with the coyote on the opposite corner of the room, both in position to observe what is about to happen. He seems quite eager and cannot help himself but smile as you both begin to hear voices and footsteps from the outside. You assume your best hiding position.";
	WaitLineBreak;
	say "     'What the fuck is that?' a man's voice is heard from outside the shack, and then, you see a soldier stepping in and walking towards the bound demon. 'Look at this! The dude looks like one of those red guys at Red Light!' he speaks to another man, who enters the hall. This seems to be a small squad of soldiers, made by just four, which you can see when they all come examine the demon. They take a really long while to realize the boner he is getting from being exposed like this to the group of men, who seem so intrigued at the fact there is a bound and gagged devil sitting on a chair in a random abandoned shack. 'And what do we do with him? Ooh, wait, is that... Is he getting...?!' one finally notices, as another replies 'This sure is some perverted shit. I say leave him here and scout the perimeter.'";
	say "     'Yeah, this isn't worth our time. Maybe we should-' the first soldier was saying something before they hear someone coming. You can see their faces of shock as they realize who is outside, but you can only hear their very deep voices, for now. 'Ah, shit. Not soldiers...!' one says, which you believe to be one of the arriving demons[if park entrance is known]. Diego[else]. The orange coyote[end if] now has the biggest grin on his muzzle as things are just starting. The soldiers quickly get into a defensive formation as they become aware of the group of demons, who immediately force themselves inside the wooden building. As they stand quite a lot taller than the men, it is not really a problem for them to just shove them back. With a total of ten people inside this room, plus you and the canine, it begins to feel a little crowded...";
	WaitLineBreak;
	say "     'So you're the naughty boys who captured our brother? What for? Personal entertainment?' asks the first demon, to whom one of the soldiers reply, 'We just found him like this! We've nothing to do with... whatever this is, we're just a small scout squad!' The devil just laughs in response and seems in disbelief. 'What, you want me to believe my comrade there tied himself up on his own? I'm not buying your story.' Another one of the soldiers rushes to intervene, seeing that they are completely outnumbered and outmatched, 'Look, we don't want any trouble! We're just leaving and you can have your friend. We mean no harm!' You see this first demon raise an eyebrow, then looking at the others as they all laugh.";
	say "     'We mean no harm either! But it's a tradition to teach naughty people a few lessons when they misbehave. I'm sure you understand... Disrupting our operations is inconvenient, and you just happened to have captured one of our most experienced scavengers and fighters... Even though he's a big slut.' He then points at the bound demon's cock, which is shamelessly throbbing, and then continues, 'How about we solve this with some good sex? Great to bond and all. And you guys keep wearing all these clothes and pouches, like... Y'all need to chill.' By now, the group of demons have surrounded the squad of soldiers, and you see one of them pulling the bound demon's chair all the way back against the wall, to give the two groups some space, and without even bothering to untie him.";
	WaitLineBreak;
	say "     'W-we're good, really! We get the message! We won't be messing with you!' one of the soldiers quickly talks back as one demon places his hands on each of his shoulders. The others do the same to the remaining soldiers, each demon on one, while the first devil you saw remains in front of them all. 'It ain't for the message anymore, really, you guys are just so tense! We gotta show you how to have some fun!' Seeing that they have no way out of this situation, the soldiers desperately try to fight the demons. A fight breaks loose as they attempt to escape the hold of the much bigger red devils, and... It does not really last too long, in fact. They are quickly overpowered by the horned hunks, who immediately grapple them as soon as one of the soldiers tries to make a run for it.";
	WaitLineBreak;
	say "     'Okay, now we're not so good. You just attacked us! And we defeated you, so that means we get to decide what to do with you... Right? That's how it works around here, as far as I'm concerned?' The devil who talked so far makes this sarcastic remark and the demons waste no time to begin undressing the soldiers and feeling their fit bodies all over. You think the whole squad would be quite frightened by this... until the demons drop the soldier's pants down and see that their cocks are all rock solid. 'Pfft... How long have you guys been without a good fuck? We barely touched you and your dicks are already standing straight up... That's cute.' The next thing you see is each soldier getting masturbated by the demon who is grappling them, and suddenly, they do not seem so reluctant.";
	say "     When you look at your side, you see the coyote squinting his eyes. He seems intrigued... or maybe focused, but either way, the scene continues. All the soldiers are stripped until they are completely naked, left only with their boots on, much alike the devils themselves, who have removed their pants but left the harnesses and their own boots on, with their huge cocks hanging free. Then, they begin to make out passionately with the soldiers, feeling up their rears and fingering their buttholes... And they simply give in. Soon, their are being pinned down against the walls, the floor, and even on top of a wooden counter towards the window, with demon cocks up their asses as their not-so-chosen partners thrust into them. There was this one soldier, however, who instead got taken by two, one claiming his mouth while the other got behind his ass.";
	WaitLineBreak;
	say "     All this sex happening right here while the bounded and gagged demon remains ignored... You begin to wonder who is receiving the punishment act here, as everyone else seems to be enjoying themselves. The coyote is sort of... surprised? It is clear that he finds this hot, but he seems, at least, intrigued by all this. You, too, continue to take a peek at what is unfolding before your eyes, noticing how quickly the soldiers become so willing for the hunky devils, arching their backs and giving them full access to their asses... and to anything else they desire. Though, you would think the devils would stick to being tops with the soldiers, but this quickly turns into some of them switching with the humans, sucking their cocks and riding them as well.";
	say "     Then, they exchange partners. Some demons get fucked, others fuck, there are some who stick to sucking, and there is this particular soldier eating a demon's ass voraciously, each muscular asscheek almost as big as his head... while getting his own ass eaten by another demon. Everything new they try lasts for about a couple to five minutes, and then shift again to something else, like two demons double penetrating a single soldier, practically squishing him between their muscular bodies as one lies underneath him and the other on top. Judging by the moans, he seems to be in complete bliss, just like the rest of the squad. You do not think this is ending anytime soon, as not even when one ends up cumming from all the pleasure they end what they are doing, skipping straight to round two...";
	WaitLineBreak;
	say "     You sort of lose track of time as this goes on and on, but obviously, the soldiers fail to keep up with the demons['] much superior stamina. They begin to fall asleep one by one as the sex ends up being too exhausting for a mere human body. 'Alright, boys... Seems we gotta continue this at the club. Bring them over, I'm sure they won't mind waking up in our soft and warm sheets...' says one of the demons, chuckling, as they begin to carry the soldiers with them outside with all their stuff. For moments, you think they had forgotten the bound one... but someone comes back for him. 'Ah, yeah, almost forgot about you, Arad. Hope this serves you right, you fucking perv.' As soon as the gag is removed, Arad shouts 'Fuck off! I want all four of them in my bedroom as compensation! This was fucking torture! Who the fuck were you punishing, after all?! Me?!' The other demon only laughs and nods, replying 'Maybe...' as he finishes untying Arad. Then, they both walk outside, with the formerly bound demon quite angrily following behind.";
	WaitLineBreak;
	say "     'Well, that was... different. Strange how these demons don't turn others into more demons... But I was hoping for a little more chaos!' says the orange coyote before storming off, talking to himself. With nothing else to see here, you gather your things and also begin to leave. This whole situation left you significantly aroused, though...";
	increase Libido of Player by 30;

to say OFTDemonGangBang:
	say "     Eventually, your waiting leads to hearing multiple heavy footsteps outside, and eventually just across the door which... was left open. You do not even have time to react as you exchange looks with another hellfire demon... And no sign of [if park entrance is known]Diego[else]the prankster canine[end if]. Then, it is not only one demon, but two, then three... And the count continues to increase. Instead of straight up attacking you on sight, however, one of the demons simply walks inside with a grin on his face. 'So here's the naughty [boygirl] who captured one of ours for some... I take it, personal entertainment?' he asks, and more of his partners begin to join you inside. There are five of them in total.";
	say "     You glance around, trying to see if you can spot the coyote and explain the situation, but you really do not see him anywhere. There is no way he really tricked you, is there? 'I'm talking to you, now! It's rude to ignore a question!' the demon berates, and you are then brought to attention as he grows impatient. One of the devils had already began untying [if OFTKnowsItsArad is true]Arad[else]their bound comrade[end if] from the chair, keeping the ropes to himself. Now, you just know that you may be in trouble as the other demons completely surround you, leaving you no room to fight back nor flee. Since he did not like you not replying to him, you have no other choice but to try to explain how you got here.";
	WaitLineBreak;
	say "     'So you're telling me a puny orange coyote brought one of us down and carried them all the way here, then... might've tricked you into making it seem like you did it?' he asks, quite in disbelief, but you confirm that is correct. He just laughs. 'Sincerely, I'd have let you go if you told me that you wanted to play some bondage with that freak over there, but seeing how dishonest you were...' The entire group begins to walk closer to you, with the chair and [if OFTKnowsItsArad is true]Arad[else]the demon[end if] now gone from behind you, so you make one last attempt to tell them that what you are saying is actually true. Seeing that they really do not believe you, this only makes them more sure that you are set on lying to them.";
	say "     'What a very bad [boygirl], still lying to us. I guess you really deserve to be punished...' Suddenly, one of the demons grabs you from behind and begins to tie you up with the same ropes that once bound the first devil, and shows quite a lot of mastery in doing the knots[if player is not naked]. You are then stripped down naked and your[else]. Your[end if] arms are immobilized as he makes a pattern around your torso with the rope, truly keeping you from moving any of your limbs. It starts getting really hot in the room as you see the entire group getting more and more turned on by the situation. 'We'll give you a proper bondage session. Your knots weren't too bad, but there's more fun ways to do it!' says the demon who is busy getting all these ropes around you.";
	WaitLineBreak;
	say "     Then, out of nowhere, you feel yourself being pulled up and flipped over, and when you manage to process what just happened, you find yourself hanging from the ceiling as your body remains in the horizontal, completely exposed. You are lowered down until your head is at the same level as the devil's crotches, which are looking bigger with each passing second. The one in front of you pulls out his girthy meat out of his tight leather pants, already half-hard, and begins to stroke it mere inches away from your face, its demonic scent reaching your nostrils. It feels intoxicating, a surprisingly arousing smell, masculine and hot, you cannot even quite describe it. It is like an exquisite fragrance that sends your brain all kinds of dirty thoughts.";
	say "     This is not the only visible cock around you, as all the others have already joined the jerking circle. All of them range from about fourteen to sixteen inches in length, but almost as thick as slim forearms from an average person, all possessing a beautiful crimson tone and perfect shapes. Their sculptural bodies are only covered now by their black leather harnesses, which differ in shapes as well, and some have body hair all over their thick muscles while others are completely smooth. They are all surrounding you, even closer than before, and you feel their hands, which are many in total, moving all over you. Your legs, your chest, your back, your butt[if player is male]... Even your cock, which is shamelessly throbbing[end if]... Every single part of your body is molested by the demons, caressed, rubbed over and felt up.";
	WaitLineBreak;
	say "     It is in that moment that you find yourself licking the demon's cock in front of you, only having access to the tip, which already began oozing precum. Its taste is incredibly good, a mixture of saltiness and sweetness that has you crave for more, but as soon as this desire settles in, he finds it entertaining to tease you with it. 'Now you want it? Hehe... Then come and try to get it.' Hearing these words, you attempt to move your head closer to his cock, but it is just too far, and you are being held by the other demons who are simply feeling you up absolutely everywhere, an overwhelmingly pleasant sensation all by itself. You even feel their cocks at some point, as they rub them across most of your erogenous areas. This is leaving you desperate...";
	say "     Having teased you enough, the devil then grabs your head and pushes his dick against your lips, causing you to open your mouth and take his big cock inside, letting you have a good taste of it for a while. 'Savor it while you can...' he nonchalantly says, soon beginning to bury it deeper towards your throat, holding it there for a while, and finally pulling out. Then, he repeats it, deeper than the first time, longer as well, and progressively more and more, as if testing your limits. At the same time, you sense someone pushing the others aside as they get behind you, immediately rubbing his big meat between your asscheeks. 'I think I deserve it, after being tied up to that chair for so long against my will!' says [if OFTKnowsItsArad is true]Arad, clearly lying and only using this opportunity to earn a free fuck, which would have you rolling your eyes if not for the cock in your mouth[else]the demon who was previously bound, who is clearly using this opportunity to get to fuck you... But... you think you know this voice from somewhere[end if].";
	WaitLineBreak;
	say "     Almost immediately, said cock between your asscheeks finds itself pressing against your butthole[if player is female]. He is not even bothering with your pussy, going straight for anal instead[end if]... but at least, it had leaked enough for its tip to slide in easily, coated in that slippery fluid. He then stretches your asshole open with his big cock, sending only delightful surges of pleasure all over you as you realize you take it in so well, your butt welcoming this insertion all while you suck on another demon's cock. You cannot help but moan, which leads the devil in front of you to thrust into your throat a little faster than before, then picking up the pace until you are essentially getting fucked from both ends.";
	say "     The action breaks loose as they dive deeper in their own lusts, and you easily follow. The one who took your ass seems very possessive of it, but the others rotate around you and take turns on your mouth, which becomes more than just a blowjob on each. They start to just use your mouth like a fuckhole and proceed to facefuck you, while something seemed to have removed your gag reflex. This hot air also makes your entire body feel sensitive, every bit of pleasure augmented, the moans and grunts of the demons just adding to it... They continue to change places, one by one fucking your throat, rubbing their big cocks against your body while they await their turns, and your ass only keeps being relentlessly taken by [if OFTKnowsItsArad is true]Arad, who is really, really horny[else]this really horny devil behind you[end if].";
	WaitLineBreak;
	say "     As you are assfucked so hard, the whole group begins to catch this flow and grow even more excited, some getting so impatient that they shove two cocks in your mouth at once, while the others stroke themselves in high lust. Occasionally, you feel several hands giving your asscheeks a spank, while others caress the rest of your body, which further makes you squirm at such unbearable, overwhelming pleasure. You cannot even think, your brain having been overtaken by only this need to get absolutely wrecked by all these devils, a trance that settles down all the way until the end. 'I'm gonna fill you up, cute stuff!' says the owner of your ass right before he shoots into you, having buried his cock all the way inside you, grunting as a generous demonic load is delivered into your bowels and fills you up as promised, with each throb of that thick warm meat further digging into you.";
	say "     His moaning gets to the others as well, who soon shoot all over your body, and do not seem content in just letting it go. As they keep firing their loads, they make sure to smear it all across your skin, taking great satisfaction from having showered you in their spunk. The ones in your mouth cum one right after the other, but their competitiveness over who gets to feed you ends up in a massive facial from both cocks shooting at your face. While your brain commands you to swallow what falls in your mouth, the rest covers your entire head and falls off your forehead, cheeks, nose, lips and chin, like thick drops slowly crawling downwards and making a huge mess.";
	WaitLineBreak;
	say "     Then, they all catch a breath and laugh to each other. 'Well, that's round one done. Who's got enough for a second?' one asks, 'Just get Arad out of [PosAdj] ass, then! I wanna fuck [ObjectPro] too!' another demands[if OFTKnowsItsArad is false], and now you know why that voice sounded so familiar to you... It is Arad, one of the twin bouncers from the Hellfire Club. How did he end up here? Anyway[end if], by the looks of it, the demons seem to want to have another go at you... It has not even been a minute and you see some of them stroking themselves again. 'Yeah, I'm going again. And I'm taking the ass, this time!' the first said, and you know what awaits you for who knows how long...";
	say "     Eventually, you lose track of time as the demons take you again and again, fucking you dumb from every side and showering you in more of their hellish spunk, and in the middle of all this, you are never allowed your climax. Not even once... And you are not even allowed to speak, as a cock fills your mouth at every time. But them seem to know what they are doing to you, as you grow so desperate for it that you begin to seek as much pleasure as you can from this endeavor, craving these hunks like your life depended on it. You whimper and squirm at an attempt to beg them to give you just a single, tiny little bit of release, but this seems to excite them even more. 'What's that? Is that you trying to say you wanted to cum too? You thought this wasn't punishment at all, heh?' one replies... And all your hopes are shattered.";
	WaitLineBreak;
	say "     The demons cum, while you do not. Not even once. And that is all on purpose so that you learn your lesson. To never mess with a hellfire demon...";
	WaitLineBreak;
	say "     Eventually, they begin to pack their gear and prepare to leave, as your body is leaking demon cum from absolutely everywhere. 'Should leave you here like this so that someone else takes advantage of you, little perv. Arad, it's your call, bro,' one of the devils say as they begin to leave the shack. Arad stays there, looking at you with a huge grin. 'Fucking hot, wasn't it? [if OFTKnowsItsArad is true]Told you it'd be fun[else]I hope you had fun[end if]!' You really are in no condition to reply to him, but however you felt about this would not change anything. The devil does untie you and carefully lowers you to the cum-soaked floor, getting rid of the ropes for you. 'See you around! Hope we get into more orgies like this one... Fuck, I'm gonna be thinking about it for a while.'";
	say "     After Arad finally leaves, you notice movement from the corner of your eye. 'I agree, that was really fun. Strange that these demons don't seem to turn people into other demons, right?' The coyote comes out of hiding and throws you a towel before he, too, walks out through the exit.";
	WaitLineBreak;
	say "     It takes you a while until you are able to get up, clean yourself and gather your stuff to leave this place. It seems you have been pranked.";
	CreatureSexAftermath "Player" receives "OralCock" from "Hellfire Demon";
	CreatureSexAftermath "Player" receives "AssFuck" from "Hellfire Demon";
	NPCSexAftermath Player receives "AssFuck" from Arad;
	increase Libido of Player by 50;


Diego Events ends here.
