Version 2 of Cherry by Gherod begins here.

"Adds a Pink Fox lady named Cherry to the game."

[Version 1 - File Created]
[Version 2 - Added Dominant Fox and Transformative Sex traits for Cherry. Dom Cherry added with one sex scene.]

Section 1 - Intro

Table of GameEventIDs (continued)
Object	Name
Pink Furred Scavenger	"Pink Furred Scavenger"

Pink Furred Scavenger is a situation.
ResolveFunction of Pink Furred Scavenger is "[ResolveEvent Pink Furred Scavenger]".
Sarea of Pink Furred Scavenger is "High".

to say ResolveEvent Pink Furred Scavenger:
	say "     On your way through one of the wealthiest regions in the vicinity, you spot a rather interesting building. This one was formerly a shopping mall. Not huge like [italic type]The Mall[roman type], but sizable still, filled with what were probably very expensive shops of anything you can imagine. Now that is a place worth of investigating, as even though this apocalypse had the impact it had, it is not very likely to have been able to empty an edifice like this completely out of their abandoned goods. You glance over it, and see an opportunity to enter it undetected by any roamers, looters or any other transformed creature who would certainly assault you on spot. Since you already committed to explore and see no danger ahead, you do not hesitate and proceed further, taking all precautions you can.";
	say "     So you walk inside, or rather sneak, but quickly, lest any unseen threat appears out of nowhere to grab you from behind or something, and certainly, you would not be in the mood for that, as your decision to proceed was immediate. But everything goes well. You do manage to reach the mall, avoid the shattered glass from the broken entrance doors and slip inside without any unnecessary injuries from the sharp shards still hanging from the corners. Obviously someone would have broken in, but that saves you the trouble of having to find an entrance. That is fine, as it gives you more time to explore. Opportunities like this, where you get to look around without any interruptions from attackers and offenders, are very rare, so you want to be smart about this.";
	WaitLineBreak;
	say "     Ahead of you is a big broad corridor that curves to the left. Seeing it from inside shows you that this mall is actually a supermarket merged with a few other inside shops of various things, including what was once a cafe shop, a clothing store, a shoe store, a laundry store... And it is all integrated in a single wide open area. It gives you an idea of why nobody is here, as once you are inside, you could see or be seen by anything or anyone passing by if you are not careful. But you are a cautious person, or least you feel like one this time, and try to walk a path that offers you some cover and protection through rubble, walls and obstacles whenever you can. Proceeding further takes you through a couple of stores that have already been looted, including that shoe one... It looks like you will not get a new pair of expensive shoes for free.";
	say "     But what is this...? You start to hear something. Something familiar... Which is not a synonym for something [italic type]good[roman type]. In fact, it is a sound you are too familiar with because of the state this region is in due to the nanites. Yes, you have heard it right... Moans and grunts, clearly of sexual nature. You do not urge to investigate, but you still do it, just to find out what the hell is going on. Of course, you have an idea, but it never hurts to be well informed. Walking silently, you proceed to investigate the source of this noise, into a clothing store which, surprisingly, still has clothes hanging around... Though they could definitely use a few days in the laundry store next to it.";
	WaitLineBreak;
	say "     Through the toppled furniture and debris, you manage to take a glance over what, or more precisely, who, is the cause of this racket. Your eyes widen as you spot a peculiar feminine furry shape topping a quite fit, yet helpless male creature. The scene is rather curious! You identify the male to be one of those very powerful feline men, a leopardman, to be exact, and he is getting absolutely dominated by a fuzzy pink-furred herm, who is clearly more feminine in appearance, were it not for her long pearl pink hair, large breasts, wide hips and extremely powerful looking thighs. She really does look strong, to have put a leopardman on his fours all by herself. Her fur is mostly pink pearl as well, except for her ears, tip of her limbs and tail, which are more of a bubblegum pink. You identify her as some sort of pink fox, and she seems to come equipped with a thick canine dong she is using to absolutely fuck the hell out of that masculine feline.";
	say "     None of them have noticed you yet, so you could, hypothetically, ignore this scenery and get out of here before you find yourself in a similar fate, or feel forced to fight whoever comes at you... Or, and this is just a thought, you could actually just... watch, if this interests you. It is quite a peculiar event...";
	LineBreak;
	say "     [bold type]How shall you proceed?[roman type][line break]";
	say "     ([link]Y[as]y[end link]) - Stay and watch from a safe position.";
	say "     ([link]N[as]n[end link]) - Just get the hell out of here.";
	if Player consents: [unlock Cherry events]
		Linebreak;
		say "     From your position, you do not think either of them can detect your presence, and you have a front seat for the scene that develops before your eyes. The leopardman seems to have no other choice but to keep taking that thick cock of hers deep in his tight hole, but his expression is of ecstatic bliss... as if he was actually enjoying being assfucked by the pink fox. She continues to thrust in deep and hard until, you think, she hits the climax, unloading her heavy balls inside the feline until the very last spurt is safely deposited inside the male. He cums too, over the floor underneath him, at the same time the furred herm's meaty member gives its final throbs inside the leopardman's ass.";
		say "     'You did well, but you don't deserve to be my pet. Naughties like you deserve only punishment.' she says, as she dismisses the feline, who can barely crawl away. 'Shoo, now. Hope you learned your lesson.' She has quite a feminine, sexy but sweet, tone in her voice, which tells you she is not just some sex-crazed creature. But before you wonder if you should talk to her, she seems to have noticed you while brushing her fur with her foxy paws. She sighs... 'Ahh, well... A lady can't take a day to do some scavenging without being pestered by opportunists. You know what happened to that one, so don't even try.' While you clearly have been warned, she sees you still standing in the same place, without having attacked her by now. Not like you had time to process any of this, but she lowers her guard as soon as she has a better look at you.";
		WaitLineBreak;
		say "     'Oh, pardon me. I thought you were another leopardman. Though I suppose this one enjoyed the outcome of his little audacity, I'm afraid his group wouldn't think the same way.' she approaches you cautiously, but does not seem to be hostile. In fact, she might be one of the friendliest people you have ever encountered in this district. 'My name's Cherry. Delighted to meet you.' she says, extending her hand to greet you in a very ladylike fashion. You play along and greet her accordingly, carefully holding her hand with a gentle shake. 'We must make haste if we don't want to get caught by more of those stinky catmen. A whole group of them would be... problematic. And with the looting I've made, today, I'd rather return with most of my fur intact. Care to accompany me?'";
		LineBreak;
		say "     [bold type]She seems to want you to follow her... Do you go?[roman type][line break]";
		say "     ([link]Y[as]y[end link]) - She seems nice enough.";
		say "     ([link]N[as]n[end link]) - Pass, but thank her for the invitation.";
		if Player consents:
			Linebreak;
			say "     You let her know that you would be delighted to accompany her in a very polite way, influenced by her manners. 'Oh, I do love to see a nice [if player is male]gentleman[else]person[end if], for a change. Follow me, then. I hope you can keep up.' Well, she really means she hopes you can keep up with her incredible agility, leaping through rubble and jumping around so swiftly it is even mesmerizing. You do your best, though, until you can make it out of the mall and safe from any further pursuers. After you run for a while, you take shelter by taking a small detour over to an empty corridor between two buildings, and manage to keep out of sight of any possible foes.";
			say "     'This should be far enough. There's no way they could follow us, now.' While she naturally seems to be running away from the group of felines, you do not get why she is having all the extra caution, so you ask her about that. 'This group of felines aren't like your typical unfortunate miscreant who happens to pick a bad time to try and assault you, no. These ones are a gang, and I've had a few... misadventures with some of them. They seem to have taken a special liking in me, or something. To be honest, I couldn't care less. I don't take any personal interest in them.' As she finishes speaking, she starts walking through the corridor, her fluffy tail swinging from one side to another in front of you, and you merely follow her.";
			WaitLineBreak;
			say "     'What were you doing, there? Scavenging, too?' she asks you. Seeing no harm in responding back, you tell her that it was indeed what you were trying to do, but had no luck, despite your initial thoughts. 'I've had quite a hard time finding anything there, as well... But eventually I could fill my bag. Hopefully this will last for at least a week.' She pauses as you both continue walking, turning to the right towards the entrance of a building. 'You seem nice. I'm unsure if you'd like to accompany me upstairs, into my apartment, for some tea... but I'd like to have you sometime, if not now.' Cherry says, in the form of an invitation.";
			LineBreak;
			say "     [bold type]Would you like to go up with her?[roman type][line break]";
			say "     ([link]Y[as]y[end link]) - Yes, accept her invitation.";
			say "     ([link]N[as]n[end link]) - Thank her, but say you have to refuse due to some urgent matters.";
			if Player consents:
				Linebreak;
				say "     With a nod, you accept her invitation and set yourself on following her. 'Splendid. I live in the third floor, so I hope you don't mind the climbing.' After you two walk up the stairs, Cherry unlocks the door to her modest apartment, which strikes you as quite cozy, with tasteful decoration. 'Take a seat and make yourself at home.'";
				wait for any key;
				now Resolution of Pink Furred Scavenger is 2; [accompanied Cherry to her apartment]
				AddNavPoint Cherry's Apartment;
				move Player to Cherry's Apartment;
			else:
				Linebreak;
				say "     Being invited over is always a pleasure, but you tell her that, unfortunately, you have to take care of a few urgent matters. 'No problem. You now know where I live, so whenever you want to visit me, my doors are open. Not literally, though, as that would be quite stupid, but you can knock. Third floor, to the right.' You see her smile before she goes inside, saying goodbye, and leaving you alone outside. At least, if you ever want to pursue any sort of relationship with Cherry, you now know where to find her.";
				now Resolution of Pink Furred Scavenger is 2; [accompanied Cherry to her apartment]
				AddNavPoint Cherry's Apartment;
		else:
			Linebreak;
			say "     You shake your head, denying her invitation but thanking her for extending it to you. 'Hm, perhaps I was too forward... My apologies. I shall get going, then, and you should do the same, lest you want to get gangbanged by a group of angry horny cats.' After she says goodbye, she disappears through the mall with incredible agility, and you never see her again.";
			say "     And perhaps, you should really follow her recommendation. You see a group of leopardmen approaching your position, and before they can notice you, you take some hiding spots towards an exit and get out of there. Better safe than sorry.";
			now Resolution of Pink Furred Scavenger is 1; [Met Cherry, but didn't follow her]
	else: [leave, Cherry goes missing]
		Linebreak;
		say "     You really do not want to spend any longer in here. Some sneaky creature could catch you anytime while you were not looking, and most stores you passed through have nothing of use for you to loot, so you decide to just go away.";
		say "     On your way back, though, you see a group of leopardmen running past you. They do not see you, but you have got a feeling that the one you found earlier, getting fucked by the pink fox, was not alone. However, it is too late to warn her. You cannot help but wonder if she will make it out of that situation...";
	now Pink Furred Scavenger is resolved;

Section 2 - Rooms

Table of GameRoomIDs (continued)
Object	Name
Cherry's Apartment	"Cherry's Apartment"

Cherry's Apartment is a room. It is a fasttravel. Cherry's Apartment is private.
The earea of Cherry's Apartment is "High".
Description of Cherry's Apartment is "[CherryApartmentDesc]".

to say CherryApartmentDesc:
	say "     It is no luxury place, but the pink fox's apartment is a rather cozy place, despite what the world outside has to offer. Cherry kept things neat and clean in most places, as well as given it a personal feminine touch regarding its decoration. In fact, all you see is an esteemed place that is well cared for its owner. The entrance door leads you immediately to the living room, which has a few couches sorrounding a small table in the center and a carpet underneath, colors matching soft tones of brown, wine red and a bit of gold. There is a kitchen separated only by its counter, as well as a few doors on the opposite side which, you would imagine, lead to either a bedroom or a bathroom.";

a postimport rule: [bugfixing rules for players that import savegames]
	if resolution of Pink Furred Scavenger >= 2 and Pink Furred Scavenger is resolved: [event resolved the right way, room not connected yet]
		AddNavPoint Cherry's Apartment;

instead of smelling Cherry's Apartment:
	say "     It somehow smells very sweet. Cherry must have been lucky enough to get her hands on some air fresheners or essence oils. Or perhaps it is some tea she is making...?";

Section 3 - Cherry NPC

Table of GameCharacterIDs (continued)
object	name
Cherry	"Cherry"

Cherry is a woman. Cherry is in Cherry's Apartment.
ScaleValue of Cherry is 3. [normal sized]
Body Weight of Cherry is 5. [scale of 1-9 for body weight, grouped into low weight (1-3), mid weight (4-6) and high weight (7-9)]
Body Definition of Cherry is 6. [scale of 1-9 for body definition, grouped into low muscle (1-3), mid muscle (4-6), high muscle (7-9)]
[Body Adjective is generated out of the body weight and body definition and can be used in scenes - one word descriptive adjective depending on weight and definition groups: low weight group: skinny/slender/lithe; mid weight group: average/fit/muscled; high weight group: pudgy/husky/jacked]
Androginity of Cherry is 8. [Gender Adjective is generated out of androginity 1-9: hypermasculine/masculine/somewhat effeminate/effeminate/androgynous/feminine butch/tomboyish/feminine/hyperfeminine]
Mouth Length of Cherry is 8. [inches deep for face fucking; maximum possible will be double this number (when deep throating)]
Mouth Circumference of Cherry is 3.  [mouth circumference 1-5, "tiny, small, normal, wide, gaping"]
Tongue Length of Cherry is 5. [length in inches]
Breast Size of Cherry is 8. [cup size as number, counting Flat Pecs = 0, A = 1, B = 2, ...]
Nipple Count of Cherry is 2. [count of nipples]
Asshole Depth of Cherry is 9. [inches deep for anal fucking]
Asshole Tightness of Cherry is 2. [asshole tightness 1-5, "extremely tight, tight, receptive, open, gaping"]
Cock Count of Cherry is 1. [number of cocks]
Cock Girth of Cherry is 4. [thickness 1-5, thin/slender/average/thick/monstrous]
Cock Length of Cherry is 9. [length in inches]
Ball Count of Cherry is 2. [allowed numbers: 1 (uniball), 2 or 4]
Ball Size of Cherry is 3. [size of balls 1-7: "acorn-sized", "dove egg-sized", "chicken egg-sized" "goose-egg sized", "ostrich-egg sized", "basketball-sized", "beachball-sized"]
Cunt Count of Cherry is 1. [number of cunts]
Cunt Depth of Cherry is 10. [penetratable length in inches; some minor stretching allowed, or more with Twisted Capacity]
Cunt Tightness of Cherry is 3. [size 1-5, generates adjectives of extremely tight/tight/receptive/open/gaping]
Clit Size of Cherry is 0. [size 1-5, very small/small/average/large/very large]
[Basic Interaction states as of game start]
PlayerMet of Cherry is false.
PlayerRomanced of Cherry is false.
PlayerFriended of Cherry is false.
PlayerControlled of Cherry is false.
PlayerFucked of Cherry is false.
OralVirgin of Cherry is false.
Virgin of Cherry is false.
AnalVirgin of Cherry is false.
PenileVirgin of Cherry is false.
SexuallyExperienced of Cherry is true.
TwistedCapacity of Cherry is false. [Twisted Characters can take any penetration, no matter the size]
Sterile of Cherry is true. [steriles can't knock people up. This is temporary for Cherry, until the player accepts being bred by her.]
MainInfection of Cherry is "Pink Fox".
Description of Cherry is "[CherryDesc]".
Conversation of Cherry is { "<This is nothing but a placeholder!>" }.
The scent of Cherry is "     She smells nice, like actual cherry flowers.".

to say CherryDesc:
	say "     Cherry is a tall fox-like person with overall pink fur, quite fit in appearance and looking very healthy, meaning she takes good care of herself. Carrying a friendly muzzle with sweet pink eyes and an elegant posture, she is wearing a white shirt, black tight slacks and a dark blue longcoat while standing on her bare vulpine feet, looking almost like an executive if she had the full matching set of clothing. Her fuzzy tail slips through a hole in her pants to wave around freely outside, and despite her quite feminine visage, you can spot an undeniable bulge in her front, proof that she is more than a fancy fox lady. She always greets you politely, with a slight smile and a bow with her head.";

[***********************************************************]
Section 3-1 - Cherry Talk Menu
[***********************************************************]

CherryDoneTalking is a truth state that varies.[@Tag:NotSaved]
CherryTea is a number that varies. CherryTea is usually 0.[@Tag:NotSaved]

instead of conversing Cherry:
	if CherryTea - turns < 7:
		say "     You take a seat on her couch, on one of the sides of the small table in the center. Cherry comes by and offers you some [one of]herbal[or]black[or]green[or]infusion[at random] tea she just made. 'Here, have some.' she says, before she takes her seat on the opposite side. 'So, how is the world out there treating you? Hopefully you haven't run into too much trouble...'";
		decrease thirst of Player by 15;
		now CherryTea is turns;
	else:
		say "     You take a seat on her couch, on one of the sides of the small table in the center. 'Did you want to talk?' she asks, focusing her attention on you.";
	say "[CherryTalkMenu]";

to say CherryTalkMenu:
	now CherryDoneTalking is false;
	say "     [bold type]What do you want to talk about with Cherry?[roman type][line break]";
	LineBreak;
	now sextablerun is 0;
	blank out the whole of table of fucking options;
	[]
	choose a blank row in table of fucking options;
	now title entry is "Herself";
	now sortorder entry is 1;
	now description entry is "Ask the pink fox about herself";
	[]
	if Energy of Cherry > 0:
		choose a blank row in table of fucking options;
		now title entry is "Pets";
		now sortorder entry is 2;
		now description entry is "She mentioned she made some threats her pets... What did she mean with that";
	[]
		choose a blank row in table of fucking options;
		now title entry is "Wealth";
		now sortorder entry is 2;
		now description entry is "Being a CEO means she had a lot of money, indeed... What happened";
	[]
	if Energy of Cherry > 1:
		choose a blank row in table of fucking options;
		now title entry is "Sex";
		now sortorder entry is 3;
		now description entry is "Talk about getting more intimate with the pink fox";
	[]
	if PlayerFucked of Cherry is true:
		choose a blank row in table of fucking options;
		now title entry is "Breeding Fetish";
		now sortorder entry is 4;
		now description entry is "She seems to be particularly into it. Ask her about that";
	[]
	if Energy of Cherry is 3 and player is not dominant:
		choose a blank row in table of fucking options;
		now title entry is "You as her sub";
		now sortorder entry is 5;
		now description entry is "Talk about the conditions of you as her submissive";
	[]
	sort the table of fucking options in sortorder order;
	repeat with y running from 1 to number of filled rows in table of fucking options:
		choose row y from the table of fucking options;
		say "[link][y] - [title entry][as][y][end link][line break]";
	say "[link]0 - Nevermind[as]0[end link][line break]";
	while sextablerun is 0:
		say "Pick the corresponding number> [run paragraph on]";
		get a number;
		if calcnumber > 0 and calcnumber <= the number of filled rows in table of fucking options:
			now current menu selection is calcnumber;
			choose row calcnumber in table of fucking options;
			say "[title entry]: [description entry]?";
			if Player consents:
				let nam be title entry;
				now sextablerun is 1;
				if (nam is "Herself"):
					say "[CherryTalkHerself]";
				else if (nam is "Pets"):
					say "[CherryTalkPets]";
				else if (nam is "Wealth"):
					say "[CherryTalkWealth]";
				else if (nam is "Sex"):
					say "[CherryTalkSex]";
				else if (nam is "Breeding Fetish"):
					say "[CherryTalkBreeding]";
				else if (nam is "You as her sub"):
					say "[CherryTalkDomination]";
				wait for any key;
				if CherryDoneTalking is false:
					say "[CherryTalkMenu]"; [looping back to keep talking with him]
		else if calcnumber is 0:
			now sextablerun is 1;
			say "     You excuse yourself as you get up, finishing any pending subjects with Cherry.";
			wait for any key;
		else:
			say "Invalid Option. Pick between 1 and [the number of filled rows in the table of fucking options] or 0 to exit.";
	clear the screen and hyperlink list;

to say CherryTalkHerself:
	say "     You did not get the chance to ask when you first met her, so this is as good a time as any to ask some questions. Bringing up your curiosity, you request that she tells you a bit more about herself, which she seems glad to oblige. 'I used to work at a big company here, in the district, as a CEO, before all this went to absolute chaos. You'd think I had enough money to just get the hell out of here before they quarantined the area, but unfortunately that wasn't possible. It all started so quickly I barely escaped with my mind untouched. My body... not so much. As you can see, I got my fair share of transformations, but I can't complain. Some had it worse.' She takes a sip of her own cup of tea before continuing to speak.";
	say "     'I don't want to talk much about it, but let's say I got too close to someone who... had already lost their sanity and... took what was left of my humanity with them. Which is why I find it hard to trust anyone these days. You seemed okay, though, and... I admit I've been feeling lonely for too long. I hope I haven't misjudged you, I used to have a great eye for people back in the days...' Cherry lets out a sigh as she resumes. 'Anyway... This old apartment is all I had left. A family member left it when she moved out of the country months ago, and handed me the keys. She never wanted to rent it... I guess she saw it coming. Lucky her, to be honest.'";
	WaitLineBreak;
	say "     So what happened to her own place, you ask... 'Completely ransacked by the time I got there to try to salvage something. It was a building located in the most populated area of the district, so by all means, extremely unsafe. Here it has always been a calm neighborhood, so nothing too crazy took place in the vicinity. Just had to fortify the building somewhat and get rid of any threats... even made some my personal pets. But that's a story for another time.'";
	say "     You thank her for telling you this.";
	if Energy of Cherry is 0:
		now Energy of Cherry is 1;

to say CherryTalkPets:
	say "     Cherry mentioned making someone her own personal pets. You cannot help but wonder what she meant with that, so you ask about it. She laughs. 'Oh, my dear, I mean what I said. Some people are like that leopardman. They just keep wanting more and more... But some just aren't too interesting to keep around, like... him. I have, however, made some that keep coming back to me, even offering me gifts as they come by to visit me just to get bred. They don't talk much, though. Hence why I still feel lonely... but it's good to have some action once in a while.' Bred, she said? You ask her more about it, out of curiosity. 'Yes, bred. That's my favorite thing to do. I used to peg my boyfriends, if that's what you're wondering. Call it a fetish, a kink... It's just what it is. That's why I didn't mind my transformation too much.'";
	if Energy of Cherry is 1:
		now Energy of Cherry is 2;

to say CherryTalkWealth:
	say "     Someone like her must have had a lot of money and influence back in the days. You cannot help but wonder how someone with such wealth still failed to leave the area before things went down south. 'You don't get to keep your hard-earned money when an apocalypse rains down on you.' - she quickly answers - 'And it's not like money is worth much, anyway. In the end, I was looking like an animal and had to be quarantined. No amount of money, power or influence can get you out once you become just another one left to rot. All I can do is survive until rescue arrives... If it ever will. I'm getting used to the idea of having to live the rest of my life like this... But, as I said, some had it worse.'";

to say CherryTalkSex:
	say "     You are left wondering if you could ever get intimate with the nice and elegant fox lady, so you get bold enough to ask the question. She smiles and delivers a direct response. 'Well, since we've already spoken a lot and I got to know you a little better... I suppose we could do something more fun. But only if you bottom. Given that fact, it would certainly be my pleasure to share some intimate moments with you. As I said, my favorite thing to do is breeding, with everything that comes with it, if you understand what I mean... I'd be down for it under those conditions.' Now, that was a quite blunt answer.";
	say "     It seems you can have sex with Cherry, but you must always submit to her and accept that she will always be the top... Unless there is some way to convince her to switch the cards around once in a while?";
	if Libido of Cherry is 0:
		now Libido of Cherry is 1;

to say CherryTalkBreeding:
	say "     You are aware that she mentioned it before, but experiencing it filled you with quite a lot of questions about the extent of this kink. With this in mind, you decide to ask her a little more about it, and she seems happy to explain. 'I like everything about it. The aspect of domination, the feeling of power over someone and the pleasure that comes from it... I've always been used to lead others and really enjoy being in positions of power, so I suppose this is an extension of that lifestyle. But regarding its extent...' she trails off, crossing her legs as she looks for words, 'I think I've said this before, but I do like everything that comes with it. The sex, the knotting, the breeding... I'd even like to have some offspring, at some point. I just didn't find the right receiver... yet.'";
	if player is submissive:
		say "     Cherry looks directly in your eyes as she finishes that sentence, and you feel her gaze piercing through you in a way that makes your heart race. She really does have that look about her, and you cannot deny that. It is as if she could command you with that alone, kicking off your submissive instincts in the most efficient of manners.";
		if Energy of Cherry is 2:
			now Energy of Cherry is 3;
	else if player is dominant:
		say "     Cherry looks directly in your eyes as she finishes that sentence, but it only leaves you sort of uncomfortable. 'I suppose I should keep looking, right? Maybe I'll find someone... submissive enough, one day. Not just anyone who doesn't mind bending over for a refined lady once in a while.' That surely reminded of you someone.";
	else:
		say "     Cherry looks directly in your eyes as she finishes that sentence, as if suggesting something. 'I suppose I could take applications. Especially eager people who love getting knocked up are preferred, but not just anyone. I do have standards...'";
		if Energy of Cherry is 2:
			now Energy of Cherry is 3;

to say CherryTalkDomination:
	if Energy of Cherry is 3:
		say "     Given your last conversation about the subject, you ask Cherry if she would take you as her submissive, before anything else. She smiles and joyfully replies 'Well, I would, of course!' but then changes her tone to a slightly more serious one. 'I would, however, expect you to follow certain rules and accept a few terms. Like I said, I don't take just about anyone who asks... Only those who behave and agree to my conditions, after showing the required eagerness. This does not mean that I'd take advantage of such people in this situation, no. This is a deal between us both, and whenever something makes either of us unhappy or uncomfortable, it should be spoken. I like to keep a clear and transparent relationship with my subs.'";
		WaitLineBreak;
		say "     As she ensures that everything has been said, you nod and pay attention to every word. 'Good, so, with that having been explained, I ask... Would you be willing to allow your body to be transformed into something more... Well, like me?' Cherry asks, her fluffy tail swinging around slightly behind her as she awaits your answer.";
		LineBreak;
		say "     ([link]Y[as]y[end link]) - Yes, you would allow her to transform you.";
		say "     ([link]N[as]n[end link]) - No, you are not into that.";
		if Player consents:
			Linebreak;
			say "     You say that you are definitely into it and that she could feel free to do so. She nods with a smile and a hint of blush appears on her cheeks, but she tries hard to not show it. 'That is most delightful, my dear... I do appreciate your permission on that. Although, this is not a requirement. If you, for some reason, wish to not keep getting transformative effects from our encounters, just let me know.'";
			TraitGain "Transformative Sex" for Cherry;
		else:
			LineBreak;
			say "     You apologize, but that is something you would not like. She gives you an understanding nod. 'That's fine. Thank you for being honest. This wasn't a requirement, but I appreciate you for being truthful with me.'";
			TraitLoss "Transformative Sex" for Cherry;
		WaitLineBreak;
		say "     She then resumes her inquiry. 'This one is a requirement, however. Would you be willing to bear my children, at some point?'";
		if player is male and player is not female and "MPreg" is not listed in feats of player:
			say "     You raise an eyebrow at that question, given your sex, and ask her how would that be possible given the circumstances. She immediately responds 'Dear, [']at some point['], I said. Don't think too much about it.'";
		else if player is male and player is not female and "MPreg" is listed in feats of player:
			say "     You know that, despite being a male, you can bear childrens of others who knock you up, and you ask her if she knew about that, already. She immediately responds 'You do have that look about yourself, my dear... I'm rarely wrong.'";
		else if player is female:
			say "     You know this to be possible due to your sex, so the answer is entirely up to you.";
		else:
			say "     You raise an eyebrow at that question, given your lack of sex, and ask her how would that be possible given the circumstances. She immediately responds 'Dear, [']at some point['], I said. Don't think too much about it.'";
		say "     What say you? Would you be willing to carry Cherry's children inside you?";
		LineBreak;
		say "     ([link]Y[as]y[end link]) - Yes, you would allow her to impregnate you, at some point.";
		say "     ([link]N[as]n[end link]) - No, you are definitely not into that.";
		if Player consents:
			LineBreak;
			say "     This is something you agree on, and she seems delightful to hear it. 'Good! That is... very pleasant to know. Very well, then. I shall no longer take any contraceptives measures with you. I can't wait to see you swollen with my kits... That'll be a delicious sight.'";
			now Sterile of Cherry is false;
			WaitLineBreak;
			say "     'Anyway, last question... This one should be easy for you. Do you agree on becoming my submissive and allow me to take you from any entrance I desire?'";
			LineBreak;
			say "     ([link]Y[as]y[end link]) - Nod and say you accept ([bold type]This is irreversible and Cherry will always regard you as Submissive, even if you become Dominant at a later point[roman type]).";
			say "     ([link]N[as]n[end link]) - You actually do not like to bottom that much.";
			if Player consents:
				LineBreak;
				say "     With this being the last requirement Cherry makes, you accepting these terms officially makes you Cherry's submissive. 'Beautiful, my dear. I'm so happy to have found someone who is compatible with my tastes. I shall take very good care of you, I promise.' By the time you are done with the conversation, you can see that the fox already got slightly excited, probably thinking of all the things you could be doing now, that you have agreed on all her conditions. 'Now, with that finally out of the way, I am certain we shall have a lot of fun together.'";
				TraitGain "Dominant Fox" for Cherry;
				now Energy of Cherry is 4;
			else:
				LineBreak;
				say "     To be honest, you really do not like to always be the bottom, so you let her know that. 'Oh, that is... curious, given your eagerness from before. But I don't judge. We can still have other kinds of fun, I suppose. If you ever change your mind, however, you can come talk to me, again.' The conversation is over as you deny her last requirement, but she does not take it in any bad way, still willing to converse with you if you wish so.";
		else:
			LineBreak;
			say "     You have to draw the line here, as you are not looking to have anyone's kids anytime soon, or at least with her. 'I see. A shame, but that is a deal breaker for me, then. We can still have some harmless sex with just infertile sperm going inside you, I suppose. That is nowhere near as fun, though... But alright. If you change your mind, you can come talk to me, again.' The conversation is over as you deny her first requirement, but she does not take it in any bad way, still willing to converse with you if you wish so.";
			now Sterile of Cherry is true;
	else if Energy of Cherry > 3:
		say "     You would like to talk to Cherry about your conditions as her submissive. She listens to what you have to say with all the attention. 'Yes, my dear? What is it that you want to discuss?'";
		LineBreak;
		say "     [link](1)[as]1[end link] - Transformation during sex.";
		say "     [link](2)[as]2[end link] - Pregnancy matters.";
		say "     [link](3)[as]3[end link] - Nothing, actually.";
		now calcnumber is 0;
		while calcnumber < 1 or calcnumber > 3:
			say "Choice? (1-3)>[run paragraph on]";
			get a number;
			if calcnumber is 1 or calcnumber is 2 or calcnumber is 3:
				break;
			else:
				say "Invalid choice. Type [link]1[end link] to talk about transformation, [link]2[end link] to talk about fertility or [link]3[end link] to quit the conversation.";
		if calcnumber is 1:
			LineBreak;
			if "Transformative Sex" is listed in traits of Cherry:
				say "     'Certainly! I hope you like the prospective of becoming a lovely pink fox like me? Or do you wish to change your mind?' Currently, sex with Cherry [bold type]will cause you to get the Pink Fox transformation[roman type] effect.";
			else:
				say "     'Of course! Do you wish to allow yourself to become a lovely pink fox like me?' Currently, sex with Cherry [bold type]is not causing any transformative effects[roman type] on you.";
			LineBreak;
			say "     ([link]Y[as]y[end link]) - Allow transformation.";
			say "     ([link]N[as]n[end link]) - No transformation.";
			if player consents:
				say "     You say that you are definitely into it and that she could feel free to do so. She nods with a smile and a hint of blush appears on her cheeks, but she tries hard to not show it. 'That is most delightful, my dear... I do appreciate your agreement on that. Although, if you, for some reason, wish to not keep getting transformative effects from our encounters, just let me know.'";
				say "     Cherry is [bold type]now allowing her infection into you[roman type] and will transform you during sex.";
				TraitGain "Transformative Sex" for Cherry;
			else:
				say "     You apologize, but that is something you would not like to have happening. She gives you an understanding nod. 'That's fine. Thank you for being honest, I truly appreciate you for being truthful with me. If you do change your mind, however, I'll be glad to hear it from you.'";
				say "     Cherry is [bold type]no longer transforming[roman type] you during sex.";
				TraitLoss "Transformative Sex" for Cherry;
		else if calcnumber is 2:
			LineBreak;
			if Sterile of Cherry is false:
				say "     'Oh, of course... What is it, my dear? Is something troubling you?' Currently, Cherry [bold type]is fertile[roman type].";
			else if Sterile of Cherry is true:
				say "     'Ah, yes! Shall I stop taking the contraceptives, finally? I don't wish to impose too much, but... I did allow this breach in our deal in your consideration.' Currently, Cherry [bold type]is taking contraceptives[roman type].";
			LineBreak;
			say "     ([link]Y[as]y[end link]) - Ask her to keep taking contraceptives, for now.";
			say "     ([link]N[as]n[end link]) - You are okay with getting impregnated by her.";
			if player consents:
				LineBreak;
				if Sterile of Cherry is false:
					say "     Unfortunately, due to some personal circumstances, you have to ask her to take contraceptives in order to prevent pregnancies, as you cannot allow that to happen, right now. 'Oh? But, my dear, that is part of my deal with you. Is something the matter?' she asks, and you explain that, for now, that would be for the best of both. 'I see... I really can't deny such a request from you, although I'm sad to hear. Very well, I shall begin to take contraceptives. Hopefully this isn't forever... but I'll do this for you.'";
				else:
					say "     Unfortunately, things have not changed for you, so you must ask Cherry to continue taking her contraceptives. She looks disappointed, but does not fight it. 'Ah... I was getting my hopes up. Surely, my dear, I'll keep doing so... For you. I just hope it isn't forever...'";
				say "     Cherry is [bold type]no longer fertile[roman type] and will not impregnate you during sex.";
				now Sterile of Cherry is true;
			else:
				LineBreak;
				say "     You tell her that you are more than happy to bear her kits, and she seems delightful to hear it. 'Good! That is... very pleasant to know. Very well, then. I like to hear I don't need to take any contraceptives measures with you. I can't wait to see you swollen with my kits... That'll be a delicious sight.'";
				say "     Cherry is [bold type]now fertile[roman type] and will impregnate you during sex.";
				now Sterile of Cherry is false;
		else if calcnumber is 3:
			LineBreak;
			say "     You tell her that it is nothing, actually. She gives you a questioning look, but drops the subject when you do.";

Section 3-2 - Cherry Sex menu

Instead of fucking Cherry:
	if "Dominant Fox" is listed in traits of Cherry:
		say "[CherryDomSex]";
	else:
		say "[CherrySexMenu]";

to say CherrySexMenu:
	if Libido of Cherry is 0:
		say "     Maybe you should talk to her about sex before you jump right into it...";
	else if Libido of Cherry > 0:
		if lastfuck of Cherry - turns < 6:
			say "     You move towards Cherry with a suggestive look, but she quickly dismisses you. 'So quickly after our last round? Give it some time, now... You can't get everything at once...!' she says, in a kind of a playful way. Maybe you should wait some time before asking her again.";
		else:
			say "     You move towards Cherry with a suggestive look, and she seems receptive to your advances. 'Well well... How shall you pleasure me, then?'";
			now sextablerun is 0;
			blank out the whole of table of fucking options;
			[]
			choose a blank row in table of fucking options;
			now title entry is "Bend over for the pink fox";
			now sortorder entry is 1;
			now description entry is "Let Cherry breed you";
			[]
			sort the table of fucking options in sortorder order;
			repeat with y running from 1 to number of filled rows in table of fucking options:
				choose row y from the table of fucking options;
				say "[link][y] - [title entry][as][y][end link][line break]";
			say "[link]0 - Nevermind[as]0[end link][line break]";
			while sextablerun is 0:
				say "Pick the corresponding number> [run paragraph on]";
				get a number;
				if calcnumber > 0 and calcnumber <= the number of filled rows in table of fucking options:
					now current menu selection is calcnumber;
					choose row calcnumber in table of fucking options;
					say "[title entry]: [description entry]?";
					if Player consents:
						let nam be title entry;
						now sextablerun is 1;
						if (nam is "Bend over for the pink fox"):
							say "[CherryFuck]";
						wait for any key;
				else if calcnumber is 0:
					now sextablerun is 1;
					say "     You politely excuse yourself, as you have changed your mind. She simply nods.";
					wait for any key;
				else:
					say "Invalid Option. Pick between 1 and [the number of filled rows in the table of fucking options].";
			clear the screen and hyperlink list;

to say CherryFuck:
	say "     You know what she wants, and that happens to be exactly what you want as well. Though she doesn't let you approach her too closely. Instead, she stands up in front of you, looks into your eyes intensely, her pink irises gleaming with her seductive gaze, brushing her foxy fingers along your chin... as she slowly lets her longcoat fall to her feet, revealing only her white shirt, its transparency teasing you with a peek at her very ample bosom, only held by a black bra that is barely enough to cover those H-cups. She then has you watch her strip, as she slowly unbuttons her shirt, letting you feast your eyes on her cleavage... And that too goes down as she lets her last piece of clothing, apart from her slacks, falling to the floor.";
	say "     'Enjoying the sights?' she says, teasing you as she slowly brings her hands over to her back in order to take her bra off, revealing her boobs on plain view right before your eyes, just enough size to fill your vision with joy. Another quite sizable thing is the bulge down her pants, visibly pulsing with eagerness as she grabs you by the hands and brings them over to her silhouette. You only get to see her chest as she has you touch the sides of her waist, leading you over to her slacks. 'Help me take these off, will you, my dear?' - she asks you, giving you the task to undo her belt, but stopping you midway - 'Patiently. No need to rush things.' Knowing now you have to do it as she says, you carefully remove her belt off her slacks, unbutton them, then slide them down her furred legs. You struggle a bit with her hips and thighs, as they are ample and strong enough to prove a challenge in trying to remove such tight pants.";
	WaitLineBreak;
	say "     Now all that is left is a feminine black thong, which matches with her bra, and fails to cover most of her meat that is already peeking outside the fabric. 'Back away, now... No touching allowed.' she orders, and you have to consent, or she won't let things continue. Stepping back and watching her from several additional inches, she begins to slide her underwear down, letting her nine incher of a knotted cock pop out, happy to be free, as a pair of plump balls rest hanging underneath, looking full. As the thong slides down to join the remaining pieces of removed clothing, she simply takes one step forward, then another, and swiftly kicks them out of the way. You are now looking at the herm pink fox naked, hard and ready to claim you.";
	say "     'Now now... I believe you have something that belongs to me.' she suggests, making a spiral gesture with her hand, a finger pointed upwards, signaling you to turn around. You do so, bending over the couch, [if player is not naked]not before removing your gear and stripping completely naked for her[else]exposing your naked body to her[end if], and present your [if player is female]pussy[else]ass[end if] to her. She approaches you with a hand ready to slap one of your buttocks as she admires the view. 'Now that's a good [boygirl]. Doing what you're told... Nothing pleases me more than that.' she provokes you, sliding a finger over your [if player is female]wet curls, glistening in arousal[else]asshole, already craving for a filling[end if] and teasing you quite a bit before making another move. Now it won't be her finger, but the tip of her rod, rubbing against your sensitive [if player is female]labia[else]anus[end if] as you can only endure the anticipation.";
	WaitLineBreak;
	say "     As she positions herself steadily behind you, grabbing your hips with both hands, she begins to push her length inside you. It's a thick one, a vulpine knotted cock invading your [if player is female]sex[else]hole[end if] and sending you shivers of pleasure as your body welcomes it, stretching around her girth. Cherry's pulsing erection continues to drill deep inside you as she does not push back, not even once, going all in right until only her knot remains outside. Now as you are properly impaled in her member, she begins to thrust, pulling out and pushing in, fucking you in the only manner she sees most appropriate... Slow and steady at first, but increasing in intensity as she picks up the pace.";
	say "     'That's it... taking it in like a good little pet. You're doing well...' teases the pink fox, pounding you hard and rhythmically as the sounds of intense fucking spread through her modest residence. As you feel the cock inside you pulse and throb even more, you give in to the situation completely, letting her ram into your [if player is female]pussy[else]ass[end if] as she sees fit, as hard and as deep as the whim takes her. This goes on for several minutes without cease, her pounding keeping strong and persistent as she keeps you pinned down against her couch and underneath her presence with your [if player is female]womanhood[else]rear[end if] up. 'Mmh... Maybe I should get ready to fill you up, now...' she says, making only a brief pause as she slows down temporarily...";
	WaitLineBreak;
	say "     It seems she is getting close, as her erection throbs compulsively, warm like an incandescent bulb. That is when she decides to push in deeper... Deeper than before, as something even girthier passes through your [if player is female]lower lips[else]orifice[end if] with relative ease. She lets out a moan as she doesn't let it go fully inside just yet, but the mere sensations around her knotted cock are bringing her closer and closer... 'Ohh... yes... Here it goes...!' Cherry goes fully inside you, knot and everything, as she delivers her generous load into you, spurt after spurt of creamy hot seed coating your [if player is female]womb[else]fleshy insides[end if] until the very last drop. You, too, feel yourself being brought over the edge, [if player is male]your own [cock of player] dick exploding in a joyful load which ends up landing all over her couch[else]a surge of intense pleasure making you quiver and squirm all over as your own orgasm bursts through you.[end if][line break]";
	say "     Once her knot deflates, she is finally able to let you go, leaving your energy completely exhausted after how intense that all was.";
	if player is male and player is submissive:
		say "     'Oh my... Look at what you've done to my couch...' She exclaims, though not in an angry manner. 'Just shameful. Make sure you lick it clean before you go.' That was not a request, either. It was an order, and she is not letting you go until you lick your own cum off her furniture. You really have no choice but to do it as she overviews your task. It thrills you as your submissive instincts kick in, and suddenly, you are giving your best at licking and slurping all the mess you have done, in hopes to satisfy her. Your tongue picks up on the still warm drops of your own spunk and your lips catch whatever escapes your slick organ's reach, taking some time to finish Cherry's command, but doing it properly. 'Good pet. Keep that up and I'll think about keeping you...'";
	WaitLineBreak;
	say "     'Hmm... That was most pleasurable for myself. I hope you enjoyed it, as well?' She asks you, returning to her polite and classy manner as she picks up her own clothes. 'I shall bring you a towel, if you need.' Whatever the case, you have left Cherry pleased and happy.";
	if player is female:
		NPCSexAftermath Player receives "PussyFuck" from Cherry;
	else:
		NPCSexAftermath Player receives "AssFuck" from Cherry;
	if "Transformative Sex" is listed in traits of Cherry:
		infect "Pink Fox";

to say CherryDomSex:
	if lastfuck of Cherry - turns < 6:
		say "     You move towards Cherry with a suggestive look, but she quickly dismisses you. 'So quickly after our last round? Give it some time, now... You can't get everything at once...!' she says, in a kind of a playful way. Maybe you should wait some time before asking her again.";
	else:
		say "     You move towards Cherry with a suggestive look, and she seems receptive to your advances. 'Oh? Is my pet in the mood for some play?' She eyes you from above while she is still sitting on her couch, having you kneel before her as you await her decision regarding what to do with you.";
		WaitLineBreak;
		let randomnumber be a random number from 1 to 2; [adjust the latter number for the number of options]
		if randomnumber is:
			-- 1: [Cherry Dom Fuck]
				say "     'How about we put your mouth to work while I consider breeding you? That sounds like a lovely idea, actually...' she asks, but to you, that sounds like an order. As she shifts her position slightly to allow you to approach her, the one thing that jumps to the eye is her cock raising to attention when you just get closer. You nod respectfully before your mistress, who smiles at your obedience, as you begin to wrap your lips around her girthy shaft, slowly hardening even further. With your hands, you jerk it at its base while your tongue circles around the tip, then bury several inches deep in your mouth. 'You like it? It's a treat for being such a good [boygirl]...'";
				say "     With as much enthusiasm as you can gather, you suck on her cock, but more than that, you worship it. You want her to be satisfied with your efforts when she sees you have made her hard and ready to put it in your [if player is female]pussy[else]ass, to fuck you until she delivers her babies inside you. Rubbing it, pushing your lips up and down against her member, licking it all over and even tilting your head around to give her everything, Cherry notes your eagerness. The pink fox seems quite pleased with you when you look at her in the eyes, a sweet smile forming across her face like the caring mistress she is, as she forward her hand and strokes your cheek affectionately. 'Good job, pet. I'm ready, now.'";
				WaitLineBreak;
				say "     As you hear this, she pulls her cock away from your mouth, with this popping sound as your lips slide across its head. She stands up, with her nine inch cock throbbing and ready to bend you over. But you know what she wants before she says it, and you get on all fours in front of her, arching your back and exposing your rear side to her. 'What a lovely sight...' she says as she squeezes one of your buttcheeks, getting behind you to align her cock with [if player is female]one of your entrances[else]your anal entrance[end if]. At first, she teases you with it, only rubbing her wet tip against [if player is female]your wet curls[else]your sensitive pucker[end if], and that makes you want it very badly. You end up mindlessly seeking for it, pushing your rear side backwards, but she stops you, holding you still.";
				say "     'You're so impatient, my dear... But I'm pleased to see you really want this...' She then begins to press her erection against you, slowly pushing it in as you feel that cock of hers entering you, a delightful sensation of pleasure suddenly striking your entire self. Cherry keeps hold of your hips as she carries on burying her length inside you, pushing inch after inch into your [if player is female]sex[else]ass[end if]. This causes you to let out a moan as your insides are taken by your mistress, who proceeds to thrust back and forth when her tool finally finds itself fully inserted into you, besides the knot. You feel that pretuberancy bumping against your [if player is female]vulva[else]hole[end if] as she fucks you, slowly at first, taking her time to feel you up from the inside.";
				WaitLineBreak;
				say "     But Cherry is only sweet and slow for a while, until you feel her practically climbing on top of you and picking up the pace. You begin to feel her weight on top of you, her sheer power keeping you pinned down underneath her as she fucks you deep, then harder, making your insides bounce with the forceful impact of her thrusts. 'Relax, my pet... Let me take care of you.' She continues this rhythm, going at it faster and faster without letting go as you are only left there, on all fours, taking it doggy style from the dominant pink fox. For a rather refined lady, she does some really mean thrusts, going at it so hard that the momentum sends you back and forth along the motion.";
				say "     Her knot begins to want to go inside you, as well, and as you feel her getting close, the pink fox finally pushes in completely, locking herself into you. 'Take it, pet... Take it all...!' she moans out loud, her cock throbbing intensely as her balls begin to send the cum out of her and into your [if player is female]womb[else]bowels[end if]. You take every single drop from beginning to end, all part of a very generous load Cherry deposits in you, filling you up with warm and creamy jizz that you can already feel sloshing within you. The thrill of getting bred by your mistress also made you climax just right after she did, [if player is male]your cock releasing your own load on the floor[else]an intense wave of pleasure overtaking you as your bottom half quivers in ecstasy[end if]. She takes a moment to catch her breath, seeing that she is locked into you.";
				WaitLineBreak;
				say "     'I'm pleased that you enjoyed yourself as well, pet. We might continue later on. For now...' she trails off in her words as she grabs you from behind, her hands over your torso as you lie down on the groun with her on top of you. 'Let us enjoy each other's embrace until I'm able to pull out. Then, I'll make some tea for us, if you want.' You and Cherry remain there, lying down on the floor and hugging each other as you wait for her cock to soften down while still inside you. Her fur feels really soft against your body, which does cause you to close your eyes, feeling a little drowsy. You both decide to take a little nap together before thinking of getting up.";
				if player is female:
					NPCSexAftermath Player receives "PussyFuck" from Cherry;
				else:
					NPCSexAftermath Player receives "AssFuck" from Cherry;
				if "Transformative Sex" is listed in traits of Cherry:
					infect "Pink Fox";
			-- 2: [Cherry Normal Fuck]
				say "[CherryFuck]";

Cherry ends here.
