Version 1 of Hellfire Workers by Gherod begins here.

"Adds NPCs to the Hellfire Club."

[Version 1 - File created - Gherod]

[***********************************************************]
Section 1 - Arad & Egran
[***********************************************************]

[ARAD]

Table of GameCharacterIDs (continued)
object	name
Arad	"Arad"

Arad is a man. Arad is in Hellfire Club.
ScaleValue of Arad is 4. [DB sized]
Body Weight of Arad is 6. [scale of 1-9 for body weight, grouped into low weight (1-3), mid weight (4-6) and high weight (7-9)]
Body Definition of Arad is 9. [scale of 1-9 for body definition, grouped into low muscle (1-3), mid muscle (4-6), high muscle (7-9)]
[Body Adjective is generated out of the body weight and body definition and can be used in scenes - one word descriptive adjective depending on weight and definition groups: low weight group: skinny/slender/lithe; mid weight group: average/fit/muscled; high weight group: pudgy/husky/jacked]
Androginity of Arad is 2. [Gender Adjective is generated out of androginity 1-9: hypermasculine/masculine/somewhat effeminate/effeminate/androgynous/feminine butch/tomboyish/feminine/hyperfeminine]
Mouth Length of Arad is 9. [inches deep for face fucking; maximum possible will be double this number (when deep throating)]
Mouth Circumference of Arad is 3.  [mouth circumference 1-5, "tiny, small, normal, wide, gaping"]
Tongue Length of Arad is 8. [length in inches]
Breast Size of Arad is 0. [cup size as number, counting Flat Pecs = 0, A = 1, B = 2, ...]
Nipple Count of Arad is 2. [count of nipples]
Asshole Depth of Arad is 15. [inches deep for anal fucking]
Asshole Tightness of Arad is 3. [asshole tightness 1-5, "extremely tight, tight, receptive, open, gaping"]
Cock Count of Arad is 1. [number of cocks]
Cock Girth of Arad is 4. [thickness 1-5, thin/slender/average/thick/monstrous]
Cock Length of Arad is 16. [length in inches]
Ball Count of Arad is 2. [allowed numbers: 1 (uniball), 2 or 4]
Ball Size of Arad is 4. [size of balls 1-7: "acorn-sized", "dove egg-sized", "chicken egg-sized" "goose-egg sized", "ostrich-egg sized", "basketball-sized", "beachball-sized"]
Cunt Count of Arad is 0. [number of cunts]
Cunt Depth of Arad is 0. [penetratable length in inches; some minor stretching allowed, or more with Twisted Capacity]
Cunt Tightness of Arad is 0. [size 1-5, generates adjectives of extremely tight/tight/receptive/open/gaping]
Clit Size of Arad is 0. [size 1-5, very small/small/average/large/very large]
[Basic Interaction states as of game start]
PlayerMet of Arad is true.
PlayerRomanced of Arad is false.
PlayerFriended of Arad is false.
PlayerControlled of Arad is false.
PlayerFucked of Arad is false.
OralVirgin of Arad is false.
Virgin of Arad is true.
AnalVirgin of Arad is false.
PenileVirgin of Arad is false.
SexuallyExperienced of Arad is true.
TwistedCapacity of Arad is true. [Twisted Characters can take any penetration, no matter the size]
Sterile of Arad is true. [steriles can't knock people up]
MainInfection of Arad is "Hellfire Demon".
Description of Arad is "[Araddesc]".
Conversation of Arad is { "<This is nothing but a placeholder!>" }.
The scent of Arad is "     Arad smells faintly of brimstone, but he has a rather attractive, masculine scent".

to say AradDesc:
	say "     Posing with his chest puffed and weapons visible, Arad is always standing next to Egran, his twin brother, by the door. He is very similar to the more common red-skinned Hellfire Demons, except he is overall more robust, looks stronger and his horns seem slightly bigger. His distinguishing feature is a straight scar across the area surrounding his right eye and a nose piercing hugging his left nostril, while also keeping a simple five o'clock shadow compared to his brother. To hold his sharp obsidian short blades, he has a couple of holsters strapped around his legs, which remain visible due to the fact he is only wearing a black leather jockstrap just right for his size, and around his jacked torso, he wears simple black leather harness with shiny steel studs across one of the frontal straps.";

[EGRAN]

Table of GameCharacterIDs (continued)
object	name
Egran	"Egran"

Egran is a man. Egran is in Hellfire Club.
ScaleValue of Egran is 4. [DB sized]
Body Weight of Egran is 6. [scale of 1-9 for body weight, grouped into low weight (1-3), mid weight (4-6) and high weight (7-9)]
Body Definition of Egran is 9. [scale of 1-9 for body definition, grouped into low muscle (1-3), mid muscle (4-6), high muscle (7-9)]
[Body Adjective is generated out of the body weight and body definition and can be used in scenes - one word descriptive adjective depending on weight and definition groups: low weight group: skinny/slender/lithe; mid weight group: average/fit/muscled; high weight group: pudgy/husky/jacked]
Androginity of Egran is 2. [Gender Adjective is generated out of androginity 1-9: hypermasculine/masculine/somewhat effeminate/effeminate/androgynous/feminine butch/tomboyish/feminine/hyperfeminine]
Mouth Length of Egran is 9. [inches deep for face fucking; maximum possible will be double this number (when deep throating)]
Mouth Circumference of Egran is 3.  [mouth circumference 1-5, "tiny, small, normal, wide, gaping"]
Tongue Length of Egran is 8. [length in inches]
Breast Size of Egran is 0. [cup size as number, counting Flat Pecs = 0, A = 1, B = 2, ...]
Nipple Count of Egran is 2. [count of nipples]
Asshole Depth of Egran is 15. [inches deep for anal fucking]
Asshole Tightness of Egran is 3. [asshole tightness 1-5, "extremely tight, tight, receptive, open, gaping"]
Cock Count of Egran is 1. [number of cocks]
Cock Girth of Egran is 4. [thickness 1-5, thin/slender/average/thick/monstrous]
Cock Length of Egran is 15. [length in inches]
Ball Count of Egran is 2. [allowed numbers: 1 (uniball), 2 or 4]
Ball Size of Egran is 4. [size of balls 1-7: "acorn-sized", "dove egg-sized", "chicken egg-sized" "goose-egg sized", "ostrich-egg sized", "basketball-sized", "beachball-sized"]
Cunt Count of Egran is 0. [number of cunts]
Cunt Depth of Egran is 0. [penetratable length in inches; some minor stretching allowed, or more with Twisted Capacity]
Cunt Tightness of Egran is 0. [size 1-5, generates adjectives of extremely tight/tight/receptive/open/gaping]
Clit Size of Egran is 0. [size 1-5, very small/small/average/large/very large]
[Basic Interaction states as of game start]
PlayerMet of Egran is false.
PlayerRomanced of Egran is false.
PlayerFriended of Egran is false.
PlayerControlled of Egran is false.
PlayerFucked of Egran is false.
OralVirgin of Egran is false.
Virgin of Egran is true.
AnalVirgin of Egran is false.
PenileVirgin of Egran is false.
SexuallyExperienced of Egran is true.
TwistedCapacity of Egran is true. [Twisted Characters can take any penetration, no matter the size]
Sterile of Egran is true. [steriles can't knock people up]
MainInfection of Egran is "Hellfire Demon".
Description of Egran is "[Egrandesc]".
Conversation of Egran is { "<This is nothing but a placeholder!>" }.
The scent of Egran is "     Egran smells faintly of brimstone, but he has a rather attractive, masculine scent".

to say EgranDesc:
	say "     Egran stands next to Arad, his twin brother, by the door. He is very similar to the more common red-skinned Hellfire Demons, except he is overall more robust, looks stronger and his horns seem slightly bigger. Regarding his attire, he is more subtle when it comes to show his might, giving only his fingerless gloves a dim fiery gleam that suggests his proficiency at wielding fire, but has a black leather harness and jockstrap set of his own wrapped around his jacked body. His distinguishing features are a full beard, a stud on the bottom of his left ear and two small rings on top. He also has a couple of straps wrapped around his legs, but they are only decorative.";

[***********************************************************]
Section 1-1 - Arad Talk
[***********************************************************]

AradDoneTalking is a truth state that varies.[@Tag:NotSaved]

instead of conversing Arad:
	say "     You approach the entrance to the Hellfire Club, more specifically, the two hellfire demons guarding the gate. 'Well, hey there! Have you been enjoying your stay?' says Arad, the scarred one of the demon duo, to whom you wish you talk with.";
	now AradDoneTalking is false;
	say "[AradTalkMenu]";

to say AradTalkMenu:
	say "     [bold type]What do you want to talk to Arad about?[roman type][line break]";
	LineBreak;
	now sextablerun is 0;
	blank out the whole of table of fucking options;
	[]
	choose a blank row in table of fucking options;
	now title entry is "Himself";
	now sortorder entry is 1;
	now description entry is "Ask the scarred demon guard about himself";
	[]
	if Energy of Arad > 0:
		choose a blank row in table of fucking options;
		now title entry is "His brother";
		now sortorder entry is 2;
		now description entry is "Ask about his twin brother, Egran";
	[]
	if Energy of Arad > 1:
		choose a blank row in table of fucking options;
		now title entry is "Sex";
		now sortorder entry is 3;
		now description entry is "You kind of fancy him... would there be any chance";
	[]
	sort the table of fucking options in sortorder order;
	repeat with y running from 1 to number of filled rows in table of fucking options:
		choose row y from the table of fucking options;
		say "[link][y] - [title entry][as][y][end link][line break]";
	say "[link]0 - Nevermind[as]0[end link][line break]";
	while sextablerun is 0:
		say "Pick the corresponding number> [run paragraph on]";
		get a number;
		if calcnumber > 0 and calcnumber <= the number of filled rows in table of fucking options:
			now current menu selection is calcnumber;
			choose row calcnumber in table of fucking options;
			say "[title entry]: [description entry]?";
			if Player consents:
				let nam be title entry;
				now sextablerun is 1;
				if (nam is "Himself"):
					say "[AradTalkHimself]";
				if (nam is "His brother"):
					say "[AradTalkEgran]";
				if (nam is "Sex"):
					say "[AradTalkSex]";
				wait for any key;
				if AradDoneTalking is false:
					say "[AradTalkMenu]"; [looping back to keep talking with him]
		else if calcnumber is 0:
			now sextablerun is 1;
			say "     You give Arad a polite bow as you make your leave, which he retributes.";
			wait for any key;
		else:
			say "Invalid Option. Pick between 1 and [the number of filled rows in the table of fucking options] or 0 to exit.";
	clear the screen and hyperlink list;

to say AradTalkHimself:
	say "     Curious about him, you decide to ask him to tell you a bit more about himself, wanting to get to know him a little better. 'Ahh, you can call me Arad. Took a like on me, eh? Must be the scar, always gets people talking. Why would I have a scar when I'm a demon, that's what you want to ask, right?' he smiles, and seems willing to tell you a story. 'This one was caused by no conventional blade, mate... Me and my brother were part of the frontline of a small demon army back when we were fighting the angels. There's a day we're split into small groups, and I'm sent to lead a few others to follow through an alternative route towards a shrine, protected by the winged bastards, while my brother went another way.'";
	say "     'It turns out they ambushed us, fell right on top of my group and slaughtered every single one of my comrades. I was lucky to just have gotten a scar that nearly ripped my eye off. A fucking glaive, that's what it was. That jumpy bitch kept on spinning that thing and jumping on top of it like some sort of acrobatic frog. I don't even know what she was doing, she definitely didn't need wings to fly, that's for sure. I got my blades and waited for her to land another strike, was quick enough to throw her off balance and end her right there. The bitch never saw it coming... Though that's when my face starts to burn hotter than the whole fucking Hell, itself! Damned heavenly magic gave me a wound that my body couldn't heal! Egran was freaking out... But he got me someone who managed to stall the magic and leave me only with a scar. Lucky me, I guess.'";
	WaitLineBreak;
	say "     'Now, here I am, looking like a seasoned warrior when I'm just a couple of decades old. Mogdraz recruited me and my brother into his elite group shortly after that incident, when things were getting... bad. Had us as covert agents, which was actually a pretty good job, not gonna lie. We've earned his trust, I guess, so that's why he has us guard his Club and recruit some interesting individuals out there. Yeah, like you! We don't hurt anyone, as you could see.'";
	say "     You thank him for his introduction.";
	if Energy of Arad is 0:
		now Energy of Arad is 1;

to say AradTalkEgran:
	say "     Knowing that both Arad and Egran are twin brothers, you ask him about his sibling, from a brother's perspective. 'Egran's my brother and my best pal. If you think demons have no feelings, then you'd be wrong, because I fucking love my brother. If anyone hurts him, they'll have me on top of them slashing my blades at their faces until there's no face left. Don't fucking mess with any of us.' He seems to be very fond and protective of his sibling, and it is good to see that even demons care of one another. 'We do have our disagreements, sometimes, like the fact he insists on relying on pyromancy alone to get the job done. Sometimes the mere glance of a blade is enough to strike fear into others, but he insists on burning them down, instead. Not that I have an issue with that, but sometimes that's excessive...'";
	say "     'Anyway, he's a good guy, so you should totally get to know him.'";
	if Energy of Arad is 1:
		now Energy of Arad is 2;

to say AradTalkSex:
	say "     If you are thinking about asking him for some intimate time together, that means you have got to talk to him about that, first. You try to delicately introduce the subject, but any subtle attempts you make are absolutely obliterated as he reads right through you. 'You wanna fuck? Could've just asked.' Well, that was easy, and he seems very receptive to the idea. 'I mean, I'm sure boss wouldn't mind a small break. My brother can cover for my absence. Unless...' he makes a pause, and looks at his sibling to make sure he isn't listening, and leans over to you, whispering 'Unless you're into Egran, too? Heh... You wouldn't be the first we share.' He then stands back up with a mischievous grin on his face. 'Just hit me up and we'll get it done.'";
	if Libido of Egran > 0:
		say "     You have already asked Egran, and he has told you the same thing. It seems you can get both twins to join you for some sexy time...";
	else:
		say "     It seems you may not only have sex with Arad, you might also be able to get both him and his brother together with you. Now, that sounds quite promising... Perhaps you should talk to Egran, as well?";
	if Libido of Arad is 0:
		now Libido of Arad is 1;

[***********************************************************]
Section 1-2 - Arad Sex
[***********************************************************]

instead of fucking Arad:
	say "[SexWithArad]";

to say SexWithArad:
	if Libido of Arad is 0:
		say "     You should talk to Arad about that, first.";
	else if Libido of Arad > 0:
		if lastfuck of Arad - turns < 6:
			say "     Now, you have had your fun with the demon guard recently. Surely you are not trying to get Mogdraz to fire him by stealing him constantly from their post to have sex, right? Try giving it some time and ask him again later.";
		else:
			say "     You walk towards Arad with a single thing in mind, giving him a suggestive look. He reciprocates, and even puts his muscular red arm around your shoulders as he pulls you closer. 'Seems like you're in the mood for some fun... I sure am.' he says with a wink.";
			wait for any key;
			say "[AradSexMenu]";

to say AradSexMenu:
	say "     [bold type]What do you want to do with the scarred demon guard?[roman type][line break]";
	now sextablerun is 0;
	blank out the whole of table of fucking options;
	[]
	choose a blank row in table of fucking options;
	now title entry is "Give him a blowjob";
	now sortorder entry is 1;
	now description entry is "Arad could certainly use a mouth around his cock, do you volunteer";
	[]
	if player is male:
		choose a blank row in table of fucking options;
		now title entry is "Ask him for a blowjob";
		now sortorder entry is 2;
		now description entry is "He loves some oral action, and he also loves to please. Have him suck your dick";
	[]
	else if player is female:
		choose a blank row in table of fucking options;
		now title entry is "Ask him to lick your pussy";
		now sortorder entry is 2;
		now description entry is "He's eager to show you what he can do with his tongue. Have him have a go with your pussy";
	[]
	if Libido of Egran > 0:
		choose a blank row in table of fucking options;
		now title entry is "Get him and his brother";
		now sortorder entry is 4;
		now description entry is "Go for some twin action";
	[]
	sort the table of fucking options in sortorder order;
	repeat with y running from 1 to number of filled rows in table of fucking options:
		choose row y from the table of fucking options;
		say "[link][y] - [title entry][as][y][end link][line break]";
	say "[link]0 - Nevermind[as]0[end link][line break]";
	while sextablerun is 0:
		say "Pick the corresponding number> [run paragraph on]";
		get a number;
		if calcnumber > 0 and calcnumber <= the number of filled rows in table of fucking options:
			now current menu selection is calcnumber;
			choose row calcnumber in table of fucking options;
			say "[title entry]: [description entry]?";
			if Player consents:
				let nam be title entry;
				now sextablerun is 1;
				if (nam is "Give him a blowjob"):
					say "[AradSexBlowjob]";
				if (nam is "Ask him for a blowjob"):
					say "[AradSexGetBlowjob]";
				if (nam is "Ask him to lick your pussy"):
					say "[AradSexCunnilingus]";
				if (nam is "Get him and his brother"):
					say "[AradEgranTwinSex]";
				wait for any key;
		else if calcnumber is 0:
			now sextablerun is 1;
			say "     You excuse yourself as you have to take your leave. Arad smiles to you, though he can't hide the disappointment in seeing you go.";
			wait for any key;
		else:
			say "Invalid Option. Pick between 1 and [the number of filled rows in the table of fucking options].";
	clear the screen and hyperlink list;

to say AradSexBlowjob:
	say "     You nod, stating your wish to have a good one-on-one time with Arad. He turns to his brother, Egran, who is standing right next to you two. 'Do you mind covering up for me?' he asks his twin, who doesn't really give any answer, but doesn't stop you both from finding a more private room inside the Club, namely his quarters.";
	WaitLineBreak;
	say "     Once you arrive at the guards['] resting room, which is a simple one with two beds, closets and other boxes, probably filled with stuff which would be useful for a security role, he leads to you his own bed on the right, which is the one further ahead from when you enter the room. 'So... where were we?' he asks suggestively, as he grabs your head gently and plants a kiss on your neck. You find yourself able to whisper on his ear what you want to do with him, and with a chuckle, he replies 'Oh, yeah? Did someone tell you that's my favorite? Or did you come up with that all by yourself?' Once you feel his large crimson hand grabbing the back of your head, he carefully guides you down his torso, past his chest, abs and waist. Kissing all the way down his treasure trail, your face bumps on his leather jockstrap, bulging considerably.";
	say "     With eagerness, he removes the only layer that separates his foot and half long of a red demon cock, sliding it down his muscled legs, as his throbbing erection bashes onto your face. His scent strikes you with an odd familiarity, the typical demonic sweetness that is abundant within the Club, coming out raw from the sex of a masculine demon. 'Like what you see? Wait until you taste it...' he teases, grabbing his pulsing rod and having it poke at your lips, its glistening tip leaving thin trails of precum as he moves it around. You feel nearly compelled to open your mouth and let him slide his cock in, but he merely lets it hang there, having you taste the glans with your tongue and softly suck on the tip.";
	WaitLineBreak;
	say "     It tastes good, almost too good. Arad pats you in the head gently as he lets you take his dick in deeper. 'Grab my balls, too... Don't leave anything out...' he asks, and to make him happy, you use your hands to massage his big orbs and thick shaft while you slide your lips down on his length more insistently. 'Yeah, that's it... You're doing so good...' his comment reaches your ears in a soft moaning tone as he holds your head between his large hands, carefully leading you over to the edge of the bed as he takes a seat, letting you kneel between his powerful legs to continue to suck him. You seem to be sending him to joyful places as you keep up with your efforts at pleasing him, as you see him leaning his head back and closing his eyes. His big cock throbs and pulses at nearly every second.";
	say "     Then, you pick up the pace and begin to suck him harder, sliding your lips up and down his veiny shaft while your hands continue to stimulate him on every other place, namely his balls, the base of his dick, and occasionally a rub all over his legs. Giving your best at letting him feel your throat, having his cock hump at the deepest area of your mouth, the blowjob gradually progresses into something more similar to a slow facefuck. Arad does seem to enjoy the soft and gentle manners of practicing love, since he lets you take in all the breath you need before diving back deep onto his sizable dong, all while maintaining that blissful expression on his face. 'Ahh damn, you're so good at this...'";
	WaitLineBreak;
	say "     The demon lets out another long moan as you keep worshipping his cock, occasionally feeling him push you in and out as he sees fit, but shifting the control back to you intermittently. During all the licking and sucking, he grunts and bites his lip, trying to keep his whole body from squirming around, grasping at the sheets underneath him with a tight grip... You feel the tentative humps of his hips, his breath deepening, his muscles becoming stiff (which gives you a really nice view of his bulging physique) and his eyes tightly shut, then hear him say 'Fuck, I'm close...' Hearing him say that, you pick up the pace and get ready to give him a powerful and satisfying orgasm.";
	say "     You stroke him fast, then faster, letting him feel your warm mouth and lips around his cock, until you make him break the point of no return. Then, he is sent into overwhelming ecstasy as his entire load comes out to greet you in the mouth, coating the entirety of it with his hot and sweet load that you either swallow or let slide off your lips, making a sticky mess all over. His climax continues throughout the minute he is still cumming into you, until it finally subsides.";
	WaitLineBreak;
	say "     'Phew, that was a really fucking good release...' he comments, stroking your cheek in a tender caress. 'Mind giving me another one later? I'll need it, for sure.' he adds, throwing a chuckle in the end. Looking over the mess you both have done, you proceed to clean yourselves up before returning outside.";
	say "     It seems you have boosted Arad's mood by a lot. He seems to be smiling to everyone as he returns to his post.";
	if a random chance of 1 in 4 succeeds:
		if Libido of Mogdraz > 0 and Libido of Mogdraz < 99:
			increase Lust of Mogdraz by 1; [Mogdraz approves when the player cares for his crew]
	NPCSexAftermath Player receives "OralCock" from Arad;

to say AradSexGetBlowjob:
	say "     You nod, stating your wish to have a good one-on-one time with Arad. He turns to his brother, Egran, who is standing right next to you two. 'Do you mind covering up for me?' he asks his twin, who doesn't really give any answer, but doesn't stop you both from finding a more private room inside the Club, namely his quarters.";
	WaitLineBreak;
	say "     Once you arrive at the guards['] resting room, which is a simple one with two beds, closets and other boxes, probably filled with stuff which would be useful for a security role, he leads to you his own bed on the right, which is the one further ahead from when you enter the room. 'So... where were we?' he asks suggestively, as he grabs your head gently and plants a kiss on your neck. You find yourself able to whisper on his ear what goes in your mind... and he abruptly stops. 'Wow, wait. You want me to suck your cock?' You reply that is, indeed, what you just said. 'Damn... Really?' He almost sounded disappointed, or at least not believing it, but... you assure him, that is exactly what you want. 'Then get your ass on the bed, you horny [boygirl]. I'll give you what you want.'";
	say "     Well, he actually didn't say no... It seemed like much the contrary. Eager to oblige, you [if player is not naked]slide down your lower gear and expose your cock before him[else]look down over your exposed cock, responding in motion[end if] and sit down over the edge of the bed, as he [']requested[']. Then, you see the tall demon walking over to you, kneeling in front of you, grabbing your [cock size desc of player] penis, give it very slow strokes as it hardens in his grasp, all while he looks at you in the eye. This really turns you on, for some reason [if cock length of player < 8]... 'You've got such a cute dick... Mine's really a lot bigger, but... Y'know... Yours is still quite cute.' Did he just mock the size of your dick, or is he trying to be nice? You cannot really say for sure[else if cock length of player >= 8 and cock length of player < 16]... 'Good size. I like it. Not as big as mine, but... Should get the job done about just the same, right?' Is he actually flexing that he is bigger than you, or is he just trying to be nice? You cannot really say for sure[else]... 'Damn! You're carrying a monster! What's this shit, a bat club? It could fucking knock me out with a smack, I bet! Just like mine does, by the way. Bigger is better, eh? I agree.' You have gotten quite confused at his comment, but he seems to like it... and sounds capable of handling your size, at least[end if].";
	WaitLineBreak;
	say "     Once he had enough of teasing you, he begins to stroke you a bit more generously, before he wraps his lips around your cock. Cupping your balls with his hand, he massages your orbs with quite the enthusiasm as he gobbles up on your shaft, dealing with any precum you are leaking by now. A soft moan vibrates through your meatlog as he keeps sucking you off, probably a sign that he is enjoying your taste. Arad is surprisingly skillful at this, wiggling his tongue all over your length as he continues to push it in deep into his throat, the tip of your cock brushing against that warm slick tunnel. No choking, no gag reflex, nothing stops the demon from giving you a proper blowjob.";
	say "     You start feeling very afraid that you will hit your climax too soon, as the sensations he provides you with are beginning to overwhelm you. It feels like his whole mouth gyrates around your dick, while the insides of his cheeks and tongue rub against the whole thing in perfect harmony, moving and touching at just the right sensitive spots of your manhood. It throbs and pulses, seemingly out of your control, and you want to moan loud. One of his hands start to rub at your torso, then all over your chest, and a glimpse at his face shows him shifting his eyes towards yours, greeting you with a cocky wink. He knows he is going to make you cum very soon, fully aware of the effect he is having on you...";
	WaitLineBreak;
	say "     Even if you wanted him to slow down, that just does not happen. He never lowers the pace nor backs off, and remains ultimately determined to make your cock shoot. It is just too much, you just find yourself desperately wanting to cum, and then it just happens. Your load ends up swallowed by the strong demon until the very last drop, and he continues to stimulate your dick until you have hit the very last second of your climax. 'You wanted a blowjob, there you have it. Hope you enjoyed the fastest cum of your life.' You are not sure you want to either thank him or smack him in the head, but he did make you feel really good... And if he ended up edging you... Well, you bet he would make you suffer for an excruciating amount of time, knowing him a bit now.";
	say "     You soon return outside, and Arad seems quite happy with himself. Not exactly for the good of others, as his cockiness can be quite irritating to some, especially for his sibling Egran, but you definitely boosted his mood.";
	if a random chance of 1 in 4 succeeds:
		if Libido of Mogdraz > 0 and Libido of Mogdraz < 99:
			increase Lust of Mogdraz by 1; [Mogdraz approves when the player cares for his crew]
	NPCSexAftermath Arad receives "OralCock" from Player;

to say AradSexCunnilingus:
	say "     You nod, stating your wish to have a good one-on-one time with Arad. He turns to his brother, Egran, who is standing right next to you two. 'Do you mind covering up for me?' he asks his twin, who doesn't really give any answer, but doesn't stop you both from finding a more private room inside the Club, namely his quarters.";
	WaitLineBreak;
	say "     Once you arrive at the guards['] resting room, which is a simple one with two beds, closets and other boxes, probably filled with stuff which would be useful for a security role, he leads to you his own bed on the right, which is the one further ahead from when you enter the room. 'So... where were we?' he asks suggestively, as he grabs your head gently and plants a kiss on your neck. You find yourself able to whisper on his ear what goes in your mind... and he abruptly stops. 'Wow, wait. You want me to lick your pussy?' You reply that is, indeed, what you just said. 'Damn... Really?' He almost sounded disappointed, or at least not believing it, but... you assure him, that is exactly what you want. 'Then get your ass on the bed, you horny [boygirl]. I'll give you what you want.'";
	say "     Well, he actually didn't say no... It seemed like much the contrary. Eager to oblige, you [if player is not naked]slide down your lower gear and expose your privates before him[else]look down over your exposed sex[end if] and sit down over the edge of the bed, as he [']requested[']. Then, you see the tall demon walking over to you, kneeling in front of you, grabbing your legs and pull him to you, but his hands do not remain on your legs for long. Once he dives his lips onto your wet lower ones, he reaches for your chest, grabbing both your [breast size desc of player] breasts with each hand. You cannot really say it is rude of him to just grab and squeeze them all he wants, since he is tonguedeep in your cunt right now, and it actually makes you feel really good...";
	WaitLineBreak;
	say "     Not really minding the situation, you let him have his way with you. As he plays with your boobs, he gives your eager cooch a good licking, making out with it like a truly skilled demon. He must really like its taste, as he has not stopped trying to slurp your feminine juices and letting those low, soft moans escape his mouth as he continues to lick you. At some point, his tongue really goes deep in there, wiggling and licking at the insides of your pussy like an agitated eel, but what really drives you crazy is his thumbs brushing at your sensitive nipples, all while he rubs and fondles your tits. He does not go hard with it, only teasing your nips with a slight poke and an occasional rub, while his tongue remains very active inside your sex.";
	say "     You start feeling very afraid that you will hit your climax too soon, as the sensations he provides you with are beginning to overwhelm you. His long demonic tongue going in and out of your cunt feels way better than you could have anticipated, and the way he teases your nipples drives you insane with lust. You find yourself more than once grinding your pussy against the demon's face, which he actually appreciates, as he takes the time to rub your breasts harder... which means you begin to feel even better, and you want to hump his face harder, which in turn makes him start to go really, really hard on your tits, squeezing and rubbing your nipples at a much harder pace, and then you feel like shouting at the top of your lungs as your climax hits you like a truck.";
	WaitLineBreak;
	say "     It overwhelms your senses like a massive thunder strike, and he only stops moving his hands, mouth and tongue once your orgasm reaches its very last second. The devil then pulls out, his whole face soaked in your lady spazzle. 'Was I that good? You really didn't last long... Must have been my skill.' For moments, you think about pulling him back to your cooch and make him stay there for like, an hour or two, but this brief moment really exhausted you. Blissfully defeated, you concede. He is actually quite good. 'Oh, I know. Though if you want more, you gotta keep coming for me and ask... You'll probably get addicted to it, which is fine. That way I'll certainly keep you close.' he adds with a grin, and somehow, the demon makes this sound like it would not be a bad thing.";
	say "     After you clean up, you return outside, and Arad seems quite happy with himself. Not exactly for the good of others, as his cockiness can be quite irritating to some, especially for his sibling Egran, but you definitely boosted his mood.";
	if a random chance of 1 in 4 succeeds:
		if Libido of Mogdraz > 0 and Libido of Mogdraz < 99:
			increase Lust of Mogdraz by 1; [Mogdraz approves when the player cares for his crew]
	NPCSexAftermath Arad receives "OralPussy" from Player;

[***********************************************************]
Section 1-3 - Egran Talk
[***********************************************************]

EgranDoneTalking is a truth state that varies.[@Tag:NotSaved]

instead of conversing Egran:
	say "     You approach the entrance to the Hellfire Club, more specifically, the two hellfire demons guarding the gate. 'Hopefully the Club has been treating you well?' says Egran, the full bearded one of the demon duo, to whom you wish you talk with.";
	now EgranDoneTalking is false;
	say "[EgranTalkMenu]";

to say EgranTalkMenu:
	say "     [bold type]What do you want to talk to Egran about?[roman type][line break]";
	LineBreak;
	now sextablerun is 0;
	blank out the whole of table of fucking options;
	[]
	choose a blank row in table of fucking options;
	now title entry is "Himself";
	now sortorder entry is 1;
	now description entry is "Ask the bearded demon guard about himself";
	[]
	if Energy of Egran > 0:
		choose a blank row in table of fucking options;
		now title entry is "His brother";
		now sortorder entry is 2;
		now description entry is "Ask about his twin brother, Arad";
	[]
	if Energy of Egran > 1:
		choose a blank row in table of fucking options;
		now title entry is "Sex";
		now sortorder entry is 3;
		now description entry is "He's a good looking fellow... would there be any chance";
	[]
	sort the table of fucking options in sortorder order;
	repeat with y running from 1 to number of filled rows in table of fucking options:
		choose row y from the table of fucking options;
		say "[link][y] - [title entry][as][y][end link][line break]";
	say "[link]0 - Nevermind[as]0[end link][line break]";
	while sextablerun is 0:
		say "Pick the corresponding number> [run paragraph on]";
		get a number;
		if calcnumber > 0 and calcnumber <= the number of filled rows in table of fucking options:
			now current menu selection is calcnumber;
			choose row calcnumber in table of fucking options;
			say "[title entry]: [description entry]?";
			if Player consents:
				let nam be title entry;
				now sextablerun is 1;
				if (nam is "Himself"):
					say "[EgranTalkHimself]";
				if (nam is "His brother"):
					say "[EgranTalkArad]";
				if (nam is "Sex"):
					say "[EgranTalkSex]";
				wait for any key;
				if EgranDoneTalking is false:
					say "[EgranTalkMenu]"; [looping back to keep talking with him]
		else if calcnumber is 0:
			now sextablerun is 1;
			say "     You give Egran a polite bow as you make your leave, which he retributes.";
			wait for any key;
		else:
			say "Invalid Option. Pick between 1 and [the number of filled rows in the table of fucking options] or 0 to exit.";
	clear the screen and hyperlink list;

to say EgranTalkHimself:
	say "     Curious about him, you decide to ask Egran to tell you a bit more about himself, wanting to get to know him a little better. He strokes his fuzzy beard as he thinks about an answer. 'I'm Egran, the Club's guardsman, along with my brother Arad. Served in the demon army back when we were on the other world, and then Mogdraz recruited us into his elite group once he saw how fucking good we were. That's how everything went.' It seems he is a demon of few words, so you ask him additional questions, namely what else he does here other than keeping guard. 'We've also been doing some additional work for Mogdraz, like... gathering... promising guests during specific evenings. We were then, of course, assigned to find you. It took some trial and error, but as you can see, we seldom fail.'";
	say "     But what could be so special about you, you ask him. And after a few more beard strokes and looking around, he answers 'You've been doing things... Surviving in this place, despite the odds... And you've managed to keep sane regardless of what threat is thrown at you. There's something quite special about you, or at least Mogdraz thinks. The average person would have succumbed to the first horny fucker who showed up in front of them, joining them in the process. In the meantime, you're still here... Probably facing a lot of those daily and still going. You're definitely seen as more capable than most.' He stops for brief moments, then adds in a few additional words 'It remains to be seen if you can keep up, though.'";
	if Energy of Egran is 0:
		now Energy of Egran is 1;

to say EgranTalkArad:
	say "     Knowing that both Egran and Arad are twin brothers, you ask him about his sibling, from a brother's perspective. 'You wanna know about my view on my brother? He's a reckless dork. He insists on carrying those short blades around and pretend he's a ninja when we've got natural claws and pyromancy abilities. I don't understand him.' You stare back at Egran until the point he starts getting uncomfortable. 'Ugh. Whatever you're thinking, no it doesn't mean I don't care about him, but he better get his shit together if he doesn't want to get into trouble. I almost lost him once, I... Don't want to go through all that again.' Egran tried to keep his voice low so that his brother wouldn't hear, but Arad is clearly starting to get suspicious of something, judging by the way he is looking at you both.";
	say "     'He's my brother, nonetheless. If anyone harms him, I'll set them on fire and give them a slow and painful death.'";
	if Energy of Egran is 1:
		now Energy of Egran is 2;

to say EgranTalkSex:
	say "     Egran is quite the manly and good looking red devil, so it is only natural that someone would feel interested in getting closer to him. For that reason, you decide to ask him about his openness to sex. 'Uh... Is that a proposal? I mean... fuck, sure! I could use some time to relief myself... Standing here all day and night can sure get boring without some diversion on the way. I guess my brother Arad can cover for my absence if I have to head somewhere... else.' he says with a smirk, but then, after making sure his brother is not listening, he leans over to you and starts whispering. 'Although, uh... It would be... pretty fucking hot if you were into my brother, too... We could do some stuff together. You wouldn't be the first we share.'";
	if Libido of Arad > 0:
		say "     You have already asked Arad, and he has told you the same thing. It seems you can get both twins to join you for some sexy time...";
	else:
		say "     It seems you may not only have sex with Egran, you might also be able to get both him and his brother together with you. Now, that sounds quite promising... Perhaps you should talk to Arad, as well?";
	if Libido of Egran is 0:
		now Libido of Egran is 1;


[***********************************************************]
Section 1-4 - Egran Sex
[***********************************************************]

instead of fucking Egran:
	say "[SexWithEgran]";

to say SexWithEgran:
	if Libido of Egran is 0:
		say "     You should talk to Egran about that, first.";
	else if Libido of Egran > 0:
		if lastfuck of Egran - turns < 6:
			say "     Now, you have had your fun with the demon guard recently. Surely you are not trying to get Mogdraz to fire him by stealing him constantly from their post to have sex, right? Try giving it some time and ask him again later.";
		else:
			say "     You walk towards Arad with a single thing in mind, giving him a suggestive look. He reciprocates, and lets you get really close to him as he puts his hand above your butt, pulling you to him. 'You keep giving me those eyes, I'll just have to do you.' he says with a smirk.";
			wait for any key;
			say "[EgranSexMenu]";

to say EgranSexMenu:
	say "     [bold type]What do you want to do with the bearded demon guard?[roman type][line break]";
	now sextablerun is 0;
	blank out the whole of table of fucking options;
	[]
	if player is female:
		choose a blank row in table of fucking options;
		now title entry is "Give him your pussy";
		now sortorder entry is 1;
		now description entry is "Egran loves a tasty cunt and he seems hungry for some. Give him what he wants";
	[]
	else if player is male:
		choose a blank row in table of fucking options;
		now title entry is "Give him your ass";
		now sortorder entry is 1;
		now description entry is "Egran is an ass man and he seems hungry for some. Give him what he wants";
	[]
	choose a blank row in table of fucking options;
	now title entry is "Eat his ass";
	now sortorder entry is 2;
	now description entry is "He's got a juicy butt. Offer to eat him out";
	[]
	if Libido of Arad > 0:
		choose a blank row in table of fucking options;
		now title entry is "Get him and his brother";
		now sortorder entry is 3;
		now description entry is "Go for some twin action";
	[]
	sort the table of fucking options in sortorder order;
	repeat with y running from 1 to number of filled rows in table of fucking options:
		choose row y from the table of fucking options;
		say "[link][y] - [title entry][as][y][end link][line break]";
	say "[link]0 - Nevermind[as]0[end link][line break]";
	while sextablerun is 0:
		say "Pick the corresponding number> [run paragraph on]";
		get a number;
		if calcnumber > 0 and calcnumber <= the number of filled rows in table of fucking options:
			now current menu selection is calcnumber;
			choose row calcnumber in table of fucking options;
			say "[title entry]: [description entry]?";
			if Player consents:
				let nam be title entry;
				now sextablerun is 1;
				if (nam is "Give him your pussy"):
					say "[EgranSexPussyLick]";
				if (nam is "Give him your ass"):
					say "[EgranSexAssPlay]";
				if (nam is "Eat his ass"):
					say "[EgranSexEatAss]";
				if (nam is "Get him and his brother"):
					say "[AradEgranTwinSex]";
				wait for any key;
		else if calcnumber is 0:
			now sextablerun is 1;
			say "     You excuse yourself as you have to take your leave. Egran smiles to you, though he can't hide the disappointment in seeing you go.";
			wait for any key;
		else:
			say "Invalid Option. Pick between 1 and [the number of filled rows in the table of fucking options].";
	clear the screen and hyperlink list;

to say EgranSexPussyLick:
	say "     You retribute the smile, stating your wish to have a good one-on-one time with Egran. He turns to his brother, Arad, who is standing right next to you two. 'Do you mind covering up for me?' he asks his twin, who gives him a dirty smirk and winks back at his sibling. 'Going for a break with a certain someone, eh? Hope you enjoy yourselves!' You can see the bearded demon rolling his eyes, then he starts leading you towards a more private room inside the Club, namely his quarters.";
	WaitLineBreak;
	say "     Once you arrive at the guards['] resting room, which is a simple one with two beds, closets and other boxes, probably filled with stuff which would be useful for a security role, he leads to you his own bed on the left, which is the one closer to the door from when you enter the room. 'Sorry about that, Arad can be excessively bold, sometimes.' You tell him that is no problem for you, as long as you get your sweet time with the one of the hot brothers, who happens to be right in front of you. 'Heh... you're cute. What did you have in mind?' Well, without trying to sound too self-interested, since you literally dragged him away from his post to have sex with him, you tell him you would like to have his fuzzy bearded face down your crotch.";
	say "     'So you called me, had me come all the way here with you, and you want me to tonguefuck your pussy?' You nod, and say that is exactly as he is saying. For moments you think he will get mad at you, but then he reaches for your cheek, stroking it tenderly as he comes closer to you. 'That would be my pleasure.' he says, pushing you onto the bed as [if player is not naked]you slide down your lower gear[else]he eyes your exposed privates[end if]. Then, the big demon crouches down between your legs, grabs them and pulls you closer to him, as he dives his face in your sex. The first thing you feel is his beard scratching against the inner side of your thighs as his masterful tongue greets your wet curls, wiggling and pressing inside at an eager pace.";
	WaitLineBreak;
	say "     It is actually insane, the intensity of his tongue movement around your labia. He definitely makes out with it, putting both his lips and tongue to work at maximum efficiency, making you feel really good. Soon, your cunt is invaded, as he presses his nimble wet organ inside you to do as promised, tonguefuck you until you're sent to heaven... hopefully not literally. He lets out a soft moan in appreciation, probably enjoying the taste of your feminine juices, as he slurps them all in the process. The burly demon definitely makes use of his beard to provide you a mix of sensations, grinding his face against your cooch instead of just eating it. You get the idea he has done this quite some times, already, and that he really takes pleasure from doing it.";
	say "     He seems completely focused on the job. Not that you can see the rest of him from your position, but his hands remain on your legs, so in no way he could be touching himself while servicing your womanhood. Instead, he simply keeps tonguefucking your cunt for the next few minutes, wiggling his tongue, gyrating it slightly, licking the insides of your pussy... The devil never stops. It really does not take too long for you start feeling that surge of ecstasy that takes you like a train running you over, and like the experienced pussy licker he is, he merely takes this time to intensify his tongue movements. All of this combined makes you nearly shout in pleasure as your cunt quivers and your body spasms in bliss...";
	WaitLineBreak;
	say "     You feel his strong hands rubbing across your torso tenderly as your climax begins to subside, which feels extremely good and relaxing... He even lies down next to you, holding you in for an embrace as he strokes your head. 'Hope you enjoyed that.' he says, and as you are too speechless to yet give a coherent answer, he just pulls you close to his hairy chest. His heart is still beating fast and audibly, and that's not the only thing that is still hard, looking down at his crotch... Though Egran keeps you from touching it. 'Hey, you only get what you asked for. Gotta get you motivated to keep coming after me.' The heat of the moment has you both exchange a kiss before you start getting up to return outside.";
	say "     Egran seems more content. You probably helped boost his mood, as he seems a lot nicer to everyone else... Including his brother Arad.";
	if a random chance of 1 in 4 succeeds:
		if Libido of Mogdraz > 0 and Libido of Mogdraz < 99:
			increase Lust of Mogdraz by 1; [Mogdraz approves when the player cares for his crew]
	NPCSexAftermath Egran receives "OralPussy" from Player;

to say EgranSexAssPlay:
	say "     You retribute the smile, stating your wish to have a good one-on-one time with Egran. He turns to his brother, Arad, who is standing right next to you two. 'Do you mind covering up for me?' he asks his twin, who gives him a dirty smirk and winks back at his sibling. 'Going for a break with a certain someone, eh? Hope you enjoy yourselves!' You can see the bearded demon rolling his eyes, then he starts leading you towards a more private room inside the Club, namely his quarters.";
	WaitLineBreak;
	say "     Once you arrive at the guards['] resting room, which is a simple one with two beds, closets and other boxes, probably filled with stuff which would be useful for a security role, he leads to you his own bed on the left, which is the one closer to the door from when you enter the room. 'Sorry about that, Arad can be excessively bold, sometimes.' You tell him that is no problem for you, as long as you get your sweet time with the one of the hot brothers, who happens to be right in front of you. 'Heh... you're cute. What did you have in mind?' Well, without trying to sound too self-interested, since you literally dragged him away from his post to have sex with him, you tell him you would like to have his fuzzy bearded face down your ass.";
	say "     'So you called me, had me come all the way here with you, and you want me to tonguefuck your ass?' You nod, and say that is exactly as he is saying. For moments you think he will get mad at you, but then he reaches for your cheek, stroking it tenderly as he comes closer to you. 'That would be my pleasure.' he says, pushing you onto the bed as [if player is not naked]you slide down your lower gear[else]he eyes your exposed privates[end if]. Then, he has you get on all fours as the big demon crouches down behind you, grabs your buttocks and gets a good feel of them. 'That's a good ass...' he comments as he slaps one of your cheeks, not too hard, but enough to take you by surprise as you let out a soft grunt. Finally, he dives his face between your glutes. The first thing you feel is his beard scratching against the inner sides of your buns as his masterful tongue greets your pucker, wiggling and pressing inside at an eager pace.";
	WaitLineBreak;
	say "     It is actually insane, the intensity of his tongue movement around your anus. He definitely makes out with it, putting both his lips and tongue to work at maximum efficiency, making you feel really good. Soon, your ass is invaded, as he presses his nimble wet organ inside you to do as promised, tonguefuck you until you're sent to heaven... hopefully not literally. He lets out a soft moan in appreciation, probably enjoying the taste of your rear, as he enthusiastically eats it out. The burly demon definitely makes use of his beard to provide you a mix of sensations, grinding his face against the inner area of your glutes instead of just rimming you. You get the idea he has done this quite some times, already, and that he really takes pleasure from doing it.";
	say "     He seems completely focused on the job. Not that you can see the rest of him from your position, but his hands remain placed on your asscheeks, so in no way he could be touching himself while servicing your butt. Instead, he simply keeps tonguefucking you for the next few minutes, wiggling his tongue, gyrating it slightly, licking the insides of your ass... The devil never stops. It really does not take too long for you start feeling that surge of blissful pleasure, and you cannot help yourself but start stroking your meat. Though, to your surprise, one of the demon's hands brushes against yours, and gets to grab your cock and jerk it for you. That is exactly when you start getting overwhelmed by the pleasure he is offering you, with the sensations of his tongue in your ass and his hand on your dick combined.";
	WaitLineBreak;
	say "     It is not long until he sends you over the edge, fastening his jerking motions and making you cum all over the bed's sheets while he eats your ass with great enthusiasm. You get to experience this throughout a minute until your climax finally subsides, and then Egran lies down next to you, holding you in for an embrace as he strokes your head. 'Hope you enjoyed that.' he says, and as you are too speechless to yet give a coherent answer, he just pulls you close to his hairy chest. His heart is still beating fast and audibly, and that's not the only thing that is still hard, looking down at his crotch... Though Egran keeps you from touching it. 'Hey, you only get what you asked for. Gotta get you motivated to keep coming after me.' The heat of the moment has you both exchange a kiss before you start getting up to clean yourselves and the room, then return outside.";
	say "     Egran seems more content. You probably helped boost his mood, as he seems a lot nicer to everyone else... Including his brother Arad.";
	if a random chance of 1 in 4 succeeds:
		if Libido of Mogdraz > 0 and Libido of Mogdraz < 99:
			increase Lust of Mogdraz by 1; [Mogdraz approves when the player cares for his crew]
	NPCSexAftermath Player receives "Other" from Egran;

to say EgranSexEatAss:
	say "     You retribute the smile, stating your wish to have a good one-on-one time with Egran. He turns to his brother, Arad, who is standing right next to you two. 'Do you mind covering up for me?' he asks his twin, who gives him a dirty smirk and winks back at his sibling. 'Going for a break with a certain someone, eh? Hope you enjoy yourselves!' You can see the bearded demon rolling his eyes, then he starts leading you towards a more private room inside the Club, namely his quarters.";
	WaitLineBreak;
	say "     Once you arrive at the guards['] resting room, which is a simple one with two beds, closets and other boxes, probably filled with stuff which would be useful for a security role, he leads to you his own bed on the left, which is the one closer to the door from when you enter the room. 'Sorry about that, Arad can be excessively bold, sometimes.' You tell him that is no problem for you, as long as you get your sweet time with the one of the hot brothers, who happens to be right in front of you. 'Heh... you're cute. What did you have in mind?' You let him know that you have been looking at his backside, and even compliment his booty... 'Yeah...? Then I assume you want to have a better look at it?' he replies, and to this, you simply nod.";
	say "     'Alright' says the demon as he turns around and heads to the edge of the bed, his ass now in direct view thanks to the fact he is wearing a leather jockstrap. But he quickly begins to undo the straps around his legs and sliding his gear down, now completely revealing his rear. The only thing he is wearing is his harness, which makes it quite a kinky attire when the rest of the burly demon's body is fully naked. Glancing over his shoulder and grabbing his glutes with both hands, he bounces them around playfully. 'You like them?' Egran asks, and all you can do is stare. His buttocks are muscular, but also plump with a certain degree of softness to it, only covered by a very subtle layer of body hair, which is mostly non-existent in the inner sides. Looks like someone takes care of themselves down there, keeping it all trimmed and neat.";
	WaitLineBreak;
	say "     After admiring the demon guard's big butt for like some good few minutes, a grin draws itself across his face. 'I didn't know I could put you into a trance just by bouncing my buttcheeks.' Of course, you are not hypnotized in the literal meaning of the word, but you are definitely quite enticed by his ass, or you would have looked away by now. 'I like to have it eaten, if you're wondering.' He says this, and the devil beings to slowly spread his cheeks, showing you his inviting pucker as he makes it pulse a little. Egran then bends over the bed and arches his back, making his demonic ass just bulge into your view. He glances at you once more, giving you a wink. 'Come on now, don't be shy... Put your tongue in there.'";
	say "     Before you is Egran bending over the bed and inviting you to lick his ass. Nothing stops you, so you do exactly that. Leaning towards his rear, you approach your face towards those big red buns and give them some generous kissing. Your lips touch his buttcheeks all over as you make your way inwards, to the space between them. Spreading them just enough so you get your mouth to kiss and tongue to lick at his hole, you begin to rim the strong demon with all the enthusiasm you can muster. His sweet musk only manages to make you more hungry for it, so eventually, you find yourself eating his ass voraciously, putting your tongue deep inside him and licking at his inner fleshy walls, which throb in response.";
	WaitLineBreak;
	say "     Now you have got the tough guard letting out soft moans as you tonguefuck him, thrusting your slick organ in and out as you provide him with the pleasure of a well-done rimjob. He just cannot help himself but to grind his big ass against your face, which sometimes knocks you back a little. All goes smoothly as he seems to really enjoy the dedication you are showing him, as you continue to lick and even suck at that warm pulsing pucker of his... But then he starts grinding at your face a bit harder... And you feel his hand sliding behind your head, grabbing you gently... Then pushing you deep between his glutes. Definitely, you cannot breathe, but you cannot stop rimming him either. 'Fuck... yes! Get it deep... very deep in there... Keep wiggling that tongue...!'";
	say "     The whole thing ends up turning you on as you oblige his request - which sounded more like an order, and turned out to be your only option, anyway - and you give your tongue the best wiggling you possibly can, which really sends Egran into ecstasy. He is jerking off that large thick dong of his, his balls swinging back and forth, beginning to pulse with his load begging to be released. 'Fuuuuck yes!!!' he grunts, loudly, and you can imagine by how much his anus is quivering around your tongue that you sent him over the edge. The demon's entire load is sent flying over the bed sheets, making a huge mess as you continue to rim his ass, now with your head free of his hand. You get to catch your breath soon enough, as his orgasm begins to subside.";
	WaitLineBreak;
	say "     Falling back, you feel like you are done for now. He looks at you with his cock still half-hard, then smiles. 'Damn. That was pretty good. Wish I could get that done to my ass everyday.' he says, chuckling in the end. 'Make sure you keep offering me these invitations. I'll gladly accept.'";
	say "     You stay to help him clean up before you return outside, and he definitely seems more content. You probably helped boost his mood, as he seems a lot nicer to everyone else... Including his brother Arad.";
	if a random chance of 1 in 4 succeeds:
		if Libido of Mogdraz > 0 and Libido of Mogdraz < 99:
			increase Lust of Mogdraz by 1; [Mogdraz approves when the player cares for his crew]
	NPCSexAftermath Egran receives "Other" from Player;

[***********************************************************]
Section 1-5 - Twin Sex
[***********************************************************]

to say AradEgranTwinSex:
	say "     With both brothers so close to each other, you actually ask both of them if they don't want to take a quick break to hang out with you. 'Oh, you mean both of us? Like, right now?' asks Arad, with a rather suggestive look in his eyes. 'Yeah, well... I guess we could ask Jyneth or Drenraya to keep watch while we're gone.' Egran comments, to which his brother replies 'That's a good idea. You do the talking?' Egran answers with a 'Sure...' and an expression of slight annoyance. 'Cool! Meet us at the quarters once you're done.' Arad adds, before his bearded twin heads over the Storage Room. 'I'm sure that won't take long. Drenraya has a bit of a crush on Egran, so she'll do anything he asks. Anyway, follow me.'";
	say "     Now with that out of the way, you simply follow Arad towards a more private room inside the Club, namely their quarters. Once you arrive at the guards['] resting room, which is a simple one with two beds, closets and other boxes, probably filled with stuff which would be useful for a security role, he leads to you his own bed on the right, which is the one further ahead from when you enter the room. Then, with a bit of muscle work, he pushes his bed to slam together with Egran's, effectively improvising a double bed. 'We might need the space.' he winks, as he puts his big arm around you and plays gently with your ears, or strokes your cheek. 'Well, I wouldn't like to get started without the grumpy man, so... let's just wait for him.'";
	WaitLineBreak;
	say "     A minute later, Egran arrives, and he seemed to be successful at convincing Drenraya to keep guard in their places. 'I'm owing her a favor, now. Hope you're ready to pay it off, Arad.' The scarred demon laughs to this. 'It's not my ass she wants, big guy.' He then gives a generous slap on Egran's buttcheeks, in a very playful manner, which annoys the bearded twin. But nothing will ruin this moment, as Egran approaches you from behind, with Arad coming very close to you on the front... Soon, you find yourself between the tall and muscular twins, who are just starting to feel you up all over with their surprisingly gentle touching. You are made into the center of the attention from now on, and they seem ready to get seriously into the action.";
	say "     '[bold type]Any fantasy in your mind that you'd like us to make it happen[roman type]?' asks Arad with a naughty grin.";
	wait for any key;
	say "[AradEgranTwinSexMenu]";

to say AradEgranTwinSexMenu:
	now sextablerun is 0;
	blank out the whole of table of fucking options;
	[]
	choose a blank row in table of fucking options;
	now title entry is "Get fucked on both ends";
	now sortorder entry is 1;
	now description entry is "Have them take your mouth and back";
	[]
	sort the table of fucking options in sortorder order;
	repeat with y running from 1 to number of filled rows in table of fucking options:
		choose row y from the table of fucking options;
		say "[link][y] - [title entry][as][y][end link][line break]";
	say "[link]0 - Nevermind[as]0[end link][line break]";
	while sextablerun is 0:
		say "Pick the corresponding number> [run paragraph on]";
		get a number;
		if calcnumber > 0 and calcnumber <= the number of filled rows in table of fucking options:
			now current menu selection is calcnumber;
			choose row calcnumber in table of fucking options;
			say "[title entry]: [description entry]?";
			if Player consents:
				let nam be title entry;
				now sextablerun is 1;
				if (nam is "Get fucked on both ends"):
					say "[AradEgranSpitroast]";
				wait for any key;
		else if calcnumber is 0:
			now sextablerun is 1;
			say "     You didn't go through all this trouble just to leave them hanging now, did you?";
			wait for any key;
			say "[AradEgranTwinSexMenu]";
		else:
			say "Invalid Option. Pick between 1 and [the number of filled rows in the table of fucking options].";
	clear the screen and hyperlink list;

to say AradEgranSpitroast:
	say "     You let them know of your choice, which pleases the demons. 'Ah, that's our classic.' Arad comments replies as he strokes your chin. 'We do that one for fun.' The two devils, after having felt your body all over enough, push you onto the improvised double bed as they follow to each side of you, with Arad facing your front and Egran remaining on your back. You then find yourself on all fours, mere inches away from the scarred twin's crotch, bulging in arousal, before he decides to slide his leather jockstrap down and let his crimson rod break free. It is still hardening before your eyes, and you can smell the oddly familiar and sweet demonic musk it oozes in its greatest raw power. Grabbing it with one hand, the now naked twin grins down at you, only letting you look at his dick without touching it.";
	say "     This, of course, because Egran is still getting ready. He figured you would need your [if player is female]pussy[else]asshole[end if] to be prepared, so he simply massages your buttcheeks once your rear is fully in his view and reach. 'Might as well offer you some tongue back here before you take me.' he says, and you cannot help but let out a moan as his thick thumb rubs across your [if player is female]moist curls[else]pucker[end if], all of this before his bearded face dives in there to lick at your [if player is female]yearning cunt[else]yearning orifice[end if]. At this time, Arad brushes his pulsing cock against your lips, which softly land on top of the glans, and slowly, you begin to slide them down the tall demon's shaft. 'Mmh fuck, that mouth really feels good...'";
	WaitLineBreak;
	say "     With a dick in your mouth and a tongue in your [if player is female]pussy, the demons cover two of your entrances[else]ass, the demons cover both your entrances[end if] with enthusiasm, one wiggling his slick organ like mad in all the sweet spots inside of you, and the other with his sizable penis throbbing in your mouth as you do your best at sucking it, licking it and kissing it all over as he wishes and yearns. You are not taking his dick deep, yet. Instead, the demon has you lick around his shaft a lot, playing with his heavy balls, and at some point, he tells you to put them inside your mouth, the considerable girth of each orb enough to force you to open wide. 'Love the way you worship my cock... You look so cute doing it.' says Arad, with a permanent grin of joy in his face.";
	say "     While the scarred twin surely has his fun making you kiss every bit, curve and corner of his rock hard meat, Egran puts his best effort at tonguing your needy [if player is female]womanhood, shoving it in deep as he gets a good taste of your feminine juices[else]pucker, shoving it in deep as he gives it a good twirl and wiggle[end if] before he pulls out, giving one of your cheeks a playful slap. 'Looks ready.' he adds, as Arad pulls you off his dick completely, grabbing his length and aiming it at your mouth, but holding it still. He seems to be waiting for his brother, as the burly demon behind you grabs his own thick shaft and lets it rest on top of your buns, where you can feel it throb and harden.";
	WaitLineBreak;
	say "     It seems the twins want to enter you at the same time, so they wait for one another. Arad tentatively slides his cock between your lips as you feel Egran's erection poke at your [if player is female]soaked labia[else]wet anus[end if]. Your eyes remain locked on Arad's fiery gaze as he begins to sink his dick in your mouth, and at the same time, your [if player is female]vulva[else]back hole[end if]opens to accommodate Egran's thick shaft, both thrusting into you from the front and the back at the exact same time. You feel your body being taken by a pair of large demon men in perfect sync as both their cocks enter you, sliding deep inside you as one hits your throat and the other threatens to bash into your [if player is male]prostate[else]cervix[end if]. The scarred twin holds your head between his large hands as he takes charge of the front action.";
	say "     Both cocks are shoved deep inside you, the one behind reaching far deep in you while Arad's dick hits your throat as he effectively facefucks you, holding your head in place as he thrusts in and out. At the same time, Egran is fucking your [if player is female]pussy[else]ass[end if], slowly at first, letting you get used to his girth, as he takes hold of your hips. You get a really sweet taste of a demonic dick in your mouth and a delightful intrusion of another inside you from the other side, the combined sensations sending you into a frenzy of lust. 'You like that, eh?' Arad teases you, continuing to shove his own member deeper and getting steadily faster with each passing couple of seconds. Egran follows his rhythm, picking up the pace as his sibling does.";
	WaitLineBreak;
	say "     To some extent, it really feels you are being double taken by the same person. Their synchronization is nearly perfect, thrusting in and out at the same time and with such expertise you cannot help but melt in pleasure. Arad's cock throbbing in your mouth, leaking that sweet thick precum that coats your mouth, which you are happy to swallow down, and Egran's thick meat pulsing inside you, pounding you with such ease and joy... It only gets more intense as they pick up the pace, thrusting and pounding faster into your throat and [if player is female]pussy[else]ass[end if], as you are grabbed by your head and hips by each respective twin. They both moan and grunt as they get absorbed by the moment, feeling their dicks deep inside you, rubbing in and out against your insides, alternating between quick and slow thrusts to prolong the blissful session...";
	say "     'I'm getting close...' says Egran, behind you, as he slows down his pounding while Arad takes a little longer to do the same. 'Yeah... me too...' his brother replies, as he pulls his cock out of your mouth and makes you lick it all over once again, your tongue running through his shaft up and down, then onto his balls as he pushes them past your lips. He then makes you look into his eyes. 'You're about to get filled, horny [boygirl]...' he says, before shoving his dick back into your mouth. There is a mutual agreement between the demon brothers as they return to their fast pace, fucking you deeply and quick, rather hard this time, grunting in pleasure as they both approach their orgasms.";
	if player is male:
		say "     In the meantime, you have also built a solid erection with that girthy log smashing your prostate. You want to join the brothers in cumming with them, so you bring a hand over your dick and start jerking it off to bring yourself just behind the point of no return...";
	WaitLineBreak;
	say "     'Oh, fuck yeah... It's coming...' grunts Egran. 'Yeah... swallow it all down, to the last... Oh, fuck...!' and grunts Arad, as well. The demons are finally reaching their climaxes and are about to shoot their loads inside you. Of course, a massive surge of pleasure also hits you as soon as you beginning to feel their creamy seed invade you from both sides, coating your insides with a whole, whole lot of demon cum as [if player is female]your pussy quivers around Egran's girth[else if player is male]you shoot your own load down onto the bed sheets[else]you are taken by an avalanche of hot, fiery and blissful ecstasy through your sexless body[end if]. What follows next is a cacophony of moans as the brothers enjoy their minute long climaxes, keeping their cocks inside you as they merrily deposit their spunk in you. A couple of thrusts accompany this, slow and gentle as their dicks throb and pulse with each spurt leaving through until the very last.";
	say "     It is then that they carefully pull their dicks out. You actually feel bloated and full from taking the two twins['] loads in you, as it was quite a lot of cum. 'Damn, this was good... I totally wanna do this again.' Arad says as he rubs your head, showing some affection for you. He adds 'You did really well, too.' before his brother, Egran, carefully lies down next to you. Not wanting to leave you two in the bed alone, Arad also joins, and you find yourself, once more, sandwiched between the two big and strong devils as they both cuddle with you in post-sex bliss. It is a good way to end, as you had to lie down and catch your breath before you could walk outside, anyway. Now you get to do that, but with their company.";
	WaitLineBreak;
	say "     After a good while, you get up and clean the mess you have all made before returning outside. Both brothers look extremely content, and they even seem nicer to each other. After all, they do get along pretty well, especially after sharing a willing participant during some steamy sex.";
	NPCSexAftermath Player receives "OralCock" from Arad;
	if player is female:
		NPCSexAftermath Player receives "PussyFuck" from Egran;
	else:
		NPCSexAftermath Player receives "AssFuck" from Egran;

[***********************************************************]
Section 2 - Jyneth
[***********************************************************]

Table of GameCharacterIDs (continued)
object	name
Jyneth	"Jyneth"

Jyneth is a woman. Jyneth is in Hellfire Lounge.
ScaleValue of Jyneth is 4. [DB sized]
Body Weight of Jyneth is 5. [scale of 1-9 for body weight, grouped into low weight (1-3), mid weight (4-6) and high weight (7-9)]
Body Definition of Jyneth is 7. [scale of 1-9 for body definition, grouped into low muscle (1-3), mid muscle (4-6), high muscle (7-9)]
[Body Adjective is generated out of the body weight and body definition and can be used in scenes - one word descriptive adjective depending on weight and definition groups: low weight group: skinny/slender/lithe; mid weight group: average/fit/muscled; high weight group: pudgy/husky/jacked]
Androginity of Jyneth is 8. [Gender Adjective is generated out of androginity 1-9: hypermasculine/masculine/somewhat effeminate/effeminate/androgynous/feminine butch/tomboyish/feminine/hyperfeminine]
Mouth Length of Jyneth is 9. [inches deep for face fucking; maximum possible will be double this number (when deep throating)]
Mouth Circumference of Jyneth is 3.  [mouth circumference 1-5, "tiny, small, normal, wide, gaping"]
Tongue Length of Jyneth is 8. [length in inches]
Breast Size of Jyneth is 6. [cup size as number, counting Flat Pecs = 0, A = 1, B = 2, ...]
Nipple Count of Jyneth is 2. [count of nipples]
Asshole Depth of Jyneth is 14. [inches deep for anal fucking]
Asshole Tightness of Jyneth is 3. [asshole tightness 1-5, "extremely tight, tight, receptive, open, gaping"]
Cock Count of Jyneth is 0. [number of cocks]
Cock Girth of Jyneth is 0. [thickness 1-5, thin/slender/average/thick/monstrous]
Cock Length of Jyneth is 0. [length in inches]
Ball Count of Jyneth is 0. [allowed numbers: 1 (uniball), 2 or 4]
Ball Size of Jyneth is 0. [size of balls 1-7: "acorn-sized", "dove egg-sized", "chicken egg-sized" "goose-egg sized", "ostrich-egg sized", "basketball-sized", "beachball-sized"]
Cunt Count of Jyneth is 1. [number of cunts]
Cunt Depth of Jyneth is 14. [penetratable length in inches; some minor stretching allowed, or more with Twisted Capacity]
Cunt Tightness of Jyneth is 3. [size 1-5, generates adjectives of extremely tight/tight/receptive/open/gaping]
Clit Size of Jyneth is 3. [size 1-5, very small/small/average/large/very large]
[Basic Interaction states as of game start]
PlayerMet of Jyneth is false.
PlayerRomanced of Jyneth is false.
PlayerFriended of Jyneth is false.
PlayerControlled of Jyneth is false.
PlayerFucked of Jyneth is false.
OralVirgin of Jyneth is false.
Virgin of Jyneth is false.
AnalVirgin of Jyneth is false.
PenileVirgin of Jyneth is false.
SexuallyExperienced of Jyneth is true.
TwistedCapacity of Jyneth is true. [Twisted Characters can take any penetration, no matter the size]
Sterile of Jyneth is true. [steriles can't knock people up]
MainInfection of Jyneth is "".
Description of Jyneth is "[Jynethdesc]".
Conversation of Jyneth is { "<This is nothing but a placeholder!>" }.
The scent of Jyneth is "     Jyneth smells faintly of brimstone, but she has a rather attractive, feminine scent".

to say JynethDesc:
	say "     Jyneth is the club's waitress, sonstantly walking from one side to another, either serving drinks or cleaning up tables and the floor off any mess done by the club's customers. The sexy deviless is a tall hellfire demoness with red skin, relatively short black hair and a fiery gaze, sporting a muscled physique with a couple of eye-catching and very sizable breasts tightly held together by a black leather corset. On her bottom, she wears a provocative black silk thong, linked to a pair of dark transparent stockings by a couple of straps on each side of her powerful legs, and walks on black high stiletto heels in perfect balance and style. Her thin demonic tail follows cautiously after her every step.";

[***********************************************************]
Section 2-1 - Jyneth Talk
[***********************************************************]

JynethDoneTalking is a truth state that varies.[@Tag:NotSaved]

instead of conversing Jyneth:
	say "     You approach the waitress, who's taking a short break right now. 'Heyy! Came to have a chat with Jyneth, here? Doing good and having fun?' she asks as you greet her.";
	now JynethDoneTalking is false;
	say "[JynethTalkMenu]";

to say JynethTalkMenu:
	say "     [bold type]What do you want to talk to Jyneth about?[roman type][line break]";
	LineBreak;
	now sextablerun is 0;
	blank out the whole of table of fucking options;
	[]
	choose a blank row in table of fucking options;
	now title entry is "Herself";
	now sortorder entry is 1;
	now description entry is "Ask the waitress about herself";
	[]
	if Energy of Jyneth > 0:
		choose a blank row in table of fucking options;
		now title entry is "Joining the Club";
		now sortorder entry is 2;
		now description entry is "Ask how she joined Mogdraz's Club";
	[]
	if Energy of Jyneth > 1:
		choose a blank row in table of fucking options;
		now title entry is "Others";
		now sortorder entry is 3;
		now description entry is "Inquire about her perspective on the others";
	[]
	sort the table of fucking options in sortorder order;
	repeat with y running from 1 to number of filled rows in table of fucking options:
		choose row y from the table of fucking options;
		say "[link][y] - [title entry][as][y][end link][line break]";
	say "[link]0 - Nevermind[as]0[end link][line break]";
	while sextablerun is 0:
		say "Pick the corresponding number> [run paragraph on]";
		get a number;
		if calcnumber > 0 and calcnumber <= the number of filled rows in table of fucking options:
			now current menu selection is calcnumber;
			choose row calcnumber in table of fucking options;
			say "[title entry]: [description entry]?";
			if Player consents:
				let nam be title entry;
				now sextablerun is 1;
				if (nam is "Herself"):
					say "[JynethTalkHerself]";
				if (nam is "Joining the Club"):
					say "[JynethTalkClub]";
				if (nam is "Others"):
					say "[JynethTalkOthers]";
				wait for any key;
				if JynethDoneTalking is false:
					say "[JynethTalkMenu]"; [looping back to keep talking with him]
		else if calcnumber is 0:
			now sextablerun is 1;
			say "     You give Jyneth a polite bow as you make your leave, which he retributes.";
			wait for any key;
		else:
			say "Invalid Option. Pick between 1 and [the number of filled rows in the table of fucking options] or 0 to exit.";
	clear the screen and hyperlink list;

to say JynethTalkHerself:
	say "     Curious about the demoness waitress, you let her know that you would like to have her tell you a bit more about herself. 'Oh! You wanna know more about me? I'm an open book, honestly. I'm just a big demon girl who loves having fun! But of course, I've got a job to do here, serving drinks to all the thirsty lads and lasses while passing on some eyecandy for extra income. You know, I don't wear this push-up corset for nothing! Some of them are so horny for some big red bazoongas they slide an extra tip through my thong. Others get more touchy, but those end down on the floor. These aren't free real estate.' she ends as she points at her eye-catching tits, tightly held up together within her curve-hugging corset. Her voice has this happy and friendly vibe to it, as she smiles and winks through her words with plenty of outgoing energy.";
	say "     'Basically, profit makes big boss['] giant king dong hard, so my job is to keep the big spenders motivated and make sure that happens. Also don't tell him I said that, he might not like me talking about his weapon of ass destruction that openly. But honestly, that drilling organ grinder is so big I bet he could send the Void King from Hell to Heaven and back with just a couple of thrusts! Maybe that's why he wants all the... You know what, this conversation was about me and I've already said too much. Hi, I'm Jyneth, your drinks taxi and Toron's assigned delivery girl when the club fills up so much you can't even see the pitch black sexy bartender behind the counter pouring in the good stuff. Though as you are a special guest, I doubt you'd need to wait like the others do. Talk about special privileges, huh? You make me jealous.'";
	say "     She looks quite eager to engage in a conversation, so you thank her for that and what she shared with you. 'No problem. Jyneth's here whenever you're feeling lonely and in need to talk. I'm great company, no false modesty here. Who needs that?' she throws in a chuckle at the end.";
	if Energy of Jyneth is 0:
		now Energy of Jyneth is 1;

to say JynethTalkClub:
	say "     She never mentioned how she joined the club as a waitress during her initial talk, so you direct the conversation towards that. 'Ah, well you know Mogdraz owns our asses since the day we're born, right? So he gets to decide where we go, it's that simple. I, however, never expressed any liking for war fights and stuff, so I always kept myself on the backlines, until big boss decided to put me in charge of [']moral support[']. Which really means putting on a show for his demon soldiers and fucking a lot. It was way more fun than fighting for my life, so I appreciated that decision. I've been a stripper, dancer, waitress, tended a bar too in occasion, though I'm not as good as Toron... And had a lot of sex, naturally.'";
	say "     'I think Mogdraz thought I'd be a good fit for this place, maybe? I mean, who else could be serving drinks and charming clients...? Drenraya? Her oversized dragon cock would probably smack the clients['] heads faster than she could put their drinks down, not to mention her temper's as explosive as a raging volcano. She'd probably blow fire on them and roast them right on the spot... Not very profitable. But anyway, answering your question, our lovely big red daddy just likes me enough to keep me around, I believe. Plus, I was sick of that stupid demon tyrant bullshit crap happening in our world, so that was the perfect opportunity to get the fuck outta there. I'm glad boss managed to climb the ranks, or that would've been impossible.'";
	if Energy of Jyneth is 1:
		now Energy of Jyneth is 2;

to say JynethTalkOthers:
	say "     She seems to have a lot to say about the other workers in the club, so you decide to push that subject. 'You're looking for gossip? Or my genuine opinion on my colleagues? Because I could offer you a mix.' she says with a devilish smile. 'Where should I begin...? Oh, yes.'";
	WaitLineBreak;
	say "     'So, we've got [bold type]Toron[roman type], our bartender... He's a very shady guy, and I'm not just talking about his choice of color. I mean, you can barely see him in the dark, but that's not what I'm saying. For sure you've noticed that the way he speaks shows there's always something that he isn't telling you. We couldn't be any more different. Okay, sure, I can keep a secret, but like... Making everything a secret is a bit too much, I think. He literally tells nothing about himself, and it's so infuriating. But I guess that's why boss has Toron as his special informant... If he picked me I'd probably let some vital information slip through my lips before I realized. So I guess his trust is well placed...";
	WaitLineBreak;
	say "     'The twins are both lovely. I get along with them very well, actually! I've got to say, though, when I want an opinion from the head, I go to [bold type]Egran[roman type], and when I want from the heart, I go to [bold type]Arad[roman type]. I guess that's the main difference between both. While Egran is a far more cautious guy who likes to take one step at a time and be in control of everything, Arad's more easygoing. Though he can be a bit reckless sometimes, he gets stuff done quicker than most, and he's very forward regarding most subjects, too. I guess they truly shine when they're together, in more ways than just one...' she adds a suggestive wink on the last part. 'I mean, who wouldn't like getting close between two hunks like those? I for sure would. And... that might have happened already. I might even... recommend it, if you fancy a good pair of pussywreckers yourself.'";
	WaitLineBreak;
	say "     'About our dragon demon lady... Not sure if you've already met [bold type]Drenraya[roman type], but let me know if you've got a good first impression of her. Those are rare, she always acts like she's got something stuck up her ass, and not the good kind of... Well, you know. She's always mad at something. I think she must make some kind of very angry sex, too! Can you imagine, with all that... grumpiness of hers? But I like teasing her, she has some really funny reactions. Although, she sells a lot of useful stuff! I buy some for myself, you should totally check out the shop section of the club.'";
	if Resolution of Ambush The Purifier >= 7:
		WaitLineBreak;
		say "     'Hmm... When it comes to [bold type]Araqiel[roman type], I really don't know what to say... Apparently he's like, connected to Mogdraz in some way, but I never really got how...? He's an angel, boss is a demon... what could have happened there? But yeah, I guess he's a quite fun chap. I never met anyone who could fuck that hard and enthusiastically, manages to put a smile on my face everytime I meet him. If I'm having a bad day, he always cheers me up the way only he can. I suppose we've got to thank you for bringing him here, right? Yeaaah, you were the one who helped Toron catch him... Hope that wasn't too hard, or I'd feel bad. I mean... He was quite a good catch, I don't think there's anyone who doesn't like him, around here...'";
		say "     'Of course, I know he's an angel and we're demons so we're supposed to be enemies and all that, but really, that doesn't matter when you have a cooch destroyer like that hanging between your legs. At least on my book!'";
	WaitLineBreak;
	say "     'Now, regarding boss... He may be a little complicated to get along with at first, but... He's okay. I mean, sure, [bold type]Mogdraz[roman type] does a lot of things demons do, but like... He protects his allies and friends with everything he's got, so he's dependable and loyal to us as well. He cares about us. We couldn't be as safe as we are now without him on the lead, that's for sure. He does a great job at keeping things going, and the Hellfire demons only made it because of him. At this point, if it wasn't for his leadership and cunning, we would've all been assimilated into that idiot's army and our entire kind... gone. I much prefer it this way, even if we have to thrive on mortals[']... er... generosity.' She does an awkward chuckle at the end.";

[***********************************************************]
Section 2-2 - Jyneth Sex
[***********************************************************]

Instead of fucking Jyneth:
	say "[SexWithJyneth]";

to say SexWithJyneth:
	say "[bold type]<< Author's Note: This is not possible at the moment. There are no sex scenes for this character, yet. >>[roman type][line break]";

[***********************************************************]
Section 3 - Drenraya
[***********************************************************]

Table of GameCharacterIDs (continued)
object	name
Drenraya	"Drenraya"

Drenraya is a woman. Drenraya is in Hellfire Storage.
ScaleValue of Drenraya is 4. [DB sized]
Body Weight of Drenraya is 5. [scale of 1-9 for body weight, grouped into low weight (1-3), mid weight (4-6) and high weight (7-9)]
Body Definition of Drenraya is 8. [scale of 1-9 for body definition, grouped into low muscle (1-3), mid muscle (4-6), high muscle (7-9)]
[Body Adjective is generated out of the body weight and body definition and can be used in scenes - one word descriptive adjective depending on weight and definition groups: low weight group: skinny/slender/lithe; mid weight group: average/fit/muscled; high weight group: pudgy/husky/jacked]
Androginity of Drenraya is 8. [Gender Adjective is generated out of androginity 1-9: hypermasculine/masculine/somewhat effeminate/effeminate/androgynous/feminine butch/tomboyish/feminine/hyperfeminine]
Mouth Length of Drenraya is 9. [inches deep for face fucking; maximum possible will be double this number (when deep throating)]
Mouth Circumference of Drenraya is 3.  [mouth circumference 1-5, "tiny, small, normal, wide, gaping"]
Tongue Length of Drenraya is 9. [length in inches]
Breast Size of Drenraya is 6. [cup size as number, counting Flat Pecs = 0, A = 1, B = 2, ...]
Nipple Count of Drenraya is 2. [count of nipples]
Asshole Depth of Drenraya is 16. [inches deep for anal fucking]
Asshole Tightness of Drenraya is 3. [asshole tightness 1-5, "extremely tight, tight, receptive, open, gaping"]
Cock Count of Drenraya is 1. [number of cocks]
Cock Girth of Drenraya is 4. [thickness 1-5, thin/slender/average/thick/monstrous]
Cock Length of Drenraya is 16. [length in inches]
Ball Count of Drenraya is 2. [allowed numbers: 1 (uniball), 2 or 4]
Ball Size of Drenraya is 4. [size of balls 1-7: "acorn-sized", "dove egg-sized", "chicken egg-sized" "goose-egg sized", "ostrich-egg sized", "basketball-sized", "beachball-sized"]
Cunt Count of Drenraya is 1. [number of cunts]
Cunt Depth of Drenraya is 16. [penetratable length in inches; some minor stretching allowed, or more with Twisted Capacity]
Cunt Tightness of Drenraya is 3. [size 1-5, generates adjectives of extremely tight/tight/receptive/open/gaping]
Clit Size of Drenraya is 3. [size 1-5, very small/small/average/large/very large]
[Basic Interaction states as of game start]
PlayerMet of Drenraya is false.
PlayerRomanced of Drenraya is false.
PlayerFriended of Drenraya is false.
PlayerControlled of Drenraya is false.
PlayerFucked of Drenraya is false.
OralVirgin of Drenraya is false.
Virgin of Drenraya is false.
AnalVirgin of Drenraya is false.
PenileVirgin of Drenraya is false.
SexuallyExperienced of Drenraya is true.
TwistedCapacity of Drenraya is true. [Twisted Characters can take any penetration, no matter the size]
Sterile of Drenraya is true. [steriles can't knock people up]
MainInfection of Drenraya is "".
Description of Drenraya is "[Drenrayadesc]".
Conversation of Drenraya is { "<This is nothing but a placeholder!>" }.
The scent of Drenraya is "     Drenraya smells faintly of brimstone, but she has a rather attractive, feminine scent".

to say DrenrayaDesc:
	say "     The shopkeeper of the Hellfire Club is rather unique in appearance. She is a full lizardwoman, is red-skinned, has fiery orange eyes with dark scleras, and has a pair of large obsidian horns that assume a more draconic shape than the typical hellfire demon ones, with a fancy obsidian circlet adorned with a bright merigold gem that falls to her forehead. However, she possesses the might of a demon still, coupled with the power of a dragoness, sporting a quite muscular and strong physique. Around her torso towards her legs, she wears a long harness, with her large breasts and bits barely covered by a set of black silk bra and thong. On her back, an intimidating pair of dark red dragon wings rest relaxed and still.";
	say "     She seems like a [bold type]shopkeeper[roman type] of some sort, with her merchandise placed behind her counter.";

[***********************************************************]
Section 3-1 - Drenraya Talk
[***********************************************************]

DrenrayaDoneTalking is a truth state that varies.[@Tag:NotSaved]
DrenrayaAskedToShop is a truth state that varies.[@Tag:NotSaved]

instead of conversing Drenraya:
	say "     You approach the demon dragoness, who stares back at you with fiery eyes. 'Come to make a purchase? Pick the product and hand over the coins. Best quality assured.' She doesn't seem too friendly, but you could also try talking to her.";
	now DrenrayaDoneTalking is false;
	now DrenrayaAskedToShop is false;
	say "[DrenrayaTalkMenu]";

to say DrenrayaTalkMenu:
	say "     [bold type]What do you want to ask Drenraya?[roman type][line break]";
	LineBreak;
	now sextablerun is 0;
	blank out the whole of table of fucking options;
	[]
	choose a blank row in table of fucking options;
	now title entry is "Shop";
	now sortorder entry is 1;
	now description entry is "Browse her catalog";
	[]
	choose a blank row in table of fucking options;
	now title entry is "Herself";
	now sortorder entry is 2;
	now description entry is "Try asking her to tell you more about herself";
	[]
	sort the table of fucking options in sortorder order;
	repeat with y running from 1 to number of filled rows in table of fucking options:
		choose row y from the table of fucking options;
		say "[link][y] - [title entry][as][y][end link][line break]";
	say "[link]0 - Nevermind[as]0[end link][line break]";
	while sextablerun is 0:
		say "Pick the corresponding number> [run paragraph on]";
		get a number;
		if calcnumber > 0 and calcnumber <= the number of filled rows in table of fucking options:
			now current menu selection is calcnumber;
			choose row calcnumber in table of fucking options;
			say "[title entry]: [description entry]?";
			if Player consents:
				let nam be title entry;
				now sextablerun is 1;
				if (nam is "Shop"):
					now DrenrayaAskedToShop is true;
					now DrenrayaDoneTalking is true;
				if (nam is "Herself"):
					say "[DrenrayaTalkHerself]";
				wait for any key;
				if DrenrayaDoneTalking is false:
					say "[DrenrayaTalkMenu]"; [looping back to keep talking with him]
		else if calcnumber is 0:
			now sextablerun is 1;
			say "     You excuse yourself as Drenraya returns to her tasks.";
			wait for any key;
		else:
			say "Invalid Option. Pick between 1 and [the number of filled rows in the table of fucking options] or 0 to exit.";
	clear the screen and hyperlink list;
	if DrenrayaAskedToShop is true:
		say "[DrenrayaShop]";

to say DrenrayaTalkHerself:
	if Energy of Drenraya is 0:
		say "     Despite the first impression you have got from her - which was that she does not seem too inclined to have long conversations with anyone - you try asking her to tell you a bit about herself and how she came to be here. 'Look. I'm not here to do any chit-chat with outsiders. Mogdraz may have allowed you to walk and poke around freely, but I don't trust you. And I'm only letting you buy stuff because he gave the order. Now, if you're not gonna buy anything, then I suggest you piss off and go bother someone else. Like Jyneth! She's the one who loves to talk.'";
		say "     It appears that your first impression was... correct.";
		now Energy of Drenraya is 1;
	else if Energy of Drenraya is 1:
		say "     Your first attempt didn't go too well, so you have decided to try one more time. 'This again?! I won't repeat myself. If you're not here to buy anything, then go away and stop pestering me. I'm not in the mood. And if you're wondering, no, I will never be in the mood, either.'";
		say "     Perhaps it is only a matter of time until she starts regarding you with less mistrust...? For now, you suppose you can only do business with her without putting your head in risk. Those claws of hers look sharp!";

[***********************************************************]
Section 3-2 - Drenraya Sex
[***********************************************************]

Instead of fucking Drenraya:
	say "[SexWithDrenraya]";

to say SexWithDrenraya:
	say "[bold type]<< Author's Note: This is not possible at the moment. There are no sex scenes for this character, yet. >>[roman type][line break]";

[***********************************************************]
Section 3-3 - Drenraya Shop
[***********************************************************]

to say DrenrayaShop:
	now DrenrayaDoneTalking is true;
	say "     You ask the demoness to allow you to browse her inventory. 'Sure thing. Shit is still messy, as I just barely set up a list of items that are in any conditions to be sold. I might expand this in the future with more items and organized lists, but for now, you'll have to make do with what I have currently in stock.'";
	say "     Drenraya has a list of items that you can purchase in exchange for [bold type]Obsidian Coins[roman type], so make sure you have them with you.";
	say "To buy an item, type buy (name here)";
	repeat through table of Drenraya Inventory:
		follow allowed entry;
		if rule failed:
			next;
		say "[link]Buy[as]buy [object entry][end link] ";
		say "[Name entry] - [price entry] obsidian coin";

Table of Drenraya Inventory
name	price	object	allowed
"hellfire demon horn shard"	2	hellfire demon horn shard	true rule
"leather harness"	5	leather harness	true rule
"black silk corset"	5	black silk corset	true rule
"leather jockstrap"	5	leather jockstrap	true rule
"black silk thong"	5	black silk thong	true rule
"black combat boots"	5	black combat boots	true rule
"black stiletto heels"	5	black stiletto heels	true rule
"null essence"	10	null essence	true rule

[***********************************************************]
Section 3-3-1 - Drenraya Shop's Exclusive Items
[***********************************************************]

[--- CHEST WEAR ---]

Table of Game Objects (continued)
name	desc	weight	object
"leather harness"	"Several leather straps that are put around the torso and connected to a central metallic piece that rests on the middle of the wearer's chest. Its revealing nature makes it quite sexy, and is designed for the male body."	1	leather harness

leather harness is a grab object.
leather harness is equipment.
It is not temporary.
Plural of leather harness is false.
Taur-compatible of leather harness is true.
Size of leather harness is 3.
AC of leather harness is 0.
Effectiveness of leather harness is 0.
GA of leather harness is 1.
Traits of leather harness is {"sexy"}.
Placement of leather harness is "body".
Descmod of leather harness is "Your upper body is covered by a black leather harness.".
Slot of leather harness is "chest".
Scent of leather harness is "It just smells like leather...".

Table of Game Objects (continued)
name	desc	weight	object
"black silk corset"	"An elegant corset made of black silk, featuring a push-up fit on the chest. Accentuates femininity and it is quite sexy."	1	black silk corset

black silk corset is a grab object.
black silk corset is equipment.
It is not temporary.
Plural of black silk corset is false.
Taur-compatible of black silk corset is true.
Size of black silk corset is 3.
AC of black silk corset is 0.
Effectiveness of black silk corset is 0.
GA of black silk corset is -1.
Traits of black silk corset is {"sexy"}.
Placement of black silk corset is "body".
Descmod of black silk corset is "Your upper body is covered by a black silk corset.".
Slot of black silk corset is "chest".
Scent of black silk corset is "It smells of perfume and has a faint trace of musk from being worn a bit. You have seen worse...".

[--- UNDERWEAR ---]

Table of Game Objects (continued)
name	desc	weight	object
"leather jockstrap"	"A black leather jockstrap that barely provides any frontal cover and none at all behind, leaving your ass exposed. Its revealing nature makes it quite sexy. Naturally, it is designed for males."	0	leather jockstrap

leather jockstrap is a grab object.
leather jockstrap is equipment.
It is not temporary.
Plural of leather jockstrap is false.
Taur-compatible of leather jockstrap is false.
Size of leather jockstrap is 3.
AC of leather jockstrap is 0.
Effectiveness of leather jockstrap is 0.
GA of leather jockstrap is 1.
Traits of leather jockstrap is {"sexy"}.
Placement of leather jockstrap is "crotch".
Descmod of leather jockstrap is "A kinky leather jockstrap holds tightly against your privates.".
Slot of leather jockstrap is "crotch".
Scent of leather jockstrap is "Smells like sweet musk... It was worn before, but it is fairly clean.".

Table of Game Objects (continued)
name	desc	weight	object
"black silk thong"	"A black silk thong that barely covers your privates, but it surely does emphasize your butt. Its revealing nature makes it quite sexy, albeit a little slutty, and it seems to be designed for females."	0	black silk thong

black silk thong is a grab object.
black silk thong is equipment.
It is not temporary.
Plural of black silk thong is false.
Taur-compatible of black silk thong is false.
Size of black silk thong is 3.
AC of black silk thong is 0.
Effectiveness of black silk thong is 0.
GA of black silk thong is -1.
Traits of black silk thong is {"sexy", "slutty"}.
Placement of black silk thong is "crotch".
Descmod of black silk thong is "A revealing black silk thong hugs your crotch tightly.".
Slot of black silk thong is "crotch".
Scent of black silk thong is "Smells like sweet musk... It was worn before, but it is fairly clean.".

[ DUNGEON PRISONERS ]

[***********************************************************]
Section P - Eranyd
[***********************************************************]

Table of GameCharacterIDs (continued)
object	name
Eranyd	"Eranyd"

Eranyd is a man. Eranyd is in Hellfire Cell One.
ScaleValue of Eranyd is 3. [Human sized]
Body Weight of Eranyd is 5. [scale of 1-9 for body weight, grouped into low weight (1-3), mid weight (4-6) and high weight (7-9)]
Body Definition of Eranyd is 6. [scale of 1-9 for body definition, grouped into low muscle (1-3), mid muscle (4-6), high muscle (7-9)]
[Body Adjective is generated out of the body weight and body definition and can be used in scenes - one word descriptive adjective depending on weight and definition groups: low weight group: skinny/slender/lithe; mid weight group: average/fit/muscled; high weight group: pudgy/husky/jacked]
Androginity of Eranyd is 2. [Gender Adjective is generated out of androginity 1-9: hypermasculine/masculine/somewhat effeminate/effeminate/androgynous/feminine butch/tomboyish/feminine/hyperfeminine]
Mouth Length of Eranyd is 5. [inches deep for face fucking; maximum possible will be double this number (when deep throating)]
Mouth Circumference of Eranyd is 3.  [mouth circumference 1-5, "tiny, small, normal, wide, gaping"]
Tongue Length of Eranyd is 5. [length in inches]
Breast Size of Eranyd is 0. [cup size as number, counting Flat Pecs = 0, A = 1, B = 2, ...]
Nipple Count of Eranyd is 2. [count of nipples]
Asshole Depth of Eranyd is 8. [inches deep for anal fucking]
Asshole Tightness of Eranyd is 3. [asshole tightness 1-5, "extremely tight, tight, receptive, open, gaping"]
Cock Count of Eranyd is 0. [number of cocks]
Cock Girth of Eranyd is 0. [thickness 1-5, thin/slender/average/thick/monstrous]
Cock Length of Eranyd is 0. [length in inches]
Ball Count of Eranyd is 0. [allowed numbers: 1 (uniball), 2 or 4]
Ball Size of Eranyd is 0. [size of balls 1-7: "acorn-sized", "dove egg-sized", "chicken egg-sized" "goose-egg sized", "ostrich-egg sized", "basketball-sized", "beachball-sized"]
Cunt Count of Eranyd is 1. [number of cunts]
Cunt Depth of Eranyd is 10. [penetratable length in inches; some minor stretching allowed, or more with Twisted Capacity]
Cunt Tightness of Eranyd is 3. [size 1-5, generates adjectives of extremely tight/tight/receptive/open/gaping]
Clit Size of Eranyd is 5. [size 1-5, very small/small/average/large/very large]
[Basic Interaction states as of game start]
PlayerMet of Eranyd is false.
PlayerRomanced of Eranyd is false.
PlayerFriended of Eranyd is false.
PlayerControlled of Eranyd is false.
PlayerFucked of Eranyd is false.
OralVirgin of Eranyd is false.
Virgin of Eranyd is false.
AnalVirgin of Eranyd is false.
PenileVirgin of Eranyd is false.
SexuallyExperienced of Eranyd is true.
TwistedCapacity of Eranyd is true. [Twisted Characters can take any penetration, no matter the size]
Sterile of Eranyd is true. [steriles can't knock people up]
MainInfection of Eranyd is "Incubus".
Description of Eranyd is "[Eranyddesc]".
Conversation of Eranyd is { "<This is nothing but a placeholder!>" }.
The scent of Eranyd is "     Eranyd would smell nicely and sweet, were it not for the reek of sex surrounding his cell and the all too familiar brimstone scent. Still, he has a set of pheromones that can drive anyone wild with eagerness to fuck".

to say EranydDesc:
	say "     Eranyd is one of the prisoners captured during one of the many conflicts between demons in Red Light. Once a, most certainly, virile incubus, the handsome hellspawn has been turned into a cuntboy and locked in the dungeons for anyone to come and use his holes for their pleasure. Sporting a swimmer's build and a quite messy short red hair, he underwent some changes made by the hellfire demons. While he retained his long and thin tail with a spaded tip and bat-like wings, he also has a pair of short obsidian horns and claws, and his eyes are of a fiery orange, which trail your every movement attentively with quite the inviting gaze. The incubus is laying bare naked and looks too lust-addled to think of anything else other than sex.";

[***********************************************************]
Section 4-1 - Eranyd Talk
[***********************************************************]

EranydDoneTalking is a truth state that varies.[@Tag:NotSaved]

instead of conversing Eranyd:
	say "     As you walk towards the altered incubus, he eyes you with obvious interest, putting himself on clear view as he makes his whole body very visible to you. 'Hey there... Did you want to have some fun?' You reply that you merely want to speak to him, which has him rolling his eyes in disappointment. 'A talker... how fun. How can I satisfy your curiosity, then?'";
	now EranydDoneTalking is false;
	say "[EranydTalkMenu]";

to say EranydTalkMenu:
	say "     [bold type]What do you want to ask the prisoner?[roman type][line break]";
	LineBreak;
	now sextablerun is 0;
	blank out the whole of table of fucking options;
	[]
	choose a blank row in table of fucking options;
	now title entry is "Himself";
	now sortorder entry is 1;
	now description entry is "Ask him about himself";
	[]
	if Energy of Eranyd > 0:
		choose a blank row in table of fucking options;
		now title entry is "His predicament";
		now sortorder entry is 2;
		now description entry is "How come he ended up here";
	[]
	if Energy of Eranyd > 1:
		choose a blank row in table of fucking options;
		now title entry is "Him being so willing";
		now sortorder entry is 3;
		now description entry is "Inquire about his willingness to please, despite him being a prisoner";
	[]
	sort the table of fucking options in sortorder order;
	repeat with y running from 1 to number of filled rows in table of fucking options:
		choose row y from the table of fucking options;
		say "[link][y] - [title entry][as][y][end link][line break]";
	say "[link]0 - Nevermind[as]0[end link][line break]";
	while sextablerun is 0:
		say "Pick the corresponding number> [run paragraph on]";
		get a number;
		if calcnumber > 0 and calcnumber <= the number of filled rows in table of fucking options:
			now current menu selection is calcnumber;
			choose row calcnumber in table of fucking options;
			say "[title entry]: [description entry]?";
			if Player consents:
				let nam be title entry;
				now sextablerun is 1;
				if (nam is "Himself"):
					say "[EranydTalkHimself]";
				if (nam is "His predicament"):
					say "[EranydTalkPredicament]";
				if (nam is "Him being so willing"):
					say "[EranydTalkPrisoner]";
				wait for any key;
				if EranydDoneTalking is false:
					say "[EranydTalkMenu]"; [looping back to keep talking with him]
		else if calcnumber is 0:
			now sextablerun is 1;
			say "     You excuse yourself as Eranyd merely watches you go.";
			wait for any key;
		else:
			say "Invalid Option. Pick between 1 and [the number of filled rows in the table of fucking options] or 0 to exit.";
	clear the screen and hyperlink list;

to say EranydTalkHimself:
	say "     You admit seeing an incubus with such altered features gives you something to think about, and so you decide to ask him to tell you a bit more about himself. 'What should I tell you? I'm Eranyd, a demon of lust, born to bring out the worst of people's innate sexual desire and feed from it. Something you should've already know if you'd ever met an incubus or a succubus...' he replies, with a slight tone of annoyance. Looking at his state, there is a chance things did not go too well for him, so you give him that remark. 'Oh, how wonderful. You'd think I would be unhappy to be captured and being brought into a dungeon that offers me free sex on an almost hourly basis? They even let me keep my name...! I don't care which demon faction I belong to, as long as I get my constant dose of pleasure... Which, by the way, you're free to offer it, yourself.' he says in a clearly suggestive way.";
	say "     To be honest, you really cannot see the harm of having a bit of fun with Eranyd, if you ever wanted.";
	if Energy of Eranyd is 0:
		now Energy of Eranyd is 1;

to say EranydTalkPredicament:
	say "     So, he is a prisoner of the Hellfire Demons, but how did that come to be? You decide to ask him about that. 'Well, you should know about the Combat Zone, right? The Hellfires seem to have a little of an issue with the remaining demons. We were here first but they seem to think they own the District... Well, whatever. I suppose I got too close to a group of horny red devils and they fucked my every hole until I was so full I couldn't walk or fly away. Good technique, if you ask me. At least we all enjoyed our time before I was thrown into this gorgeous room... and got fucked through the next hours by a duo of really handsome twins. What were their names, again...? They had so much synergy together that I felt I was getting doublefucked by the same person. Really hot...'";
	say "     That does not really explain his physical changes, since the Hellfires do not seem to carry any infectious nanites, and so, are not able to change anyone with their body fluids during sex. Wanting more information on that matter, you press on the subject a little further. 'You mean how I lost my dick and got these horns, claws and eyes...? I don't know. I woke up like this one day. I suppose they used something to change me, but I really don't care. I didn't make much use of my cock either, so I welcome the change. I can get an additional dick inside me, so I suppose that's a win-win situation. Plus, the cosmetic side looks sick... I love it.'";
	WaitLineBreak;
	say "     Sounds like Eranyd does not really mind anything that happened to him.";
	if Energy of Eranyd is 1:
		now Energy of Eranyd is 2;

to say EranydTalkPrisoner:
	say "     You already know how he ended up here and who he is, sort of. But one question remains... Did he never actually think about escaping? Eranyd said he really does not mind being here as all his needs are cared for, but what about his freedom? These are all questions you ask him. 'Escaping?! Why would I? I don't actually feel the need to do it. In all honesty, I don't really want to leave.' Oddly enough, you think that is not a strange reaction, but you still try to ask him to explain what he is saying.";
	say "     'As I've told you, all my needs are satisfied with an almost hourly fuck or two, all of them very, very pleasurable. You could say I am a willing prisoner.' he says.";
	if Perception of player > 19:
		WaitLineBreak;
		say "     [bold type]But you are perceptive enough to notice that something looks odd...[roman type]";
		say "     You cannot quite put your finger on why, but you feel there is something else to this story. The incubus senses your mistrust in his words and proceeds to give you another explanation. 'Look... It is true, I am willing. I couldn't have put myself under Mogdraz's will without actually wanting to do it. He just has a way with words, I can't really... explain. His power is impressive... Though, for some reason, I can never remember any interaction I had with him to its full extent, there's always something missing... Like a blank in my memory. But I remember feeling so content afterwards... Nothing alike anything I've ever experienced after that meeting.'";
		say "     So Eranyd is saying he actually had some intimate experience with Mogdraz, you ask... 'Did we...? Perhaps. Maybe that's what he made me forget. I don't really know why, though. Why would he? One would think I'd be spoiled forever, maybe. Perhaps his sex is so good you can't find anything else better than that, and if you forget, you still get to enjoy sex with other people? Who knows...'";
		say "     One thing is certain, Eranyd likes it here, regardless of everything else that may have happened. But this conversation goes to show how truly influential, and also mysterious, Mogdraz can be...";
	else:
		say "     Well, given his consistent answers, you suppose that is all there is to it.";

[***********************************************************]
Section 4-2 - Eranyd Sex
[***********************************************************]

Instead of fucking Eranyd:
	say "[SexWithEranyd]";

to say SexWithEranyd:
	say "[bold type]<< Author's Note: This is not possible at the moment. There are no sex scenes for this character, yet. >>[roman type][line break]";

Hellfire Workers ends here.
